август: августа
агентство: агентства
академия: академии
аккреционный: аккреционном аккреционный
активность: активности
активный: активная активное активной
алексей: алексей
американский: американскими
анализ: анализ
аппарат: аппарат аппарата аппаратами
аризона: аризона
аризонский: аризонского
астероид: астероид астероида
астроновость: астроновости
астроном: астроном астрономам астрономы
астрономический: астрономических
астрономия: астрономии астрономия
астрофизик: астрофизика астрофизики
атмосфера: атмосфере атмосферу
атмосферный: атмосферным
аэрокосмический: аэрокосмических
базальт: базальт базальта
барт: барт
белый: белый
бесценный: бесценные
блазар: блазары
близкий: ближе близкой
близко: близко
близость: близость
блокировать: блокирует
борт: борту
бурение: бурением
важно: важно
венера: венеры
вероятно: вероятно
вершина: вершине
весь: всем
вещество: вещество
взаимодействие: взаимодействие взаимодействий взаимодействия
взаимодействовать: взаимодействующие
взрыв: взрыв
вид: вида виде
видеть: видели видеть
видимый: видимая видимого
включая: включая
владимир: владимир
влететь: влетел
влиять: влияющие
вместе: вместе
внешний: внешнего
внутренний: внутренней
возвратить: возвращенных
возле: возле
возраст: возраст
войти: войдет
вокруг: вокруг
вращаться: вращающийся
вращение: вращения
время: времен времени время
вселенная: вселенной
всё: всё
вулкан: вулкана
вулканизм: вулканизм вулканизма
вулканический: вулканического вулканической вулканическом
вход: входе
вхождение: вхождения
выброс: выбросы
выйти: выйти
вынудить: вынуждены
гавайи: гавайях
газ: газом
гаиша: гаиш
галактика: галактик галактика галактиках галактики галактикой галактику
галлей: галлея
гало: гало
гамма: гамма
геологический: геологической
геология: геологии
геофизик: геофизики
го: го
год: года лет
голова: голове
гораздо: гораздо
гость: гостя
гравитационный: гравитационного гравитационные гравитационных
гранула: гранул
грунт: грунтов
группа: группа группы
давать: дает
данные: данным
датирование: датирование датированием датирования
датировка: датировка
дать: данные
два: две
двигатель: двигателей
двигаться: движется
движение: движения
дева: девы
девятый: девятый
девять: девять
декабрь: декабря
дело: дело
день: день
деталь: деталей
детальный: детальное
деятельность: деятельности
джеймс: джеймс
джет: джеты
диаметр: диаметр диаметром
диапазон: диапазона диапазонах
диск: диск диске диски
добыть: добытых
довольно: довольно
доказательство: доказательства
должный: должен
доставить: доставленных
достаточный: достаточное
достигнуть: достичь
доцент: доцент
друг: друг друга
другой: другая других другое
дыра: дыр дыра дыре дыры
европейский: европейского
естествоиспытатель: естествоиспытателей
жаклин: жаклин
жизнь: жизнь
журнал: журнале
завершение: завершение
задача: задача
запечатлеть: запечатлена запечатлены
запланировать: запланированной запланированы
заполнить: заполненный
запустить: запущенный
заранее: заранее
затмить: затмить
звезда: звезды
звёздный: звездное звездными
земля: земле землей земли землю
земной: земной земную земных
значительно: значительно
зона: зоны
зонд: зонд
зондовый: зондовый
зрелище: зрелищем
извержение: извержении
известный: известны
излучать: излучают
излучение: излучение излучения
изменение: изменения
изначально: изначально
изображение: изображение изображении изображения
изучение: изучение изучения
изучить: изучила изучить
именно: именно
иметь: имеет имел иметь
импактный: импактного импактную
институт: института
инструмент: инструмент инструменты
интересный: интересным
информация: информацию
инфракрасный: инфракрасные
искать: ищут
исключительно: исключительно
использовать: использовать
испускать: испускает испускают
исследование: исследование исследований
исследователь: исследователем
исследовать: исследованных
история: истории
источник: источниками
итог: итоге
какой: каким какую
канал: канале
канд: канд
капля: капель
карлик: карлик
карта: карта
каталина: каталина
каталогизация: каталогизацию
квазар: квазары
кеа: кеа
километр: километров
китай: китая
китайский: китайские
классифицировать: классифицируют
км: км
количество: количество
коллега: коллегами
кольцо: кольцо
комета: комета кометы
компактный: компактная компактным
конечный: конечном
корабль: корабля
корректировать: корректировать
космический: космический космическим космических космического
космос: космос
косс: косс
который: которая которого которое которой которые
крайний: крайней
кудрить: кудря
лаборатория: лаборатория
леммона: леммон
лишь: лишь
луна: луна луне
лунный: лунного лунный лунных
лусон: лусон
луч: лучей лучи
лёгкий: легче
магнетар: магнетара
магнитный: магнитного
манила: манилы
манёвр: маневров маневры
марс: марсе
массивный: массивнее
мат: мат
материал: материалам
материя: материи
мауна: мауна
маунт: маунт
мгу: мгу
медуза: медуза медузу медузы
мелкий: мелких
менее: менее
мера: мере
меркурианский: меркурианским
меркурий: меркурий меркурию меркурия
место: место
метеор: метеора
метеорит: метеорита метеоритов
метод: методы
метровый: метровым
механизм: механизм
микроанализатор: микроанализатор
миссия: миссией миссии миссия миссиями
множество: множестве
молодой: молодого
момент: момента
московский: московскому
мочь: могли могут
мощный: мощнейшие мощные
наблюдатель: наблюдателей наблюдатели
наблюдать: наблюдаемых наблюдать
надежда: надежда
назад: назад
название: название
назвать: назвал назвали
наземный: наземной
называть: называемый
называться: называется
наиболее: наиболее
наличие: наличие
намного: намного
напоминать: напоминают
направить: направлены
население: население
наслать: нашли
наука: наук науки
научий: науч
научный: научными
находиться: находится находясь
нацелить: нацелена
наш: нашего
небесный: небесного небесное небесные
небо: неба
небольшой: небольшая небольшие небольшом
невозможно: невозможно
недалеко: недалеко
неполадка: неполадок
непосредственно: непосредственно
нептун: нептуна
несколько: нескольких
несмотря: несмотря
нести: несет
ниже: ниже
никакой: никаких
новость: новостей
новый: новая новое новые
номер: номера
носить: носит
обеспечить: обеспечить
обзор: обзор обзором
область: область
обнаружение: обнаружении обнаружения
обнаружить: обнаружен обнаруженного обнаруженных обнаруживший обнаружили обнаружить
обозначение: обозначение
образец: образцах образцов образцы
образование: образования
образовать: образовав образуя
образоваться: образовались образоваться
обсерватория: обсерватории
обширный: обширный
общий: общей
объект: объект объектов
объясняться: объясняется
ограничение: ограничений
один: одной
однако: однако
ожидание: ожидании
ожидаться: ожидается
означать: означает
оказаться: оказавшееся
окончание: окончания
октябрь: октябре
омолодить: омолодила омолодили
оно: оно
оперативный: оперативная
опубликовать: опубликовал опубликовано
орбита: орбите орбиту орбиты
оснастить: оснащенных
основа: основе
основный: основная
особенность: особенность особенностью
остальной: остальную
остров: острова
отвечать: отвечающие
отдельный: отдельных
отличаться: отличающееся
относительный: относительную
отправить: отправили
отслеживание: отслеживание
очень: очень
падать: падающее
падение: падение падения
пара: пару
первоначальный: первоначальный
передать: переданном
песочный: песочные
план: план
планета: планет планеты
планироваться: планировалось планируется
поверхность: поверхности
поглощать: поглощает
поддержание: поддержания
подобный: подобную подобные подобными подобных
подразумевать: подразумевает
подробно: подробно
подтвердить: подтвердила подтвержденные
позволить: позволят
позволять: позволяет
поздний: поздних позже
показать: показаны
показывать: показывает
поле: поля
полностью: полностью
полоса: полоса полосами
полтора: полутора
получить: полученном полученных получено получил
полушарие: полушария
полюбоваться: полюбоваться
полёт: полет
помочь: помогут
понимание: понимания
понять: понять
поразительный: поразительного
порядок: порядка
последний: последнего
постоянный: постоянными
поток: потоки
потухший: потухшего
прародитель: прародитель
предварительный: предварительным
предоставлять: предоставляет
предполагать: предполагаемое
предсказать: предсказанный предсказано
представление: представлениям
представлять: представляет
прежде: прежде
прекрасно: прекрасно
приблизиться: приблизился
прибор: приборами
привести: привела
признать: признав
примерно: примерно
принять: приняли
природа: природу
присутствие: присутствием
причудливый: причудливое
проблема: проблем
провести: проведет провести
программа: программы
продолжать: продолжает
проект: проект
произвести: произведет
произойти: произойдет произошло
происхождение: происхождения
пролёт: пролета пролетом
пропадать: пропадает
пропускать: пропускает
протопланетный: протопланетные
прочий: прочих
проявляться: проявлялся
путь: путь
пылевой: пылевыми
пыль: пыли
пятно: пятна
пятый: пятый
работа: работе
радиация: радиации
радиоволна: радиоволн радиоволны
радиоизотопный: радиоизотопное радиоизотопным
разглядеть: разглядел
различать: различать
различный: различные
разогреваться: разогреваются
разрешение: разрешение
разрушиться: разрушился
рамка: рамках
распасться: распадется
расположить: расположена
расстояние: расстояние
расчётный: расчетного
реализация: реализации
реализовать: реализует
реголит: реголита
редкий: редким
результат: результатам результате
релятивистский: релятивистские
роль: роли
сам: самого самой
самый: самые самым самых
сближаться: сближающихся
сближение: сближение
сверхмассивный: сверхмассивная сверхмассивной сверхмассивных
световой: световых
свидетельствовать: свидетельствовали
свинцовый: свинцового
свистопляска: свистопляска
свой: своего своей своем свой
сгореть: сгорел
себя: собой
север: северу
сегодня: сегодня
сегодняшний: сегодняшний
сентябрь: сентября
сердцевина: сердцевине
серия: серии
система: системы
слабый: слабое
слава: славу
слева: слева
след: след следов
следующий: следующие
слишком: слишком
слияние: слияний слияния
сложно: сложно
сложность: сложности
сложный: сложных
смотреть: см
смочь: смогли
снимка: снимок
снимок: снимке снимков
собирать: собирая
собранный: собранных
событие: событие
совершить: совершить
советский: советскими
совместный: совместный
современный: современный современным
согласно: согласно
содержать: содержала содержащая
содержаться: содержались
созвездие: созвездии
солнечный: солнечной
солнце: солнца солнцу
соответственно: соответственно
соответствовать: соответствующая
состав: состава
сотня: сотнях
сотр: сотр
сохранять: сохранять
спектр: спектре
специалист: специалисты
спираль: спирали
спиральный: спиральная спиральные
способ: способ
способный: способно способны
справа: справа
спрогнозировать: спрогнозировано
спутник: спутника спутники
ст: ст
стабильный: стабильной
сталкиваться: сталкивающиеся сталкиваясь
стать: стал
стекло: стекла
стеклянный: стеклянные стеклянных
столица: столицы
столкновение: столкновение столкновения
столкнуться: столкнулся
столько: столько
сторона: сторону
страна: страны
струить: струи
сурдина: сурдин
существование: существования
считаться: считается считаться считаются
счёт: счет
также: также
такой: такие таким таких такого такое
телеграм: телеграм
телескоп: телескоп телескопа телескопе телескопом
тело: тела тело
температура: температур
тепло: тепла
технически: технически
технический: технические
технолог: технологом
тип: типы
тот: той тому
точный: точный
траектория: траектории траектория
транность: транности
три: трех
трудность: трудностями
туманность: туманность
тёмный: темной
убедительный: убедительные
удалить: удалены
удалённый: удаленных
удар: ударе
ударный: ударного
удаться: удалось
университет: университета
уран: уран
успешный: успешное
установленный: установленным
уточнение: уточнение
утром: утром
учёный: ученые ученым
уэбба: уэбб уэбба
фазекас: фазекас
факультет: факультета
физ: физ
физический: физического
филиппина: филиппины
филиппины: филиппин филиппинами
форма: формой форму
формирование: формирование
фото: фото
фотография: фотографии
хаббл: хаббл
хаббнуть: хаббла
характеристика: характеристик
хвост: хвоста
химический: химического
хирон: хирона
хозяин: хозяином
хороший: лучшие
центр: центре
центральный: центральная центральной
цюли: цюли
чанъэ: чанъэ
час: часов
частица: частицы
часть: часть
часы: часы
человек: людей
человечество: человечества
чрезвычайно: чрезвычайно
чудовищный: чудовищных
чёрный: черная черной черных
шарик: шарики шариков
шестой: шестой
шесть: шесть
штат: штат
щупальце: щупальца
эволюция: эволюции эволюцию
экватор: экватора
экзопланетный: экзопланетную
экспедиция: экспедиции
экстремальный: экстремальные
электромагнитный: электромагнитного электромагнитном
электронный: электронно
электропитание: электропитанием
этап: этапа
этот: эта этих
юг: югу
южный: южного
юпитер: юпитера
явление: явлением
ядро: ядра ядре ядро ядром
январь: января
японский: японским японского
яркий: яркая яркий ярким яркими ярче
ясли: яслями
