автомобиль: автомобиля
адаптивный: адаптивная адаптивной
алкалоид: алкалоидами
аллель: аллелей
аллёля: аллеля
американский: американском
анализ: анализ анализом
аналогичный: аналогичного
аномалия: аномалии
аномалоскоп: аномалоскопе
ао: ао
астроном: астрономов
бабочка: бабочки
бабушка: бабушки
белок: белка
белый: белого белых
бинокуляр: бинокуляр
биол: биол
бодрствовать: бодрствующего
больший: большими
большинство: большинстве
большой: большого
буква: буквы
бывать: бывают
бывший: бывшие
важный: важный
вариация: вариация
варьировать: варьировало
вверху: вверху
ввести: введен
веда: вед
вектор: вектором
верхний: верхний верхняя
вести: вести
весь: всем вся
веточка: веточки
взаимоисключающий: взаимоисключающую
взрослый: взрослой взрослых
видеть: видел видеть видим видит видят
визуализация: визуализации
визуализировать: визуализированы
вильямс: вильямса
вирус: вирус
вирусный: вирусных
вишня: вишен
внизу: внизу
вновь: вновь
внутренний: внутреннего внутренней
вогнутый: вогнутое
вожак: вожаками
вождение: вождения
возбуждать: возбуждающим
возбуждение: возбуждения
возможность: возможность
возможный: возможных
возникновение: возникновении возникновению
возникнуть: возникла
волновой: волнового волновой
впервые: впервые
вредный: вредными
время: время
встречаться: встречаются
встроить: встроенного
встроиться: встроился
всё: всё
выборочный: выборочном
выбрать: выбранный
выделить: выделенными
выживание: выживания
вызывать: вызывала
вылечивание: вылечивание вылечивания
вынужденный: вынужденного
выражать: выражали
высказываться: высказывалось
высокий: высокую
выход: выход
выявить: выявить выявленная
гельмгольц: гельмгольц гельмгольца гельмгольцем
ген: ген гена генов гены
генетика: генетики
генетический: генетический генетическим генетических
генный: генной
геном: геном
герман: герман
гетерозиготный: гетерозиготные
гетероморфный: гетероморфных
гипотеза: гипотеза
гистологический: гистологическое
глаз: глаз глаза глазами глазу
глазной: глазного
год: год года году лет
гомозиготный: гомозиготные
грубый: грубых
группа: группами
давний: давней
дальтон: дальтон
дальтонизм: дальтонизм
дальтоник: дальтоники
дать: дала
два: две двух
движение: движения движениями
дева: девы
дейтераноп: дейтеранопа
дейтеранопа: дейтеранопы
дейтеранопия: дейтеранопии дейтеранопию
денситометрия: денситометрии денситометрия
день: дни
дерево: деревьев
десять: десяти
дефектный: дефектным
деформировать: деформируемое
джей: джей
диагноз: диагноз
диаметр: диаметре
дикий: диких
дихромазия: дихромазии дихромазия
дихромат: дихромата дихроматами дихроматы
дневный: дневных
дно: дна
доказать: доказана
домашний: домашних
достаточно: достаточно
достаточный: достаточным
достигаться: достигалась
достигнуть: достиг
достижение: достижением
другой: другие других
дупликация: дупликация
елена: елена
естественно: естественно
естественный: естественного
живой: живого живое живой живом
животное: животные животных
жизнь: жизни
жить: живущих жили
журнал: журнале
жёлтый: желтое
зависеть: зависит
зависимость: зависимости
загадка: загадка
заглянуть: заглянуть
заменить: заменена
заместить: замещен
замечать: замечает
занимать: занимает
заранее: заранее
засвечивание: засвечиванием
захватывать: захватывают
зеленочувствительный: зеленочувствительного зеленочувствительные зеленочувствительных
зелёный: зеленого зеленой зеленые зеленый зеленым зеленых
зеркало: зеркала зеркало
зерно: зерно
знать: знают
зрачок: зрачок
зрение: зрение зрения
зрительный: зрительного зрительные зрительный зрительных
идентифицировать: идентифицированные
идея: идея
идти: шла
издали: издали
изображение: изображении изображения
изучение: изучения
иметь: имеют имеющие
иммунохимический: иммунохимическим
имя: имени
иначе: иначе
инверсия: инверсия
инициал: инициалами инициалы
иной: иного
интересный: интересен интересный
интраокулярный: интраокулярно
инъекция: инъекции
инъецировать: инъецируемый
иппи: иппи
исихара: исихара
использовать: использован
использоваться: используется
исправление: исправление
исправлять: исправляющее
испытуемый: испытуемого испытуемых
испытывать: испытывают
исследование: исследование исследования
исследователь: исследователю исследователя
история: история
источник: источника
ихара: ихара
каждый: каждого каждое каждой
какой: каких
канд: канд
карандаш: карандашей
карта: карте
картина: картина картине
картинка: картинка картинки
качественно: качественно
кисть: кистей
класс: классов
клетка: клетке
клубок: клубков
книга: книги
когерентный: когерентной
кодировать: кодирующие кодирующий кодирующим кодирующих
колбочка: колбочек колбочкам колбочке колбочки
колбочковый: колбочковых
количество: количества количество
колонка: колонке
колоссальный: колоссальным
комиссия: комиссиях
комментарий: комментария
компенсировать: компенсирующая
компьютеризация: компьютеризация
конкретный: конкретных
конструкт: конструкт
континент: континенте
контролировать: контролирует
конфокальный: конфокальная
кормить: кормили
коррекция: коррекции
который: который которым которых
крайне: крайне
красивый: красивая
красноватый: красноватые
красночувствительный: красночувствительного красночувствительных
красный: красно красного красной красные красный красным красных
краткий: краткое
кривая: кривые
кровеносный: кровеносные
крон: кронах
крошечный: крошечных
курс: курсах
лазер: лазер
лазерный: лазерное
лампа: лампу
левый: левая левой
либо: либо
лист: листьев листья
листва: листве листвы
листик: листики
листочек: листочки
листоядность: листоядность
лишь: лишь
любимец: любимцев
макака: макаки
максимальный: максимальна
максимов: максимова
максимум: максимумами
малочисленный: малочисленная
малый: меньшей
масштаб: масштаба
материковый: материковых
матриархат: матриархат
матрица: матрице матрицу матрицы
маурина: маурин
медицина: медицину
мелкий: мелких
менее: менее
метод: метод методом
меченый: меченый
мечта: мечтой
микробиом: микробиом
микроскопия: микроскопия
мимикрировать: мимикрирующих
минута: минут
мир: мир мире миру
мишень: мишеней
мкл: мкл
млекопитающее: млекопитающие
многократно: многократно
многочисленный: многочисленная
мозаика: мозаики
мозг: мозг
молекулярный: молекулярные
молодой: молодые
момент: момент
мономорфный: мономорфны
морфологически: морфологически
мочь: могут
мощь: мощь
мраморный: мраморные
мужчина: мужчин
мутация: мутации
мысль: мысль
наблюдатель: наблюдатель
наблюдательный: наблюдательнее
наблюдать: наблюдаемая наблюдать
наблюдение: наблюдения
наглядность: наглядности
назад: назад
наземный: наземные
называние: назывании
найти: нашедшая
накопиться: накопившимися
наличие: наличие наличием
напомнить: напомним
направление: направления
направлять: направляющей
направляться: направлялся
например: например
наружное: наружном
наружный: наружных
насекомое: насекомых
наука: наук наука
научий: науч
научный: научных
находить: находят
находиться: находятся
начаться: началась
наш: наших
небольшой: небольшое
невозможно: невозможно
неделя: недели неделю
незрелый: незрелых
неинвазивный: неинвазивного
нейтц: нейтц
некоторый: некоторые некоторых
необходимо: необходимо
неожиданный: неожиданным
неразличимый: неразличимы
нерв: нерва
нервный: нервных
несколько: нескольких несколько
нефункционирующий: нефункционирующий
нечёткий: нечеткого
нижний: нижний нижних нижняя
низкий: низших
никакой: никаких
никто: никто
нитка: ниток
нм: нм
новый: новая нового новой новом новый
номинал: номиналу
нормальный: нормальное нормальной нормальный нормальными
носорог: носорогов
ночной: ночного
оба: обоим обоих
обезьяна: обезьян обезьяны
обезьянка: обезьянка обезьянки
обеспечивать: обеспечивает обеспечивают
обеспечить: обеспечена
обесцветить: обесцвеченным
обесцвечивание: обесцвечивании
обзор: обзоре
обладать: обладает
область: области
обработка: обработка
образ: образа образом
обследование: обследование обследовании обследования обследованиях
обследовать: обследованных обследуемого
общаться: общаются
общий: общего
объяснение: объяснения
объяснить: объяснить
одежда: одежды
один: одна одного одной
одинаковый: одинаковы
одиночный: одиночной одиночных
однако: однако
одновременно: одновременно
одомашнивание: одомашнивание
окрасить: окрашены
операция: операции
описать: описана
опосредовать: опосредована
определение: определение
определять: определяющим определяя
определяться: определяется
опсиновый: опсинов
опсиный: опсин опсина опсины
оптика: оптика оптикой
оптимальный: оптимального
оптический: оптической оптическую
опубликовать: опубликованы
опыт: опыт опыта опыту
оранжевый: оранжевых
организация: организации
освещение: освещение освещения
оснастить: оснащены
основа: основе
основный: основных
особенность: особенностях
особь: особей
остальной: остальные остальных
острота: остроту
отбор: отбора
отверстие: отверстием
отвечать: отвечает
отдельный: отдельные отдельных
открыться: открылась
отличать: отличать
отличаться: отличается
отличие: отличие
отличить: отличить
отметка: отметка
относительный: относительного
отношение: отношение
отражать: отражающей
отражаться: отражалась
отражённый: отраженного отраженном
отрывок: отрывок
отсутствие: отсутствие
отсутствовать: отсутствовали отсутствуют
офтальмолог: офтальмологов
офтальмоскоп: офтальмоскоп офтальмоскопа
офтальмоскопия: офтальмоскопии офтальмоскопия
охотно: охотно
очень: очень
ощущение: ощущение ощущения
паразитный: паразитных
патология: патологии
пациент: пациентов
первый: первый
перемещаться: перемещающихся
пигмент: пигмент пигмента пигментов пигментом пигменты
питательный: питательные
плечо: плече
плита: плит
плод: плодов плоды
плосконосый: плосконосых
плотность: плотности плотность
пневмония: пневмонии
поверхность: поверхности
повторный: повторная
повторяться: повторяющиеся
подавление: подавления
подбор: подбор
подвижный: подвижных
поддерживать: поддерживающим
поддерживаться: поддерживается
подозревать: подозревают
подсказка: подсказок
подтвердить: подтвердил
подтверждаться: подтверждалась
поедать: поедают
позволять: позволяет
позвоночный: позвоночных
поиск: поисках поиске
пока: пока
показать: показал показали показало показано
показывать: показывает показывают
пол: пол
поликлиника: поликлиниках
полиморфизм: полиморфизм
полиморфный: полиморфный
половина: половине половины
положение: положением
получить: полученному получить
помидор: помидоры
помимо: помимо
помощь: помощи
понадобиться: понадобилась
понятно: понятно
понять: понять
популяция: популяция
пора: пор
последовательный: последовательном
последующий: последующие последующих
поток: потоке
похожий: похожи
почему: почему
почерпнуть: почерпнута
поэтому: поэтому
появиться: появившихся появилась появились появилось
правда: правда
правило: правило
правый: правая правой
предполагаться: предполагается
предположение: предположение
представить: представить
предъявить: предъявил
предыдущий: предыдущее
преимущество: преимущества
прекрасно: прекрасно
прибор: прибор приборе
привести: привела привело
придумать: придумал
примат: приматов приматы
примерно: примерно
природа: природа
присутствовать: присутствующего
приходиться: приходилось
причина: причина
приёмник: приемника
приёмный: приемных
провести: провели
произвести: произведено
произойти: произошла произошли произошло
происходить: происходит
промотор: промотором
промоутер: промоутером
просторечие: просторечии
пространство: пространство
протаноп: протанопа
протанопа: протанопы
протанопия: протанопии протанопию
профотометрировать: профотометрированы
процесс: процесса процессом
прямой: прямого прямое
псевдоизохроматический: псевдоизохроматических
психофизический: психофизический психофизическим психофизических
путаться: путаются
путь: путях
пятно: пятно
пятнышко: пятнышка
пять: пяти
рабкина: рабкина
работа: работа
разделение: разделение
разделить: разделить
различаться: различалось различаются
размер: размер размера
размерность: размерности
разный: разная разной разную разные разными разных
разработка: разработки
разрешать: разрешающую
разрешение: разрешением
разыскивать: разыскивать
ран: ран
ранее: ранее
раскрашивать: раскрашивают
распознать: распознать
расположение: расположение расположением расположения
расположить: расположен расположены
распределение: распределения
расстройство: расстройствах
растр: растре
реакция: реакций
реальность: реальность
ревун: ревунов
регистрироваться: регистрироваться
редко: редко
резко: резко
резорбироваться: резорбировались
результат: результат результате результату результаты
результирующий: результирующей
резус: резуса
ретинограмм: ретинограмма
ретроаденовирус: ретроаденовирус
рецептор: рецептор рецепторов
рецепторный: рецепторной рецепторные
рис: рис
род: рода
рыба: рыб
рябина: рябины
саймирить: саймири
сам: самих
самец: самца самцами самцов самцы
самка: самки
самый: самым
сбор: сборе
свет: свет света свете светом
световой: светового
светофор: светофора светофоре
свеча: свеча свечи
свидетельство: свидетельства
свой: своего
связываться: связывается
себя: собой
сегмент: сегмента сегменте сегментов
седьмой: седьмой
сей: сих
селективность: селективность
селективный: селективная селективно
семья: семье
серьёзный: серьезных
сетчатка: сетчатка сетчатках сетчатке сетчатки сетчатку
сигнал: сигнал сигналов сигналы
сидеть: сидит
сильно: сильно
сильный: сильнее сильного
синечувствительный: синечувствительного синечувствительные
синий: синего синим
синоб: синобу
синь: синей
система: система
слева: слева
следить: следящая
следовать: следовало
следующий: следующим
слепой: слепое
случай: случае случаев
случайно: случайно
случайный: случайного случайное случайным
смотреть: см смотрит
совершенно: совершенно
современный: современных
содержать: содержащий содержащих
содержаться: содержится
создатель: создателей
сократиться: сократилось
сообщение: сообщение
соответственно: соответственно
соответствовать: соответствует
соответствующий: соответствующие
соотношение: соотношение
сорокакратный: сорокакратная
составлять: составлял составляли составляют
сосуд: сосуды
сотр: сотр
сохраняться: сохраняется
соцсеть: соцсеть
сочетание: сочетании
спасти: спасут
спектр: спектра
спектральный: спектральной
спелый: спелые спелыми спелых
специальный: специальном специальный
способ: способов
способность: способность способностях
способный: способен
справа: справа
спрятаться: спрятавшихся
среди: среди
средневолновочувствительный: средневолновочувствительного средневолновочувствительных
ставиться: ставится
стандартный: стандартном
старое: старого
старый: старый старых
стать: стала стали
стая: стае
стимул: стимула стимулы
стимулировать: стимулировать
стимуляция: стимуляции стимуляция
стоить: стоил
строго: строго
субретинальный: субретинальное
субъективный: субъективные
судить: судить
существовать: существуют
схема: схема
сходный: сходные сходных
сходство: сходства
считаться: считается
счёт: счет
съедобный: съедобные съедобных
сэм: сэм сэма
таблица: таблицах
также: также
такой: таким таких
тандем: тандемом
телескоп: телескопы
терапия: терапии
тест: тест тестам тестах
тестирование: тестировании
технология: технологий
тип: тип типа типами типов
томография: томографией
трв: трв
три: трех
тританопа: тританопы
трихромазия: трихромазии трихромазию трихромазия
трихромат: трихромата трихроматами трихроматов трихроматы
трихроматический: трихроматического
трудно: трудно
трудность: трудности
убить: убьют
увеличиваться: увеличивалась
увидеть: увидеть
угловой: угловых
удав: удава
удивительный: удивительным
узконосый: узконосых
узнавать: узнавать узнают
указанный: указанных
улучшение: улучшения
уменьшение: уменьшению
умерший: умершего
умозаключение: умозаключение
усовершенствование: усовершенствования
установка: установка установки
устроить: устроена
утомительно: утомительно
утратить: утратившие
участвовать: участвуют
участок: участка участках участков участок
учреждение: учреждений
учёный: ученому
фазо: фазо
фактор: фактором
феромон: феромоны
фиксировать: фиксированной
фиксироваться: фиксируется
флуоресценция: флуоресценции флуоресценция
флуоресцировать: флуоресцирующего
фовеа: фовеа
фовеальный: фовеальных
фокальный: фокальная
фон: фон фоне
форма: форм
фотоизображение: фотоизображении
фотопигмент: фотопигмента фотопигментов
фоторецептор: фоторецепторов
фронт: фронт фронта
фрукт: фруктами фрукты
фруктоядность: фруктоядность
функционировать: функционирующих
хаотично: хаотично
хромосома: хромосомах хромосоме хромосомы
царить: царит
цвет: цвет цвета цвете цвету
цвета: цветами
цветовой: цветового цветовое цветовые
цветовосприятие: цветовосприятии цветовосприятия
цветоразличительный: цветоразличительных
ценный: ценен
центр: центра
центральный: центральной центральным
цз: цз
цифра: цифры
час: часов
частица: частиц
часто: часто
частый: чаще
часть: части
часы: часы
человек: людей люди людям человек человека
черно: черно
четыре: четырех
число: числа
чувствительность: чувствительности чувствительность
чувствительный: чувствительной
чёткий: четких
шум: шумов
щелевой: щелевую
эволюция: эволюции
экспрессия: экспрессию экспрессия
эмоциональный: эмоциональных
эпоха: эпоха
это: этим
этот: эта этих
эффект: эффект
являться: является
ягода: ягоды
