австралия: австралии
активный: активной
аналитик: аналитики
анастасия: анастасия
артерия: артерий
база: база базе базу базы
базовый: базовые
блокада: блокада
болезнь: болезней болезнь
борис: бориса борисов
быстрый: быстрее быструю быстрым
быть: будут
вариант: вариант
василий: василий
вено: вен
вероятность: вероятность
вести: вести
весь: всем
визуализировать: визуализированная визуализировать
витреомакулярный: витреомакулярного
включая: включая
вначале: вначале
внимание: внимание
воз: воз
возраст: возрасте
возрастной: возрастная возрастной
война: войны
впоследствии: впоследствии
врач: врач врачам
время: время
встречаться: встречается
вшить: вшито
выделять: выделять
выполняться: выполняющихся
высокий: высокая высокую
выше: выше
выявить: выявлена
выявление: выявление выявления
германия: германии
гистологический: гистологической
главный: главный
глаз: глаз глаза
год: году лет
государственный: государственную
данные: данным данных
датасет: датасет датасета
два: двух
дегенерация: дегенерации дегенерация
день: дню
диабетический: диабетический
диагноз: диагноз диагноза
дистрофия: дистрофию
доступный: доступна доступным
доцент: доцент
другой: другие
екатеринбургский: екатеринбургской
животное: животных
жизнь: жизни
жить: жили
журнал: журнале
заболевание: заболевание заболеваний заболевания
загрузить: загрузили
задний: заднего
запатентовать: запатентована
запись: записей
заподозрить: заподозрить
зарегистрировать: зарегистрирована
затем: затем
значимый: значимых
зрачок: зрачки
зрени: зрени
зрение: зрение зрения
идеальный: идеальный
изменение: изменения
изображение: изображения
индустриальный: индустриальными
иной: иной
интерфейс: интерфейса
информационный: информационных
использовать: использовать используемых
исследование: исследование исследовании
исследователь: исследователи
итог: итоге
к: ко
какой: какие какого
кафедра: кафедры
качественно: качественно
качество: качество
кейс: кейсов
китайский: китайских
класс: классов
клиника: клинике клиники клинику
когерентный: когерентная когерентной
количество: количеством количеству
компьютерный: компьютерного
конкретный: конкретных
который: которое которую которые
крупный: крупной
крымский: крымской
лечение: лечении лечения
максимальный: максимальное
макулярный: макулярная макулярной макулярный
малый: меньшей
маршрутизация: маршрутизацию
математик: математика
математика: математики
мембрана: мембраны
мера: мере
метод: метод методы
минимум: минимум
мир: мире
мировой: мировой
молекулярный: молекулярной
мочь: могут
набор: набор
надеяться: надеемся
назад: назад
нарушение: нарушения нарушениями
наследственный: наследственную
наука: науки
научить: научить
научиться: научились
наш: нашу
недоношенный: недоношенных
нейронный: нейронной
нейросеть: нейросети нейросеть нейросетях
несколько: нескольких
никифоров: никифорова
новость: новости
новый: новая нового новый
норма: норме
нужный: нужные
обезьяна: обезьян
обеспечение: обеспечение
обратить: обратить
обучение: обучения
обученный: обученные
обучить: обучили
объяснять: объясняет
один: одно одной
окг: окг
окклюзия: окклюзии окклюзия
окт: окт
омикрон: омикрон
оон: оон
опасный: опасный
описание: описание
описать: описанный
определить: определить
определять: определять
определяться: определяется
оптика: оптика
оптический: оптическая оптической
опубликовать: опубликовали
организовать: организовать
основа: основе
особенность: особенности
оставаться: остаются
отечь: отек
отмечать: отмечают
отношение: отношении
офтальмолог: офтальмологов
офтальмологический: офтальмологической
офтальмология: офтальмологии
очень: очень
патология: патологии патологий патологиями
пациент: пациента пациентов пациенты
первый: первый
плюс: плюс
поддержка: поддержки
подсказать: подскажет подсказать
позволить: позволит
позволять: позволяющей
показание: показания
показывать: показывая
получить: получили
помочь: поможет помочь
помощь: помощью
попросту: попросту
попрыгунья: попрыгунья
постараться: постараемся
построение: построения
построить: построить
почему: почему
появиться: появились
пояснять: поясняет
правильный: правильные
предварительно: предварительно
предотвратить: предотвратить
предсказывать: предсказывать
пресс: пресс
признак: признаки
признанный: признанными
пример: примеру примеры
принимать: принимать
принятие: принятия
проблема: проблема
проверить: проверили
прогноз: прогнозы
программный: программное
продолжить: продолжим
протяжение: протяжении
профессорский: профессорская
процент: процент
работа: работы
работать: работать
развитие: развития
разметить: размеченный
разный: разной
разработать: разработали
ранее: ранее
ранний: ранней раньше
распространить: распространенное распространенные распространенных распространены
распространённость: распространенностью
рассказывать: рассказывает
расширить: расширить
регулярный: регулярные
редкий: редких
результат: результат результаты
рекордный: рекордный
ретинопатия: ретинопатию
решение: решений решения
рождение: рождения
россия: россии
сайт: сайта
сам: самого самой
свет: света
сделать: сделает
сегмент: сегмента
сетчатка: сетчатка сетчатки
сеть: сетей сети
система: систем системах систему
сканирование: сканирования
скачивание: скачивания
слепота: слепота слепоту
слишком: слишком
слово: словам
сложный: сложных
слой: слои
служба: служба
смотреть: см
смочь: смогли
снимка: снимкам снимками
снимок: снимки снимков
собирать: собирали
собранный: собранной собранный
собственный: собственный
содержать: содержит
создать: создали
состояние: состояние состояния
состоять: состоит
сохранить: сохранить
социально: социально
специализировать: специализированную
специалист: специалисты
стадия: стадии
стандарт: стандартами
старое: старого
старт: старту
статья: статьи
стоить: стоит
сторона: стороны
страдать: страдал
стрекоза: стрекоза
стремиться: стремимся
стругацкий: стругацкого
структура: структура
существовать: существует
считать: считает
также: также
такой: таким такими
терапия: терапии
терять: теряли
тестирование: тестирования
технология: технологий
томограф: томографы
томография: томографии томография
тот: той
точно: точно
точность: точности точность точностью
угрожать: угрожающие
университет: университета
управление: управления
уральский: уральского
урфа: урфу
устранить: устранить
уточнить: уточнили
федеральный: федерального
форма: формой формы
фото: фото
цветовой: цветовое
частный: частную
часто: часто
человек: люди человек человека
число: числе
широко: широко
штамм: штамм
экономический: экономическая
эксперимент: эксперименты
экспертный: экспертной
эпиретинальный: эпиретинальной
это: этим
этот: этому
являться: являются
язык: языки языков
