автоматика: автоматикой
автор: автора
администратор: администратора
азимутальный: азимутальная
алегриа: алегриа
алексей: алексей
американец: американец американцев американцы
американский: американские американский американскими американских американском
антенна: антенной
аппарат: аппарат аппарата
аравия: аравии
астероид: астероид
астронавт: астронавтами
астронавтика: астронавтики
астроновость: астроновостей астроновости
астроном: астрономов
астрономический: астрономической
астрофизик: астрофизики
астрофотограф: астрофотографом
атакама: атакама
атакамский: атакамская
атмосфера: атмосфере атмосферы
аэродинамика: аэродинамики
база: базы
байконур: байконур
бе: беам
безупречно: безупречно
белый: белым
бельгия: бельгии
бенкен: бенкен
беспилотный: беспилотных
бесформенный: бесформенной
бетонка: бетонка
бишоп: бишоп
благодаря: благодаря
благополучный: благополучную
блогер: блогер
блок: блоком
бок: бока
больший: большая большей большим
большой: большого большой
борт: бортом
боуэн: боуэн
бразилия: бразилии
быть: будут
вдоль: вдоль
великобритания: великобритании
вероятно: вероятно
версия: версии версий
взаимный: взаимными
взор: взором
видимый: видимые
виталий: виталий
влияние: влияния
внутри: внутри
вода: вода воды
возможно: возможно
возникать: возникает
вокруг: вокруг
волна: волн волны
воссом: воссом
впервые: впервые
вперёд: вперед
вполне: вполне
вращаться: вращаются
время: временем время
вселенная: вселенная вселенную
всматриваться: всматривается
вспомнить: вспомним вспомнить
всё: всё
второй: вторая второй
выбор: выбора
вывести: вывела
выглядеть: выглядит
вызывать: вызывает
выйти: вышел вышло
выполнить: выполнено выполнены выполнила
выполняться: выполнялись
выравнивание: выравнивания
выравниваться: выравниваться
выровнять: выровненных выровнены
вырываться: вырывается
высадка: высадку
высказаться: высказался
высокий: высоким высокое
высокочастотный: высокочастотных
высота: высоты
вытянуть: вытянутыми
выход: выход выходах выходов
выявить: выявили
газ: газ
газета: газеты
галактика: галактике
гармония: гармония
герасименко: герасименко
германия: германии
гкнпц: гкнпц
главный: главную
гладко: гладко
говориться: говорилось говорится
год: года годах году лет
гораздо: гораздо
гражданин: гражданина гражданину
грузовой: грузовым грузовых
группа: группа группы
далеко: далеко
дальнейший: дальнейшем
дания: дании
дать: данные
два: двух
двигатель: двигателей двигатели
дебаты: дебатов
девять: девять
день: день дней
дестиня: дестини
десятилетний: десятилетнего
десяток: десятка
десять: десяти
детектор: детектор
джеймс: джеймсом
диапазон: диапазона
динамика: динамика
диск: диска дисков диском
длина: длиной
длительность: длительностью
длительный: длительный
дмитрий: дмитрий
доказательство: доказательства
доклад: докладе
долгий: дольше
долететь: долетела
должный: должна
долл: долл
дом: дом
дорого: дорого
доставить: доставленный
достигнуть: достиг достигнув достигнуто
достижение: достижение
достижимый: достижимым
дракон: дракон
дыра: дыра дырой дыру
европейский: европейский европейских европейского
егоров: егоров
единица: единицы
жадный: жадным
журнал: журнале
журналистский: журналистский
задать: заданную
задача: задачу
зазор: зазоров
заканчивать: заканчивающей
заключительный: заключительной
заместитель: заместитель
запечатлеть: запечатлена
заполнение: заполнения
заправка: заправка
заправщик: заправщика
запуск: запуск запуска запуски запусков
запустить: запущено запущены
зареять: зарей
зародыш: зародыши
заря: заря
заседание: заседании
заставлять: заставляет
затаиться: затаившийся
зачастую: зачастую
заявить: заявил
заяц: зайца
звезда: звезда звезде звездой звезды
звучать: звучит
земля: земле земли
зерно: зерна
значительно: значительно
значительный: значительной
зонд: зонда
идти: шло
излучение: излучение
изменение: изменения
изображение: изображение изображении изображений изображения
израиль: израиля
изучать: изучает
изучение: изучению
илона: илона
именно: именно
иметь: имеют
имя: имени
индевора: индевор
инопланетянин: инопланетяне
инструмент: инструментом
интересно: интересно
интересный: интересную
интересовать: интересуют
интернациональный: интернациональному
испания: испании
использование: использование использованию
использовать: использовать использующим
испускаться: испускается
испытание: испытание
исследование: исследований исследования исследованиям
исследователь: исследователей
исследовательский: исследовательский исследовательского
история: историю история
исходить: исходит
итальянец: итальянца итальянцев
итог: итогу
кадр: кадров
казахстан: казахстана
калибровка: калибровки
камень: камни
камера: камеры
канада: канады
канадец: канадцев
карлик: карлик
качество: качеством
квест: квест
кеннеди: кеннеди
кибо: кибо
кит: кита
классический: классическая
км: км
коламбусы: коламбус
количество: количества количество количеством
кольцо: колец кольцах кольцо
комета: комета кометы
комитет: комитета
компания: компании компания
компенсация: компенсации
комплекс: комплекс
конгресс: конгрессе
конец: конца
конкретный: конкретного
кононенко: кононенко
консультация: консультации
контракт: контракта
конфигурация: конфигурацией конфигурации
корабль: кораблей корабль корабля кораблями
корея: кореи
коррекция: коррекций
космический: космическая космические космического космической космическом космическую
космодром: космодрома
космонавтика: космонавтики
космос: космос космоса
который: которая котором которую которые который которыми
кристофер: кристофер
кроме: кроме
крупный: крупнейшему крупных
кудрить: кудря
купол: купола
кусок: куски
кэссидеть: кэссиди
лакишеть: лакиша
леонардо: леонардо
либо: либо
линейный: линейному
лопёс: лопес
луна: луну луны
лунный: лунной
любитель: любителем
магнетар: магнетара
магнитный: магнитного
майкл: майкл
максим: максимом
максимально: максимально
максимальный: максимальной
малайзия: малайзии
маленченко: маленченко
маленький: меньше
малый: меньшим
манёвр: маневрами
марс: марсу
март: марта
мартовский: мартовская
маск: маск
маска: маска
масса: массы
масштаб: масштаб масштабу
международный: международная международной международном
мелкий: мелкие
менее: менее
мера: мере
место: места местом
метеорит: метеорит
метод: методам
механический: механическими
миллиметровый: миллиметрового миллиметровым миллиметровых
миллисекунда: миллисекунд
минута: минут минуты
мир: мир мире миры
миссия: миссии
мкс: мкс
млечный: млечного млечный
многоразовый: многоразовых
модуль: модулей модулем модуль модуля
молодой: молодой молодых
момент: момент момента моменты
монитор: мониторов
мочь: могут
мощный: мощным
наблюдать: наблюдаемым
наблюдение: наблюдение наблюдений наблюдения
набрать: набрав
надувной: надувной
наземный: наземная
наиболее: наиболее
накопление: накопления
напополам: напополам
направление: направлении
настоящий: настоящее настоящий
наука: наука
научный: научного
находиться: находятся находящиеся нахожусь
начало: начало
начаться: началась
начинать: начинали
наш: нашей
незапланированный: незапланированная
немец: немца
необходимо: необходимо
неожиданный: неожиданным
нептун: нептуна
несмотря: несмотря
неутомимый: неутомимый
неясно: неясно
нидерланды: нидерландов
новость: новостей
новый: новая новой новые новый новым
носитель: носитель
ноябрь: ноябре ноября
нюанс: нюансов
оаэ: оаэ
оба: обе
обзор: обзор
обладать: обладать
обозначать: обозначаемой
образ: образом
образование: образований
образовать: образуют
обсерватория: обсерватории
обусловить: обусловлена
общий: общая общем
объект: объекта объектов объекты
объектив: объективах
один: одним одному
однородный: однородна
ожидание: ожидании
означать: означает
около: около
окончание: окончанием
олег: олег
оно: оно
операция: операциям
определённый: определенном
опубликовать: опубликовал опубликовала опубликовано
орбита: орбите орбиту орбиты
оригинал: оригинале
оригинальный: оригинальная
ориентировать: ориентированы
оседать: оседают
оснастить: оснащенный
оставаться: остается
осуществить: осуществить осуществлен осуществлены
отделение: отделения
отделиться: отделилась
открытый: открытый
отмена: отмена
относиться: относится
отправить: отправить
отработать: отработала
отстыковаться: отстыковался
официальный: официальное
очень: очень
очередной: очередной
парсек: парсеках
пегги: пегги
пейзаж: пейзаж
первый: первая первого первой первую первый первых
переменный: переменным
перестыковка: перестыковки перестыковок
период: периодом
песня: песне
петелин: петелин
петься: пелось
пиксель: пиксель
пилотировать: пилотируемых
пк: пк
план: плану
планета: планет планеты
планетезималь: планетезимали
планетный: планетных
площадка: площадка площадки
побывать: побывало
поверхность: поверхности поверхностью
повреждение: повреждения
подобный: подобные
подорвать: подорваны
позволять: позволяет
поиск: поиск
пойти: пошло
показывать: показывает
поле: поля
полететь: полетела
положительный: положительная
положить: положивший
получить: получено получил
поляризационный: поляризационных
поляризация: поляризация
поляризовать: поляризованным
полёт: полет полета
помощь: помощью
понять: понят
попасть: попал
популярный: популярной
попытка: попытке попыткой
пора: пор
посадка: посадки посадку
посадочный: посадочный
посвятить: посвящены
поскольку: поскольку
последний: последнее
посмотреть: посмотрите
пострадать: пострадала
потеря: потерей
потребовать: потребует
почитать: почитала
поэтому: поэтому
практически: практически
прародитель: прародитель
превращаться: превращаются
предел: пределами
предмет: предметом
предоставить: предоставили
предположить: предположить
представитель: представителя
представить: представленном
предыдущий: предыдущие
препринт: препринтов
пресс: пресс
приводить: приводил
признать: признать
прилетать: прилетали
приливный: приливное
прильнуть: прильнуло
примерно: примерно
принять: приняли
пристальный: пристальнее
причал: причал
причём: причем
приёмник: приемниками приемников
пробный: пробных
пробыть: пробыл
провал: провал
провести: проведены
проводить: проводимых
программа: программе программы
прогресс: прогресс прогрессов
прогрессивный: прогрессивное
продолжаться: продолжалась
продолжение: продолжения
проект: проекту
произойти: произошло
прокопьев: прокопьев
промежуток: промежутках промежутки
промежуточный: промежуточной
просто: просто
протон: протон
протопланета: протопланет
протопланетный: протопланетным протопланетных
процесс: процесс процесса процессами
прошлый: прошлый
прямой: прямая
публикация: публикация
пульсар: пульсары
пульсация: пульсаций
пуск: пуск пусков
пустыня: пустыне
путь: пути путь
пылинка: пылинками пылинки пылинок
пыль: пыли пыль
пятно: пятна
пять: пять
работа: работа работы
работать: работали работают
рабочий: рабочие
радиотелескоп: радиотелескоп радиотелескопов радиотелескопом
раз: раза
разборка: разборка
разгон: разгон разгона
разгонный: разгонной
разделение: разделения
разлетаться: разлетающегося
различимый: различимы
размер: размерах
разрастись: разрослась
разрешение: разрешение разрешением
разрушать: разрушали
разрушение: разрушение
ракета: ракета ракеты
рамка: рамках
ранее: ранее
ранний: ранние
расположить: расположена расположенной
рассвет: рассвет
рассеиваться: рассеивается
рассеяние: рассеянием рассеяния
расстояние: расстояние расстоянию
результат: результатам результате результатом результаты
рекомендация: рекомендациям
рекорд: рекорд
релиз: релиз
реплика: реплика
решать: решать
решётка: решетка решетки
роберт: роберт
робот: робот робота
рождение: рождение
розетта: розетта розетты
роскосмос: роскосмос
российский: российские российских российском
россиянин: россиян россияне
рубио: рубио
руководство: руководством
рукотворный: рукотворного
сайт: сайте
сам: сама самого
самый: самый самым
сатурн: сатурн
саудовский: саудовской
световой: световые световых
свой: свое своей своем свой
свыше: свыше
связать: связано
сделать: сделан сделанных
север: севере
сегмент: сегменте
сегодня: сегодня
сегодняшний: сегодняшний
сей: сих
секунда: секунд секунду
семь: семь
сентябрь: сентября
сервер: сервере
сергей: сергей
сердце: сердце
серия: серии
система: систем система системе системы
сказать: сказать
скафандр: скафандрах
скорость: скорости
слипаться: слипаясь
сложный: сложный
служебный: служебным
случай: случае
случайный: случайным
слышать: слышат
смотреть: см смотрит
снимка: снимок
снятой: снятая
собственный: собственной
событие: события
совершить: совершил совершили
совет: совета
советский: советский
согласно: согласно
созвездие: созвездии
создание: создания
создать: созданный
солнечный: солнечной
солнце: солнца
сообщение: сообщении
сообщить: сообщила
соответствовать: соответствует
составить: составило
составлять: составляет составляло
состоять: состоящий
состояться: состоялся
состыковаться: состыковался
сочетание: сочетания
союз: союза союзов
специалист: специалистов
сплюснутый: сплюснутыми
спор: споры
спуск: спуска
сравнивать: сравнивая
среди: среди
стадия: стадии
сталкиваться: сталкиваясь
станция: станции станция
старт: старта старте
стартовать: стартовала
стартовый: стартовая стартовый
статистика: статистику
стать: стал станет стать
статья: статья
степень: степени
стивен: стивен
стоимость: стоимость
стол: стол
страна: стран страны
строительство: строительству
строить: строят
строй: строя
структура: структуры
ступень: ступени ступень
стыковка: стыковки стыковок
суббота: субботу
субкоричневый: субкоричневый
субмиллиметровый: субмиллиметровым
сугубо: сугубо
суммарно: суммарно
сутки: суток
существенный: существенный
сферический: сферической
схема: схеме
счесть: счел
считать: считают
считаться: считается
счёт: счет
сьюзен: сьюзен
таганрог: таганрога
также: также
такой: такого
танкерный: танкерных
твиттер: твиттере
текущий: текущей текущий
телеметрия: телеметрии
телескоп: телескоп телескопов телескопом
тельце: тельца
тепловой: тепловое
техас: техасе
технология: технологии
тип: типа
тонкость: тонкости
точный: точное точных
транквилить: транквилити
треснуть: треснул
туманность: туманность
увеличиваться: увеличиваясь
уверить: уверены
увидеть: увидеть увидим
угловой: угловым угловых
узкоугольный: узкоугольной
узловой: узловой
уитсон: уитсон
указание: указания
управляемый: управляемого
усилие: усилиями
успех: успех
успешно: успешно
успешный: успешную успешным
утверждаться: утверждалось
участие: участие
учёный: ученые
уэбба: уэбба
факт: факту
фил: фила
финальный: финальной
фокусировка: фокусировка
фокусировщик: фокусировщик
фокусный: фокусное
форма: формы
формирование: формирования
фото: фото
франциско: франциско
француз: француза
фундаментальный: фундаментальным
функционально: функционально
фёдор: фёдор
хаббнуть: хаббла
характерный: характерно
хелмс: хелмс
хисамутдинов: хисамутдиновым
хокинс: хокинс
хруничев: хруничева
цветной: цветной цветным
центр: центре
центральный: центральной
цифра: цифр
час: час часов
частица: частиц частицы
частично: частично
частность: частности
часть: частей части
человек: человека
человечество: человечество
черно: черно
четвёртый: четвертого
четыре: четыре
чик: чика
чили: чили
число: числе
чурюмов: чурюмова
чёрный: черная черной черную
шаттл: шаттлами шаттле шаттлов
швеция: швеции
шикарный: шикарный
шлюзовый: шлюзовой
штамп: штамп
штатный: штатно
эволюция: эволюции эволюцию
экран: экранам
эксперимент: эксперимента
экспериментальный: экспериментальный
эксплуатация: эксплуатации
экстренный: экстренная
энтузиаст: энтузиаст
этап: этап этапы
этот: эта этими этих
юар: юар
юбилей: юбилей
южный: южной южном
юнить: юнити
юпитер: юпитера
юрий: юрий
юрчихина: юрчихин
являться: является являясь
ядро: ядро ядром
язев: язев
японец: японцев
япония: японии
японский: японский японских
ясно: ясно
