абсолютно: абсолютно
агостиня: агостини
адронный: адронного адронном адронный
актуальный: актуален
алгоритмический: алгоритмические
анализ: анализом
аналог: аналогов
аполлон: аполлоне
армстронг: армстронга
архитектурный: архитектурных
астроном: астроном
астрофизик: астрофизика
астрофизический: астрофизические астрофизических
атом: атом атома атомами атомах атоме атомов атомы
атомарный: атомарные
атомный: атомных
аттосекунда: аттосекунд аттосекунда аттосекундах аттосекунду аттосекунды
аттосекундный: аттосекундная аттосекундное аттосекундной аттосекундные аттосекундный аттосекундными аттосекундных
база: базу
бак: баке
барьер: барьер
бежать: бежать бежите
безотказность: безотказность
безумно: безумно
безусловно: безусловно
белка: белки
белый: белый
беседа: беседе беседу беседы
бесконечный: бесконечного
бизнес: бизнесе
биологический: биологические
биология: биологии
благодарить: благодарю
благодаря: благодаря
благородный: благородные
близкий: ближайшие близка близкие близок
блин: блин блины
бозон: бозон бозона
больший: большая большее большие большими больших большую
большой: большого большое большой большом
борис: борисов
борисов: борисову
боровский: боровской
брюсов: брюсова
будущее: будущего будущем
будущий: будущие
буквально: буквально
бумажка: бумажку
бутылочный: бутылочное
бывать: бывает
быстро: быстро
быстрый: быстрее быстрые
бытие: бытия
быть: будут
важно: важно
важный: важнее важного важный
валерий: валерия
вариант: вариантов
введение: введение
везде: везде
век: веков
вентиль: вентиль
верифицировать: верифицированы
вероятно: вероятно
вероятноь: вероятноь
версия: версией версии версий
весовой: весовые
весомый: весомая
вести: ведет ведут вести
весь: весь всей всем вся
весьма: весьма
вещество: вещества вещество веществом
вещь: вещи вещь
взаимодействие: взаимодействие
взглянуть: взглянуть
взрыв: взрыва
взять: взять
вид: виде виды
видение: видения
видеоверсия: видеоверсию
видеокарта: видеокарт видеокарты
видеть: видим вижу
видимо: видимо
видимый: видимому
визионер: визионер визионерами визионеров визионеры
визионерство: визионерство
виртуальный: виртуальные виртуальными
вкачивать: вкачивать вкачивают
вкачка: вкачки
вместо: вместо
внести: внесу
внутри: внутри
вовсе: вовсе
водород: водорода
возбудить: возбудить
возбуждать: возбуждает возбуждать
возбуждение: возбуждение возбуждений возбуждения
воздействие: воздействию воздействия
воздействовать: воздействовать воздействует воздействуете
возможно: возможно
возможность: возможности возможность
возможный: возможна возможных
возникать: возникает возникают
возникнуть: возник возникли
война: войны
вокруг: вокруг
волновой: волновыми
вообще: вообще
вопрос: вопрос вопроса вопросов вопросом вопросу вопросы
восемнадцать: восемнадцать
востребовать: востребован востребовано
восхититься: восхититься
восхищение: восхищения
вполне: вполне
временной: временные временных
время: времен времена временам временах времени время
вроде: вроде
вряд: вряд
вселенная: вселенная вселенной
всплеск: всплеском
встать: встать
встретиться: встретимся
встреча: встречи
всюду: всюду
всякий: всякие всяких всяком
всё: всё
вторичный: вторичное
второй: второй второму
выбрать: выбрать
выгодный: выгоднее
выделить: выделить
выделяться: выделяется
вызвать: вызовет
выпускник: выпускник
выражаться: выражаться
высадка: высадка
высокий: высокими высоких высокой
высокопарно: высокопарно
вытравка: вытравки
выход: выход
выходить: выходить
вычисление: вычислений вычисления
вычислительный: вычислительные вычислительных
газ: газов
газа: газы
гарантия: гарантия
гармоника: гармоник гармониками гармоники
гвоздика: гвоздик
генератор: генераторов
гигагерц: гигагерцы
гигантский: гигантских
гипотетически: гипотетически
главный: главная главный
говорить: говорили говорим говорит говорить говорю говоря говорят
год: год года году годы лет
гора: горами
гораздо: гораздо
горизонт: горизонте
горлышко: горлышко
готовить: готовить
градостроительство: градостроительстве
градус: градусов
грань: грань
графика: графика графикой
графический: графические графическими
грид: грид
группа: групп группа группе группы
давать: давай дает
давно: давно
далее: далее
дальнейший: дальнейших
далёкий: далеки
данные: данными
данный: данном
дать: дайте дали даст
два: две двумя двух
двадцать: двадцати
дверь: дверь
двигатель: двигателей двигатели двигателям
двигать: движет
двигаться: двигаться движется движутся движущегося
движение: движение движения
двухнанометровый: двухнанометровые
действие: действия
действительно: действительно
дейтрий: дейтрием
делать: делать делают делая
делаться: делаются
дело: деле
демонстрация: демонстрации
день: день дни дня
деструктивный: деструктивная
десятилетие: десятилетий
десятка: десятки
десяток: десятков
десять: десять
детальный: детальную
деятельность: деятельности
джет: джеты
диагностик: диагностику
диагностика: диагностике диагностики
диагностировать: диагностировать
диагностический: диагностические
диапазон: диапазон диапазонах диапазоне
динамика: динамике
диод: диод диодам
дистанция: дистанции дистанциями
диэлектрик: диэлектрик диэлектрика диэлектрики
длина: длины
длинный: длиннее длинный
длительность: длительности длительность длительностью
дмитрий: дмитрий дмитрию
добираться: добираемся
добиться: добиться
добрый: добрый
довольно: довольно
доклад: докладах
докт: докт
должный: должен должны
доля: доли
доплера: доплера
допустить: допустим
дорого: дорого
достаточно: достаточно
достигнуть: достигнут
достижение: достижение достижения
др: др
дрейфовать: дрейфует
друг: друг другом
другой: другая другие другим других другого
дубна: дубна дубне
думать: думай думаю
дёргать: дергает
единица: единицу единицы
единичный: единичными
естественно: естественно
естественный: естественная
ждать: ждут
желательно: желательно
журналист: журналист
забить: забить
забраться: забраться
зав: зав
заведовать: заведующий
завернуть: заверните
завтра: завтра
завтрашний: завтрашнего завтрашний
заговорить: заговорили
задача: задач задачи
задвижка: задвижки
задеть: задел
зажечься: зажглась
зайти: зайдет зайти зашел
закон: законам законов
закончить: закончили закончить
закрывать: закрывает закрывая
замечательный: замечательного
заниматься: занимается занимаешься занимаюсь занимающейся
заняться: занялся
заполнить: заполнить
запрос: запросу
запросто: запросто
запустить: запустить
запутать: запутанных
заранее: заранее
заставить: заставить
заставлять: заставляя
застой: застой
засунуть: засунув
затем: затем
затишье: затишье
затормозиться: затормозиться
затрата: затратам
затратить: затрачено
затронуть: затронем
захотеть: захотите
захотеться: захотелось
зачастую: зачастую
звать: зовут
звезда: звезды
звучать: звучит
здоровый: здоровая
зептосекунда: зептосекунды
зептосекундный: зептосекундным
зеркало: зеркала зеркало зеркалом
знак: знаком
знание: знанья
знать: знаем знает знаешь знать знаю
значение: значение
значимость: значимость
значит: значит
зона: зону
зрение: зрения
зря: зря
идеологически: идеологически
идея: идеи идей
идти: идем идет идти
излучать: излучает
излучение: излучение излучения
изменять: изменять
измерительный: измерительные
изучать: изучать изучают
изучить: изучить
илона: илон илона
именно: именно
иметь: имеем имеет имеют
иметься: имеется
импульс: импульс импульса импульсам импульсами импульсах импульсов импульсом импульсу импульсы
инженерный: инженерно
инновация: инновации
иной: иного иной иному иных
институт: института
инструмент: инструмент инструмента инструментов инструменты
интегрировать: интегрировать
интеллект: интеллект интеллекта интеллекту
интеллектуальный: интеллектуальный
интервью: интервью
интерес: интереса интересов интересом
интересно: интересно
интересный: интересен интересная интересный
интересоваться: интересуюсь
интерференция: интерференцию
информация: информацию информация
инфракрасный: инфракрасном
ион: ион ионах ионы
ионизовать: ионизовать ионизует
ионизовывать: ионизовывать
ионный: ионные
искусственный: искусственного искусственному искусственный
искусство: искусства искусстве
испариться: испарилась
использование: использование использования
использовать: использовать используем используют использующие используя
использоваться: используется используются
исследование: исследований исследования
исследователь: исследователя
исследовательский: исследовательские
исследовать: исследовать
история: истории
источник: источнике источников
исходить: исходить
исходный: исходное
исчисляться: исчисляется
итог: итоги
итэр: итэр
ия: ии
к: ко
кадараш: кадараше
кадр: кадров
каждый: каждой каждую каждые каждый
казаться: кажется казавшиеся
какой: какие каким какими каких какого какое каком какую
канал: каналах
карта: карты
картинка: картинки
касательно: касательно
катализатор: катализатором
катализировать: катализировать
категория: категории
кафедра: кафедре кафедрой кафедры
качественно: качественно
качество: качестве качество
квалифицировать: квалифицировать
квантовый: квантового квантовой квантовом квантовые квантовый квантовыми квантовых
километр: километров
класс: класса
классический: классических
клон: клонов
когерентность: когерентности
когерентный: когерентно
количество: количества количество
коллайдер: коллайдер коллайдера коллайдере
коллега: коллегами
коль: коль
колько: колько
компания: компании компанию компаниями
компьютер: компьютер компьютера компьютерами компьютерах компьютеров компьютером компьютеру компьютеры
компьютинг: компьютинг компьютинге
конденсировать: конденсированным конденсированными
конкретно: конкретно
конкуренция: конкуренция
конкурировать: конкурируют
константа: константа константой
конструктивный: конструктивная конструктивную
контролировать: контролировать контролируемым
конференция: конференциях
концепция: концепции
копайлот: копайлота
копия: копию
коробочка: коробочка
королёв: королёва
короткий: короткая короткие короткий коротким короткими коротких короткого короткое короткой короток
коротко: коротко
короче: короче
космонавт: космонавтов
космос: космос космосе космосом
который: которая которого которое которой котором которому которую которые который которым которыми которых
коэффициент: коэффициент
край: крае
крайне: крайне
краус: краус
кристалл: кристаллами кристалле
критиковать: критиковали
кроме: кроме
круг: круг
круто: круто
кстати: кстати
кубит: кубитов кубиты
культура: культуре
культурный: культурных
купить: купить
кутрита: кутриты
лаборатория: лаборатории лабораторию
лабораторный: лабораторная
лавина: лавину
лазер: лазер лазерами лазеров лазеры
лазерный: лазерная лазерного лазерное лазерной лазерную лазерные лазерный лазерным лазерными лазерных
лауреат: лауреат
легко: легко
лекция: лекциях
либо: либо
лидер: лидерами
линейно: линейно
линейный: линейному
литографический: литографических
литография: литографии
лоб: лоб
лобачев: лобачев
ловушка: ловушки
луна: луне луну
любитель: любитель
любить: люблю
любой: любого любое любой
лёгкий: легкой
магнитный: магнитные
максим: максим максиму
максимум: максимум
маленький: маленькие маленький маленькой меньше
мало: мало
маловатый: маловато
малый: малая малых меньшие меньших
маск: маск
маска: маска
массовый: массовое
масштаб: масштаб масштаба масштабах масштабов масштабом масштабы
масштабирование: масштабирование
масштабировать: масштабируя
мат: мат
математика: математики математику
математический: математический
материал: материалов
материк: материков
машина: машинах
мгновенно: мгновенно
мгц: мгц
мегагерц: мегагерца
мегаджоуль: мегаджоули
медицина: медицине
мелкий: мелкие
менее: менее
менять: менять
мера: мере
месяц: месяцев
метавселенная: метавселенной
метод: метод
механизм: механизма
мечтать: мечтают
микроджоуль: микроджоули
микрометр: микрометры
микрочастица: микрочастиц микрочастицы
миллиард: миллиард миллиарда миллиардов
миллиардный: миллиардной
миллиджоуль: миллиджоули
миллион: миллион миллионы
мимо: мимо
миниатюризировать: миниатюризировать
минимальный: минимальная
минус: минусы
мир: мир мира миры
мировой: мировая
мифь: мифи
мишень: мишени мишень
многие: многие
многий: многими многих
многовато: многовато
многое: многое
моделирование: моделирования
модель: модели
мой: моего моей моему
молекула: молекул молекулами молекуле молекулы
молекулярный: молекулярные
молоток: молотком молоток
момент: момент
монополизм: монополизм
московский: московского
мост: мост
мотивировать: мотивирует
мочь: мог могла могли могу могут можем можете
мощность: мощностей мощности мощностями мощностях
мощный: мощные мощным
музей: музеи
мы: нам нами
мысль: мысль
набирать: набирать
наблюдать: наблюдаем
набор: набор
набрать: набрать
наверное: наверное
наверняка: наверняка
навстречу: навстречу
надежда: надежда
надеяться: надеемся надеюсь
назад: назад
название: названия
называть: называемая называемому называемых
называться: называется называются
наивный: наивными
найти: найдены
накачка: накачки
наличие: наличие
наноджоуль: наноджоули
наномасштаб: наномасштабов
нанометр: нанометра нанометров
нанометровый: нанометровый нанометровых
наноразмер: наноразмеров
наносекундный: наносекундный
написание: написания
написать: написанные
напоследок: напоследок
направление: направлении направления
напрашиваться: напрашивается
например: например
напрямую: напрямую
напрячь: напряженных
нарушать: нарушающая
насколько: насколько
настолько: настолько
натягиваться: натягивается
наука: наук наука науке
научаться: научаются
научиться: научились научись научитесь научиться
научный: научного научной научную научные научный научными
находиться: находимся находится находятся
начало: начале
начать: начал начнете
начинаться: начиналась
наш: нашего нашей нашем наших
нащупать: нащупать
небольшой: небольшие
невозможно: невозможно
невозможность: невозможности
невозможный: невозможен невозможного
неделимый: неделимы
недоступный: недоступны
недра: недра
нежели: нежели
независимый: независимую
нейтральный: нейтральные
нейтрино: нейтрино
некий: некая некий некое
некоторый: некоторые
немного: немного
немножко: немножко
необходимо: необходимо
неожиданно: неожиданно
непостижимо: непостижимо
неправильный: неправильной
непростой: непростая
несколько: нескольких несколько нескольку
неустойчивость: неустойчивости
нечасто: нечасто
нечто: нечто
ниже: ниже
низкоэнергетический: низкоэнергетическая
никакой: никакой
никто: никто
ничтожный: ничтожна ничтожные
нияу: нияу
нм: нм
нобелевский: нобелевский нобелевских нобелевской нобелевскую
новый: новая новой новом новую новые новый новых
ноздря: ноздрю ноздря
носитель: носителем носители носитель
нуждаться: нуждается
нужно: нужно
нужный: нужен нужна нужного нужны нужными
нынешний: нынешним
оба: обеим
обеспечить: обеспечен обеспечили
обещать: обещает
обзор: обзорах обзоры
обладать: обладает обладают
область: областей области область областью областям областях
облучаться: облучается
обобщить: обобщить
обозримый: обозримом
обоснованный: обоснованные
образ: образом
образование: образовании
обратно: обратно
обратный: обратную
обсуждать: обсуждаемых обсуждали
обсуждаться: обсуждавшиеся
обсуждение: обсуждение
обучаться: обучался
обучение: обучения
общий: общем
объект: объект объектов
объективно: объективно
объём: объеме объемы
обычно: обычно
обычный: обычный обычным обычных
обязательно: обязательно
ограничение: ограничения
ограничить: ограничено
огромный: огромная огромное огромный огромным огромных
один: одна одно одной одну
одновременно: одновременно
одногруппник: одногруппника
одолеть: одолеть
ожидание: ожидании
ожидать: ожидать
означать: означать
оказаться: окажется оказалась оказаться
оказываться: оказываясь
окей: окей
окно: окно
около: около
околосветовой: околосветовой
окружать: окружает окружают
окружающий: окружающего
оммический: оммическое
они: ими ними
оно: оно
оперировать: оперируя
описание: описанием
определённый: определенного определенное определенный определенным
оптика: оптика оптики оптикой
оптический: оптические оптический оптическим оптических оптического оптическом оптическому
опубликовать: опубликованы
орбита: орбите
освоение: освоении
освоить: освоенное
основа: основе
основатель: основатель
основное: основном
основной: основные
основный: основная основное основным
особенность: особенность
оставаться: остается
оставлять: оставляем
остановиться: остановится
остаток: остатки
ось: оси
ответ: ответ
ответить: ответить
отвёртка: отвертка
отдельный: отдельный
отказоустойчивость: отказоустойчивостью
открутить: открутить
открывать: открывать
открываться: открывается
открытие: открытие
открытость: открытость
открыть: открыт открыть
отличаться: отличается отличаются
отметить: отметил отметить отмеченное
отношение: отношении
отойти: отойду
отправлять: отправляющего
отражать: отражаете
отразить: отразить
отрасль: отраслей отрасли
отрубить: отрубить
отсекать: отсекает
отслеживать: отслеживая
отставать: отстаем
отсюда: отсюда
отыскание: отысканием
очевидный: очевидна
очень: очень
очередь: очередь
очерчивать: очерчивает
падать: падает
память: память
пара: пару
параметр: параметров параметры
пауза: паузу
первый: первая первую первый первым первых
перебор: перебором
перебрасывать: перебрасывать
перебраться: перебраться
перевернуть: перевернем
передний: переднем
перейти: перейдем перейти
переключатель: переключатель
переключение: переключение
переложение: переложением
переложить: переложив
перелом: перелом
перемещаться: перемещаться
пересечение: пересечение
переход: переход переходе переходы
переходить: переходить
пикоджоуль: пикоджоули
пинцет: пинцет
плавно: плавно
плазма: плазме плазмой плазму плазмы
плазменный: плазменное плазменной плазменные плазменный плазменных
план: плане
планета: планет планетой
плотность: плотность
плохой: хуже
площадь: площади
плюс: плюс плюсы
плёнка: пленки
поблагодарить: поблагодарить
повод: поводом поводу
повседневность: повседневность
повсюду: повсюду
повторение: повторения
повторяемость: повторяемости
повторять: повторять
повысить: повысить
повышение: повышения
погасить: погасила
погода: погоды
погрузить: погружен
подарок: подарок
подать: подано
подвергать: подвергаете
подвижка: подвижки
подготовить: подготовив
поддержать: поддержит
поднимать: поднимал
поднять: поднять
подобрать: подобрать
подобраться: подберется
подразумевать: подразумеваю
подробный: подробное поподробнее
пожалуй: пожалуй
позволить: позволил позволит позволят
позволять: позволяет позволяют позволяющие позволяющую
поздно: поздно
познание: познанием
поискать: поискал
пойти: пойти
пока: пока
полгода: полгода
поле: поле полей полем поля полями
полезный: полезны
полететь: полетела
полноценный: полноценную
полный: полное полной
половина: половиной
положение: положение положениями
полтора: полутора
полупопулярный: полупопулярных
полупроводник: полупроводник полупроводника полупроводниками полупроводники
получать: получаете получать
получаться: получается
получение: получения
получить: получил получили получить
получиться: получилось получился получится
поменять: поменять
померить: померить
помощь: помощи помощью
понимание: пониманием
понимать: понимаем понимать понимаю
понятно: понятно
понять: поймем понял понять
попадать: попадают
попробовать: попробовать попробуй попробую
попросить: попрошу
попруженко: попруженко
популярный: популярных
попытаться: попытаться
пора: пор
порождать: порождает
поручаться: поручается
порядок: порядка порядков порядок
посветить: посветить
поскольку: поскольку
послать: послать
последний: последние
последовательность: последовательности последовательность
последствие: последствия последствиями
послезавтра: послезавтра
посмотреть: посмотреть
постоянный: постоянная
построить: построен построить
потенциал: потенциал
потенциально: потенциально
потенциальный: потенциальное
потребление: потребления
потребность: потребности
потрясать: потрясающими
пофантазировать: пофантазировать пофантазируем
похожий: похожие
почему: почему
поэтому: поэтому
появиться: появилась появилось
появление: появлении появления
появляться: появляется появляются
правило: правило
правильно: правильно
право: право
правый: правым
прагматичный: прагматичные
практически: практически
практический: практические
превратить: превратить
превратиться: превратится
превращаться: превращается
предвидеть: предвидеть
предел: предел пределами
предлагать: предлагаю
предложить: предложено предложить
предоставлять: предоставляемые
предсказание: предсказанием
предсказывать: предсказывать
представить: представить представлена
представиться: представиться
представление: представлений
предугадать: предугадать
предыдущий: предыдущая предыдущий предыдущих
прежде: прежде
преимущество: преимущества преимущество
прекрасный: прекрасную
преломление: преломления
премия: премией премию премиях
преобразование: преобразование
преодолеть: преодолеть
преодолимый: преодолимы
препятствие: препятствия
прибор: приборы
приветствовать: приветствую
привлечение: привлечения
приводить: приводит привожу
приглашение: приглашение
придумывать: придумывать
прийти: прийти
прикладывать: прикладывать
прикрутить: прикрутить
прикручиваться: прикручивается
приложение: приложении приложений
приложимый: приложимо
применение: применение применением применении применений применения применениях
применительно: применительно
применить: применить
применять: применять
пример: пример
примерно: примерно
принести: принесет
принцип: принципа принципе
принципиально: принципиально
принципиальный: принципиальной
принять: приняла
природа: природе природы
присоединиться: присоединиться
приходить: приходят
приходиться: приходится
причина: причинам
проблема: проблем проблема проблемы
проводимость: проводимости проводимость
проводиться: проводятся
проводник: проводник проводника проводники
прогноз: прогнозами
программист: программисты
прогресс: прогресс прогресса прогрессом
продаваться: продается
продвижение: продвижение
продолжение: продолжения
продолжить: продолжил
проект: проекте
произведение: произведение
производитель: производители
производить: производить
производство: производстве
произойти: произойдет произошел
происходить: происходит происходят
пройти: пройти прошло
пролететь: пролететь
промежуток: промежутками
промоделировать: промоделировать
проникнуть: проникнуть
прорыв: прорыв прорывы
прорывный: прорывные
прослушать: прослушал
просто: просто
простой: проще
протекать: протекает протекают протекающие
профессионал: профессионалы
профиль: профилем
проходить: проходят
процент: процента
процесс: процесс процессе процессов процессы
процессор: процессор процессорами процессоров
прошлое: прошлого
прошлый: прошлом
прямо: прямо
пусть: пусть
путь: пути
путём: путем
пытаться: пытаемся пытаетесь пытаются
пьер: пьера
пять: пять
пятьдесят: пятидесяти пятьдесят
работа: работа работой работы
работать: работаем работает работаете работал работала работало работать работают работающие
рабочий: рабочее рабочим рабочих
радикал: радикал
радовать: радует
развернуть: развернул
развиваться: развивается
развитие: развитие
развиться: разовьются
разговор: разговора разговоре разговору
раздел: раздел
разделить: разделены
разделять: разделяя
разлетаться: разлетаются
различный: различных
размер: размер размера размеры
разный: разное разные разных
разработать: разработана
разрастись: разрастется
разрешение: разрешением
ракета: ракет ракета ракету
рамка: рамки
ранее: ранее
ранний: раньше
рано: рано
распоряжение: распоряжение распоряжении
рассказать: рассказать
рассказывать: рассказывает рассказывающий
рассчитать: рассчитать
расти: растут
реактор: реакторов
реакция: реакции реакцию реакция
реализация: реализацией реализаций
реализовать: реализовано
реализовывать: реализовывать
реально: реально
реальность: реальности реальность
реальный: реальная реального реальном реальных
регистрироваться: регистрируются
режим: режиме
результат: результат результате результату
резюмировать: резюмирую
релаксировать: релаксируют
реплика: реплик реплика реплики
ресурс: ресурсов
реферат: рефераты
речь: речь
решаться: решаюсь
решающий: решающих
решение: решении решения решениями
решить: решена решены решить
рисовать: рисуют
рисунок: рисунка
род: рода
родиться: родился
родственный: родственное
рука: руки
руководитель: руководитель
сам: сама сами самом
самостоятельно: самостоятельно
самый: самое самые самым
сближать: сближают
сверхвысокий: сверхвысоких
сверхкороткий: сверхкороткие сверхкороткими сверхкоротких
сверхмощный: сверхмощных
сверхновый: сверхновой
сверхсильный: сверхсильные
свет: света свете светом
светить: светить
свидетель: свидетелями
свой: свое своей своих
свойство: свойства свойствами
свысока: свысока
связанный: связанных
связать: связан связана связанная связано
связь: связи связь
сделать: сделает сделаете сделал сделала сделана сделано сделать
сегодня: сегодня
сегодняшний: сегодняшнего сегодняшней сегодняшние сегодняшний сегодняшних
сей: сих
секунда: секунд секунда секунде секунду секунды
сервер: серверы
сергей: сергеем сергей сергею сергея
серьёзный: серьезного серьезное
сжатый: сжатом
сжаться: сжаться
сжимать: сжимает
сила: сила
сильно: сильно
сильный: силен сильная сильные сильным
симбиоз: симбиоз
синтез: синтез синтеза
синхронизировать: синхронизировать
система: систем систему системы
скажем: скажем
сказать: скажет сказал сказать
скан: сканы
сканирование: сканирование
сканировать: сканировать
скептик: скептикам
сколько: сколько
скорее: скорее
скоро: скоро
скорость: скорости скорость скоростью
скучный: скучный
слабый: слабые
следить: следим
следовать: следует
следующий: следующих
слишком: слишком
слияние: слияния
слово: слово
сложить: сложить
сложиться: сложились
сложно: сложно
сложность: сложности
сложный: сложная сложное сложны сложные сложный сложных
служить: служить
случай: случае
случайно: случайно
слушатель: слушателей
слушать: слушаю
слышать: слышу
смежный: смежных
смотреть: см смотреть смотри смотрит
смочь: сможем
смысл: смысле
сначала: сначала
собираться: собираетесь
собственно: собственно
событие: событие
совершенно: совершенно
совершенствование: совершенствование
советский: советских
совместить: совместить
совмещение: совмещение
содержательный: содержательную
содержаться: содержится
соединить: соединенных
создавать: создаваемой создаем
создаваться: создаются
создание: создание созданием создании создания
создать: создать
соответственно: соответственно
соотечественник: соотечественников
сопоставимый: сопоставима
сопрячь: сопрячь
сорок: сорока
соседний: соседними
состав: состав
состояние: состоянием состояния состояниями
состоять: состоит
сотня: сотни
спасибо: спасибо
спектр: спектр
специализация: специализация
специалист: специалист
специфика: специфике
спорт: спорта
способ: способами
спустя: спустя
сработать: сработает сработать
сравнение: сравнению
сравнимый: сравнимых
сравнительный: сравнительные
сразу: сразу
среда: среду среды
стабилизировать: стабилизировать
сталкиваться: сталкивается
стандарт: стандарт стандартами
стандартный: стандартная стандартной
становиться: становимся становится
старший: старше
старшип: старшипом
стать: станут стать
статья: статьями
стена: стена
степень: степенью
стимулировать: стимулирует
стих: стихи
сто: ста сто
стоить: стоит
стол: стол
столкновение: столкновения
столь: столь
столько: столько
стоп: стоп
сторона: сторона сторону стороны
стоять: стоят
страна: страны
строиться: строятся
структура: структуру структуры
структурный: структурную
студент: студентам
студенческий: студенческие
стык: стыке
субатомный: субатомные
субфемтосекундный: субфемтосекундная субфемтосекундные
сумбур: сумбур
суперкомпьютер: суперкомпьютерам суперкомпьютеров
суперпартнёр: суперпартнеры
суперпозиция: суперпозиции
суперсимметрия: суперсимметрия
существенно: существенно
существовать: существует существуют
существующий: существующими
сфера: сфер
сфокусировать: сфокусировать
сцена: сценой
считать: считали
сша: сша
тайваньский: тайваньской
также: также
таки: таки
такой: такая такие таким такими таких такого такое таком
тактовый: тактовая тактовую тактовые
тандем: тандеме
твой: твоя
твёрдый: твердых
телевидение: телевидении
тело: тел телами тело
тема: тема теме тему темы
тематика: тематике
теоретически: теоретически
теоретический: теоретическая теоретических теоретической
теория: теория
тепло: тепло
терагерца: терагерцы
терминология: терминология
термояд: термояд термояде
термоядерный: термоядерного термоядерной термоядерную термоядерный термоядерных
технически: технически
технический: техническая технические техническим техническими технических
технологический: технологические технологическими технологического технологическое
технология: технологии технологий технология технологиям технологиями технологиях
течение: течение
тип: типа типы
ток: токи токов
токамак: токамак токамаках токамаке токамаки
тонкий: тонкой
торий: торий тория
тот: та те теми тех той тому
точка: точки
точно: точно
точный: точное точный
транзистор: транзистор транзистора транзисторам транзисторов
транзисторный: транзисторный
трансформировать: трансформируете
трафик: трафика
требовать: требует
требоваться: требуется
третий: третий
три: трех
тридцать: тридцать
тритий: тритием
трон: троны
трудно: трудно
трудность: трудность
трудоёмкий: трудоемкий
трудоёмкость: трудоемкости
трёхмерный: трехмерная трехмерное трехмерной трехмерными трехмерных
туда: туда
туманный: туманный
тупик: тупик
туризм: туризме
ты: тобой
тысяча: тысяч тысячу
тяжёлый: тяжелых
увеличение: увеличению
увеличиваться: увеличиваются
увеличить: увеличим увеличить
уверенно: уверенно
уверенный: уверен
увидеть: увидели увидеть
углубляться: углубляться
угодный: угодно
угол: углах
удержание: удержания
удерживать: удерживать
удивительно: удивительно
удобно: удобно
удобный: удобен удобная удобнее удобный
ужас: ужасы
узкий: узкий узкого
узко: узко
уйти: уйти
указка: указки
укоротить: укоротить
ультракороткий: ультракоротким
ультрафиолетовый: ультрафиолетового ультрафиолетовые
уметь: умеете умели
уникальный: уникальное
упадок: упадок
упаковать: упаковать
упаковка: упаковки
упереться: упрется упрутся
управление: управления
управлять: управлять
уравнение: уравнение
уровень: уровне уровни
усилие: усилиями
ускорение: ускорение
ускоритель: ускорителей
ускорить: ускорить
ускорять: ускоряем ускоряет
ускоряться: ускоряется
условный: условного
успешно: успешно
установка: установке
устойчивый: устойчивого
устроить: устроить
устройство: устройства
утверждение: утверждении
утилитарный: утилитарным
уточнять: уточнять
ухищрение: ухищрениями
уходить: уходить
участок: участка
учитывать: учитывая
учёный: ученого учеными
фаза: фазами
фазовый: фазовый
факт: факт
фактически: фактически
факультет: факультет факультета
фантазировать: фантазировать фантазируем
фантастика: фантастику
фемтосекундный: фемтосекундная фемтосекундные фемтосекундный фемтосекундными
ференц: ференц
физ: физ
физик: физиков
физика: физика физике физики физикой
физический: физический физического
фокусировка: фокусировка
фольга: фольги
формула: формул
формулировка: формулировка
фотография: фотографий
фотон: фотона фотонов фотоны
фотоник: фотоника
фотоплёнка: фотопленка
французский: французском
фронтир: фронтир
функция: функциями
фурье: фурье
характерный: характерны
хиггс: хиггса
химический: химическую
ходовой: ходовые
хороший: лучшее хороша хорошая хорошего хорошее хороши хороший хорошим
хотеть: хотел хотите хочу
хотеться: хотелось хочется
хотя: хотя
целое: целом
целый: целая целый
церн: церн церне
цифра: цифры
цифровой: цифровых
частица: частиц частицы
частность: частности
часто: часто
частота: частота частотами частотах частотой частоту частоты
частый: чаще
часть: часть частью
человек: люди людьми человека
человеческий: человеческого
чип: чипы
число: числе
чистый: чистой
читатель: читателей читателя
чрезвычайно: чрезвычайно
шесть: шесть
ширина: шириной
широкий: широкая широкий широкого
шрёдингер: шрёдингера
штангенциркуль: штангенциркуль
штат: штатов
шум: шум
шутить: шутят
щелочной: щелочных
щель: щель
щёлкнуть: щелкнуть
эв: эв
эволюция: эволюция
экономика: экономики
экономия: экономия
эксперимент: эксперименты
экспериментально: экспериментально
экспериментальный: экспериментальная
экспериментатор: экспериментаторов
эксперт: эксперты
экспромт: экспромт
электромагнитный: электромагнитного электромагнитное электромагнитные электромагнитный электромагнитным электромагнитных
электрон: электронов электрону электроны
электронвольт: электронвольт
электронный: электронная электронных
элементарно: элементарно
элементарный: элементарное элементарные элементарных
эмоциональный: эмоциональная
эмпирически: эмпирически
энергетика: энергетика энергетике энергетики
энергетический: энергетические энергетических
энергия: энергией энергии энергий энергию энергия энергиями энергиях
энергозатраты: энергозатрат
энергоресурсы: энергоресурсах
энергосистема: энергосистема
эпохальный: эпохальное
этап: этапе
это: этим
этот: эта этими этих
эффект: эффекта
эффективность: эффективности
явиться: явился
явление: явлений
являться: является являются
ядерный: ядерная ядерной ядерные ядерных
ядро: ядра ядрах ядром
язык: язык
ясно: ясно
