автор: авторов авторы
аккреции: аккреции
аккреционный: аккреционных
аккреция: аккреция
андрей: андреем андрей
астроном: астрономов
база: базой
бить: бьет бьют бьющих
благополучно: благополучно
блазар: блазаров блазары
близкий: ближе близка близкий
близлежащий: близлежащий
блуждать: блуждающих
блэндфорд: блэндфорда
болгария: болгарии
больший: большая больших большую
большой: большое велика
борис: борис
борода: бороды
важность: важность
важный: важное
вверху: вверху
вдвое: вдвое
вдоль: вдоль
великобритания: великобритании
весь: всей
вещество: вещества
видно: видно
видный: виден видны
включать: включает
вместе: вместе
вместо: вместо
внегалактический: внегалактическая
внешний: внешней
внутренний: внутренним
возможно: возможно
возможный: возможных
возраст: возраст возрасту
войд: войдов
войда: войд войды
волна: волн волны
вообще: вообще
воспроизводиться: воспроизводится
вплоть: вплоть
вполне: вполне
вращаться: вращающейся
вращение: вращения
врезка: врезки
время: времена времени
вряд: вряд
всаживать: всаживаемая
вселенная: вселенная вселенной
всё: всё
вывод: вывод
выглядеть: выглядит
выплёвываться: выплевывается
высокий: высоких
выше: выше
галактика: галактик галактика галактики галактикой
гамма: гамма
генерация: генерации
германия: германии
гигант: гиганта
гигантский: гигантских
говорить: говоря
год: года лет
горячий: горячие
гс: гс
давать: давало
далеко: далеко
данные: данными
дать: дано
действительно: действительно
делаться: делался
держаться: держался
десятка: десятки
десять: десять
детектор: детектор
дециметровый: дециметровом
джет: джет джета джетами джете джетов джету джеты
диапазон: диапазонах
диск: диски дисков диском
дисковый: дисковая
длина: длина длинах
длинноволновый: длинноволновой длинноволновых
длинный: длинный
довольно: довольно
должный: должно
дополнение: дополнение
дополнительный: дополнительный дополнительных
древнегреческий: древнегреческого
другой: другого
дыра: дыра дырой дыру дыры
европа: европу
европейский: европейского
естественный: естественный
живой: живое
завысить: завышены
задача: задача
задержка: задержкой
заключаться: заключается
замагнитить: замагниченной
замедление: замедление
заметить: заметить
заметный: заметные
зато: зато
знаек: знаека
значение: значений
значит: значит
зоопарк: зоопарк
зрелищный: зрелищный
известный: известны известный
излучающий: излучающих
излучение: излучение излучения
изображение: изображений изображения
именно: именно
имя: имени
иначе: иначе
инжектировать: инжектирует
интенсивный: интенсивной
интервал: интервал
интерферометр: интерферометр интерферометрам
ионосфера: ионосферу
ирландия: ирландии
исключить: исключен
использоваться: используется
испустить: испущенных
источник: источник источника источников
исходить: исходя
италия: италии
итог: итоги
каждый: каждый
казаться: кажутся
карта: карта карте карты
каскадный: каскадное
квазар: квазар квазара квазаров квазары
квант: квант квантам кванты
квантовый: квантов
количество: количество
команда: команда
комптоновский: комптоновское
конец: концах конце
конечный: конечном
коротковолновый: коротковолновым
космический: космический
который: которое котором которые который которых
кпк: кпк
край: крае
красный: красном
кризис: кризис
кроме: кроме
крупномасштабный: крупномасштабной
латвия: латвии
лебедь: лебедь лебедя
левый: левая
либо: либо
лишь: лишь
лишённый: лишенное
лопасть: лопасти
лоренц: лоренц
магнитный: магнитного магнитное магнитным
магнитогидродинамический: магнитогидродинамический магнитогидродинамическим
максимальный: максимальной
маленький: меньше
массив: массив массива
масштаб: масштабу
материя: материей
машина: машины
мгц: мгц
межгалактический: межгалактическое межгалактической
международный: международная
менее: менее
механизм: механизм механизма механизмов
миллиард: миллиарда миллиарды
мифологический: мифологического
многий: многих
могучий: могучего
моделирование: моделирования
модель: моделей модель
мочь: могут
мощность: мощность
мпк: мпк
мс: мс
наблюдаться: наблюдается наблюдаются
наблюдение: наблюдений наблюдения
назад: назад
название: название
называть: называемый
наиболее: наиболее
накачать: накачанная
накачивать: накачивают
наматываться: наматывается
направление: направления
насколько: насколько
находиться: находится находящуюся
начало: начале
наш: нашей
небо: небо
небольшой: небольших
немного: немного
немой: нем
нерон: неронов
нероновое: нероновым
нидерланды: нидерландах
нижний: нижнем
низкий: низких
нить: нити
новый: нового новому
оба: оба обе
облако: облака
обнаружить: обнаруженный обнаружены обнаружила
образ: образом
обстоятельство: обстоятельства
объект: объекту
объяснять: объясняют
объём: объема
обычно: обычно
огромный: огромном
около: около
окружающий: окружающего окружающей
оно: оно
определить: определить
оптика: оптике
оптический: оптического
ориентироваться: ориентируются
особенно: особенно
ось: оси
отклонить: отклонен
открытие: открытия
относительно: относительно
оценка: оценкам оценки
очень: очень
очередь: очередь
пара: пару пары
параметр: параметрам параметры
парсек: парсеках
первичный: первичные
первый: первых
переводить: переводя
передний: переднем
пинать: пинают
пк: пк
плазма: плазмой плазмы
плоскость: плоскости
плотный: плотная
плохой: хуже
подгонка: подгонок
подобный: подобные
позитронный: позитронные
показывать: показывающий
полвека: полвека
поле: поле полем поля
получить: полученные получены
получиться: получилось
польша: польше
полюс: полюсов
помогать: помогает
помощь: помощью
попытаться: попытались
пора: пор
порождать: порождают
порфирион: порфирион порфириона
порядок: порядка порядок
посильный: посильней
последний: последнего
поставить: поставлен
постепенно: постепенно
поток: поток потока потоком
правда: правда
правый: правая
превышать: превышает
предел: предел
предложить: предложенный
предположение: предположение предположений
прекрасно: прекрасно
прилетать: прилетают
пример: пример
приходиться: приходится
причина: причина причины
причём: причем
пробивать: пробивает
проблема: проблема
проект: проект
пронзить: пронзил
пространство: пространство
протяжённый: протяженное
проходить: проходят
прямолинейность: прямолинейность
путь: пути
пучок: пучком
пятно: пятна пятно
работа: работы
работать: работает работают работающим
радиоастрон: радиоастрон
радиодиапазон: радиодиапазон
радиоизлучение: радиоизлучению
радиоинтерферометр: радиоинтерферометром
радиоисточник: радиоисточник
радиокарта: радиокарта
радиотелескоп: радиотелескоп радиотелескопов
развеваться: развевающиеся
размах: размах размаха размахом
размер: размерам размеру
разрастись: разросся
разредить: разреженная
разрешение: разрешение разрешением
распространить: распространена распространенным
рассеяние: рассеяние
рассматривать: рассматривать
расстояние: расстоянии
реагировать: реагируют
результат: результате
рекорд: рекорд рекорду
рекордный: рекордного
реликтовый: реликтового
релятивисский: релятивисские
релятивистский: релятивистские релятивистских
рис: рис
родительский: родительская
родиться: родился
рыть: рыть
сам: самого самой самом
самый: самое самых
сантиметровый: сантиметровом
сверхдлинный: сверхдлинной
сверхмассивный: сверхмассивная сверхмассивные
свет: света
светимость: светимости
светить: светят
световой: световых
свой: своему
связанный: связанный
связать: связано
сделать: сделанных
сей: сих
середина: середине
сильный: сильны
синий: синее
синхротронный: синхротронное
система: система
скопление: скоплении
скорее: скорее
скорость: скорости скорость
скорый: скорей
слабеть: слабей
слабый: слабое слабому
следующий: следующее
слишком: слишком
слово: слов
случай: случаях
смещение: смещение смещении смещения
смотреть: см
снижаться: снижаются
снизу: снизу
соавтор: соавторами
солнце: солнца
сомнение: сомнение
соответстветствовать: соответстветствует
составлять: составляет составлять составляющие
состояние: состоянии
сотня: сотни
способствовать: способствовать
справа: справа
сравнимый: сравнимы сравнимых
среда: среда среде средой
становиться: становятся
станция: станции станций
статья: статьи
столкновение: столкновения
сторона: стороны
струить: струи
структура: структуры
судить: судя
существенный: существенны
счёт: счете
также: также
такой: таким таких такого такое таком
телескоп: телескоп телескопу
типичный: типичная типичное типичный
тороидальный: тороидальное
тот: те
требование: требования
требовать: требует
туннель: туннель
тысяча: тысяч тысячу
тэвный: тэвных
тяжёлый: тяжелая
тёмный: темной
увидеть: увидеть
угловой: угловое угловым
ударный: ударным
узел: узел
узнать: узнать
уменьшить: уменьшенную
фактически: фактически
фактор: фактор
ферми: ферми
филамент: филамент филаменте
философия: философии
формироваться: формируется
фотон: фотонами фотоны
франция: франции
фронт: фронт фронтом
хороший: лучшим
целый: целый
центр: центра центрах
центральный: центральной
частица: частиц частицами
частота: частотах
часть: часть
численный: численного численных
чисто: чисто
чувствительность: чувствительность
чёрный: черная черной черную черные
чёткий: четкие
швеция: швеции
штерн: штерн
экватор: экватора
экстремальный: экстремальными
электрон: электрон электронов электроны
элемент: элементами
энергетика: энергетике
энергия: энергий энергия
эрг: эрг
этот: этих
эффект: эффект эффекты
эхо: эхо
яркий: яркие яркий яркое ярче
