автор: автор авторы
акацук: акацуки
активность: активности
активный: активная активного активной активным
алай: алая
алексей: алексей
антенна: антенна
ао: ао
аппарат: аппарат аппарата аппаратом
апрель: апреле
асз: асз
астероид: астероид астероидов астероиды
астроновость: астроновости
астроном: астроном астрономам астрономов астрономы
астрономический: астрономической
астрофизик: астрофизики
атмосфера: атмосферы
бар: баром
безопасный: безопасны
бен: бен
бета: бета
ближний: ближнего
близкий: ближайшей ближе близки
больший: большие
большой: большого
брант: брант
будущий: будущая
буря: бури бурь бурю
быстро: быстро
быть: будут
вариант: варианты
век: века
великолепный: великолепных
величина: величина величины
венера: венера венере венеры
вера: веры
вернуть: вернуть
вернуться: вернулась
весь: всей
весьма: весьма
взрыв: взрыва
вид: виды
видеть: видеть
видимо: видимо
видимый: видимый
видный: видна видны
вместе: вместе
вновь: вновь
возвращать: возвращаемый
возвращаться: возвращаются
возможный: возможные
возникать: возникают
возникновение: возникновению
возникнуть: возникшие
вокруг: вокруг
волна: волны
восстановить: восстановить
восток: востоку
восточный: восточном
впервые: впервые
впоследствии: впоследствии
время: время
вселенная: вселенная вселенной
вспучиться: вспучились
вспышечноопасный: вспышечноопасной
вспышечный: вспышечные вспышечный
вспышка: вспышек вспышка вспышках вспышки вспышку
вступить: вступить
вулкан: вулкан
выброс: выброса выбросов
вывести: вывести
выдать: выдав выдала
выделить: выделена
выйти: выйти вышла
высказать: высказано
высокий: высоких высшая
выстреливаться: выстреливается выстреливаются
галактика: галактик галактика галактикам галактики
галактический: галактическое
гамма: гамма
генерировать: генерировать
геомагнитный: геомагнитную геомагнитные
гигантский: гигантские
гипотетический: гипотетическом
главное: главного
главный: главном
глубина: глубины
год: года году лет
горизонт: горизонтом
государственный: государственного
госуниверситет: госуниверситета
громко: громко
грунт: грунт грунта
группа: группа группе группы
далёкий: далеких далекой дальше
данные: данных
данный: данного
дать: дала данные
два: две
дверь: дверью
действовать: действующий
декаметровый: декаметрового
делать: делает делая
дельта: дельта
день: день
десять: десяти
джеймс: джеймс
джозеф: джозеф
джонсон: джонсон
диаметр: диаметром
диапазон: диапазона диапазонах
динамика: динамики
динкинеш: динкинеш
директор: директор
длина: длины
добыть: добыть
довольно: довольно
докт: докт
долгота: долготами
должный: должен
доставить: доставить
достаточно: достаточно
достигнуть: достигнут
достраиваться: достраивающейся
древний: древнейший древний
другой: другие другими
дуэт: дуэт
дыра: дыр дыра
евклид: евклида
единица: единиц
единственный: единственный
еленин: еленин
естественный: естественного
ждать: ждут
завершаться: завершается
завершить: завершил
задача: задач задача задачей
заметный: заметная
запуск: запуск
запустить: запустить
зарегистрировать: зарегистрировано
затем: затем
звездообразование: звездообразования
звёздный: звездная
земля: землей земли землю
земной: земной
зеркало: зеркалами
знать: знаем знали
значение: значение
значимый: значимого
значит: значит
зодиакальный: зодиакальный
золотой: золотой
зонд: зонд зонда зондом
зрение: зрения
иго: игу
идти: идет
известный: известных
излучение: излучения
изменение: изменение
измерять: измерять
изначально: изначально
изображение: изображение
изучать: изучал изучающий
изучение: изучение изучении изучения
именно: именно
иметь: имеет
имя: имени
инженер: инженерам
институт: института
интересный: интересных
информация: информации
инфракрасный: инфракрасного инфракрасную инфракрасные
иркутский: иркутского
искать: ищут
исключительно: исключительно
исследование: исследований исследования
исследователь: исследователи
история: истории
источник: источник
исчерпать: исчерпан
июнь: июня
калифорнийский: калифорнийский
камень: камни
камера: камер камерой
каргайла: каргайл
карниани: карниани
каррер: каррера
карта: карта
каталогизация: каталогизации
каталогизировать: каталогизировано
катастрофа: катастрофе
квазар: квазар квазаров
кг: кг
келдыш: келдыша
кембридж: кембридж
китайский: китайского китайское
класс: класс класса
климатический: климатических
книга: книг
койперо: койпера
количество: количество
команда: команды
комета: комет кометы
компактный: компактной
конец: конец
конструкция: конструкцию
контакт: контакт
контроль: контроль
координата: координаты
корональный: коронального корональных
космический: космические космический космического космическое
космос: космос
который: которая которой которые которыми
край: краем
красный: красного красное красную
крус: крус
кудрить: кудря
леонид: леонид
лимб: лимбе
лишь: лишь
луна: луны
лунный: лунного лунную лунный
луч: лучах
магнитный: магнитные магнитный
магнитосфера: магнитосфере
май: май мая
майкл: майкла
мало: мало
малый: малых
марс: марса
масса: масса массы
мат: мат
математика: математики
межзвёздный: межзвездной
место: месте
метод: методы
метровый: метровый
микроквазар: микроквазара
минимум: минимум
миссия: миссии миссию
млечный: млечного
мнение: мнение
многий: многими
модуль: модуль
момент: момент
мочь: мог могут
мощность: мощности
мощный: мощнейшую мощную мощные мощных
мпк: мпк
мск: мск
мы: нам
наблюдать: наблюдаемых наблюдает
наблюдаться: наблюдается наблюдалась наблюдались
назад: назад
название: названия
назвать: названная
написание: написания
напомнить: напомню
направить: направленной
например: например
настоящий: настоящее настоящий
наука: наук
научий: науч
научный: научный научных
находиться: находится
национальный: национальное
начало: начале начало
начинать: начиная
наш: нашего нашей
небо: небу
незабываемый: незабываемые
некоторый: некоторые
немало: немало
необходимый: необходима
неожиданно: неожиданно
несколько: нескольких
несмотря: несмотря
неумолимо: неумолимо
низкий: низких
новость: новостей
новый: новая нового новые новый
номер: номер номера номере
нормальный: нормальная
ночь: ночь
обеспечивать: обеспечивает
обзор: обзор обзора
обзорный: обзорный
облако: облака облаке
область: области область областью областями
обнаружение: обнаружение обнаружении
обновить: обновил
обработать: обработаны
образец: образцов
обратно: обратно
обратный: обратной
обращаться: обращающихся
обсерватория: обсерваторией обсерватории обсерватория
общий: общей
объект: объект объекта объектов объекты
объектив: объективах
объём: объем
огромный: огромное огромной
один: одной
однако: однако
ожидание: ожидания
около: около
околоземный: околоземных
олмстед: олмстед
оорт: оорта
опасный: опасными опасных
определение: определения
определить: определили
определять: определять
орбита: орбитами орбите орбиту орбиты
орбитальный: орбитальный орбитальным
ориентация: ориентации ориентацию
осень: осенью
основание: основании
основное: основном
основный: основная
оставаться: оставалась
осуществить: осуществлен
открыватель: открыватель
открыть: откроет
отменяться: отменяется
отметка: отметку
относить: относят
отправиться: отправится
охота: охота
оценка: оценкам
очень: очень
очередной: очередной
первый: первые
перекрывать: перекрывает
перемещаться: перемещается перемещаться
перемычка: перемычка
песочный: песочные
петля: петли
пик: пик
писать: писали
плазма: плазмы
план: планам
планета: планет планету планеты
планировать: планировали
плодовитый: плодовитая
площадь: площадь
повернуться: повернулось
поверхностный: поверхностная
поверхность: поверхностью
поворачиваться: поворачивается
подарить: подарят
поддерживать: поддерживать
подобный: подобных
подробность: подробности
позволять: позволяет позволяющей
поиск: поиск
пока: пока
поле: поле
полмесяца: полмесяца
поломка: поломки
получить: полученное полученные полученных получено получив получила получили
полярный: полярное полярных
понижение: понижения
популяция: популяции
попытаться: попытаться
попытка: попытки
породить: породивших породила
порядок: порядка
посадочный: посадочного посадочный
послепосадочный: послепосадочные
потенциал: потенциал
потенциально: потенциально
потерять: потеряли
потрясать: потрясает
почему: почему
поэтому: поэтому
пояс: пояса поясе
правда: правда
превысить: превысил
предполагать: предполагают
предположительно: предположительно
предыдущий: предыдущем предыдущий
преодоление: преодолением
привести: привели привести
привет: привет
прикладной: прикладной
прилагать: прилагают
прилуниться: прилунился
пристальный: пристальном
проблема: проблемы
провести: проведенного провести
проводиться: проводятся
продлить: продлить
произойти: произойдет произошла
происходить: происходит
пройти: пройдены прошли
прорабатывать: прорабатывая
протозвёздный: протозвездные
профессор: профессор
проходить: проходило
процедура: процедуры
процент: процента
процесс: процессов
прощание: прощанье
прощать: прощай
прятаться: прячется
пульсар: пульсары
путь: пути
пыль: пыли
пятно: пятен пятна
пять: пять
работа: работы
размер: размера размеры
разработчик: разработчиков
ран: ран
ранее: ранее
ранний: ранней
расположить: расположена расположенном
расстояние: расстояние расстояния
расчётный: расчетную
расширяться: расширяется
региональный: региональной
результат: результат
рекорд: рекорд
рекордсмен: рекордсменом
речь: речи
решение: решения
робертсон: робертсон
рубеж: рубежа
рубин: рубин
рыба: рыбы
ряд: ряд
самый: самый самых
сандро: сандро
сант: санта
сближаться: сближающийся сближающихся
сверхмассивный: сверхмассивная
сверхновый: сверхновая сверхновые
свет: свет света
светило: светила
свой: своей своих свой
свойство: свойства
свыше: свыше
связь: связь
север: севере
сегодняшний: сегодняшний
сергей: сергей
середина: середине
серия: серию
сеть: сети
симонить: симони
система: система системе
сияние: сияние сияний
скорее: скорее
скорость: скорость
слово: словами
смещаться: смещается
смещение: смещение смещения
смотреть: см
смочь: смог
снимок: снимке снимки
снова: снова
современный: современным
сожаление: сожалению
созвездие: созвездии
солнечно: солнечно
солнечный: солнечной солнечные
солнце: солнца солнце солнцем
сомнение: сомнения
сообщать: сообщает
сообщить: сообщил
соответственно: соответственно
соседка: соседке
сосредоточить: сосредоточена
составить: составило
составлять: составляет
состыковаться: состыковаться
сотр: сотр
сотрудник: сотрудник
сохранение: сохранении
социальный: социальной
спектр: спектра
спектральный: спектральные
спектрограф: спектрографа
специалист: специалисты
спиральный: спиральная
способный: способна
спустя: спустя
спутник: спутника
среди: среди
ст: ст
стабильный: стабильную
стать: стал
столкновение: столкновения
столько: столько
сторона: стороне сторону стороны
страница: странице
строго: строго
строиться: строящаяся
строй: строй строя
стыковка: стыковки
сформироваться: сформировавшаяся сформировалась
сюрприз: сюрприз
также: также
такой: таких такое
такчелла: такчелла
текущий: текущего текущим
телескоп: телескоп телескопа
течение: течение
тип: тип типа
тот: той
три: тремя
трио: трио
тысяча: тысяч
убегание: убегания
увеличить: увеличить
увидеть: увидим
угловой: угловые
удалённый: удаленный удаленных
удаться: удалось
удивлять: удивляют
ультрафиолетовый: ультрафиолетовые
университет: университет университета
уникальный: уникальную уникальный
упомянуть: упомянутой
управление: управление
усилие: усилия
условный: условных
успешно: успешно
успешный: успешной
установить: установлено
устойчивый: устойчивую
утверждать: утверждают
учёный: ученые
уэбба: уэбб уэбба
фантастический: фантастическое
физ: физ
физика: физики
фил: фил
фон: фоне
форма: формы
фото: фото
хаббнуть: хаббла
хлопнуть: хлопнула
центр: центра центре
цикл: циклы
чанъэ: чанъэ
час: часов
частота: частот частоты
часы: часы
чей: чьи
чили: чили
число: числе
чёрный: черная черных
широкий: широкое
широта: широтах
школа: школа
шторм: штормы
электромагнитный: электромагнитного
энергия: энергии
эпоха: эпоху
этот: эта этих
юго: юго
юпитер: юпитера
являться: является
ядро: ядром
язев: язев
январь: январе
японский: японский японского
яркий: яркая ярким ярких
яркость: яркость
