август: августа
автоматический: автоматическая
алексей: алексей
альфа: альфа
альфер: альфера
аммиак: аммиак
анализ: анализа
андромеда: андромеду андромеды
аппарат: аппарат аппарата аппаратом
апрель: апреля
астероид: астероид
астробиология: астробиологии
астроновость: астроновости
астроном: астрономам астрономы
астрономический: астрономический астрономических
астрономия: астрономии
астрофизик: астрофизики
атака: атакой
атакамский: атакамской
атмосфера: атмосфере
бериллий: бериллии
бинокль: бинокль
блеск: блеск
близкий: ближайшее ближайшей ближайших ближе близкого
близко: близко
бо: бо
богатый: богатых
большой: большой
бора: боре
брильянт: брильянтами
брукса: брукса
вблизи: вблизи
вернуться: вернется
вертушка: вертушка
верхний: верхний
вечер: вечерами
вещество: вещества
видеть: видеть
видный: видна
влиять: влиять
вместо: вместо
вне: вне
внешний: внешней
внутренний: внутренней
вода: вода воды
водовоз: водовоза
водородный: водородный
водяной: водяного водяной
возможность: возможность
возраст: возраст
вокруг: вокруг
волга: волга
воспользоваться: воспользоваться
вполне: вполне
время: времен время
вселенная: вселенная вселенной вселенную
вскоре: вскоре
всматриваться: всматривается
всё: всё
вызывать: вызывает
выйти: выйдет
выполнить: выполнил
высоко: высоко
выше: выше
газ: газом
газовый: газовых
галактика: галактика галактики
галлей: галлея
гарпун: гарпуны
гейзер: гейзеров
герасименко: герасименко
гигант: гигантов
гипотеза: гипотезы
глаз: глазом
го: го
говорить: говорит
год: года годах лет
гораздо: гораздо
горизонт: горизонтом
грунт: грунту
данные: данным
дать: дал данные
двадцатилетие: двадцатилетия
двигатель: двигателя
дейтерий: дейтерии
дело: деле
дельта: дельты
день: день
джеймс: джеймс джеймса
диаметр: диаметр
диапазон: диапазона
диск: диска дисках диске
дискуссия: дискуссий
дожидаться: дожидаются
долгий: долгое
должный: должен должно должным
доставить: доставлена доставлены
достаточно: достаточно
достигать: достигают
достигнуть: достиг достигнет
др: др
другой: другие
евклид: евклид
европейский: европейской
жёсткий: жесткая
завершать: завершает
зависимость: зависимости
заключить: заключен
заметно: заметно
запуск: запуск
запустить: запущен
захватывать: захватывающих
зачастую: зачастую
звезда: звезда звездами звезды
звёздный: звездных
земля: земле земли землю
знаменитый: знаменитой
значит: значит
значительный: значительное
зонд: зонд
иванович: ивановича
идти: идти идут
известный: известной
изображение: изображение изображении
изучение: изучения
изучить: изучить
именно: именно
иметь: имеет
имя: имени
иначе: иначе
инструмент: инструмент
информация: информации
ио: ио
искать: ищут
исследование: исследований исследования
исследователь: исследователи
история: истории история
исчезнуть: исчезнет
каждый: каждом
каменистый: каменистые
карлик: карлик карлика карликами карлики карликов
карта: карта
картинка: картинки
класс: класса
клим: клима
км: км
количество: количество
коллапсар: коллапсар коллапсаров
коллекция: коллекция
кольцевой: кольцевыми
кольцо: кольцо
команда: команды
комета: комета комете кометой кометы
конец: конца
контролировать: контролируемая
коричневый: коричневые коричневых
космический: космический
космос: космос
который: которое которой которые который которых
крупный: крупным
кудрить: кудря
летучий: летучие
литий: литии
луна: луны
лунный: лунное
льшуя: льшую
лёд: льда
маленький: малы
марс: марс
марсианский: марсианский
март: марта
мартовский: мартовская
масса: масс масса массы
материал: материал
международный: международный
межпланетный: межпланетная
менее: менее
мера: мере
местный: местных
месяц: месяца
метан: метан
механизм: механизма
миллиметровый: миллиметрового
мир: мир мире миром
миссия: миссией миссии миссия
мкс: мкс
множество: множества
модуль: модуль
молодой: молодой молодых
момент: момент момента
монооксид: монооксид
мочь: могут можете
мы: нами
мягкий: мягкая
наблюдать: наблюдаемого наблюдая
наблюдение: наблюдения
назад: назад
наиболее: наиболее
накапливать: накапливают
наличие: наличие
направить: направлена
настолько: настолько
научный: научной
находиться: находится
начало: начале начало
начинаться: начинается
небесный: небесным
небо: неба небе
невооружённый: невооруженным
недавний: недавней
недозвезда: недозвезда
недостаточно: недостаточно
недра: недра
некоторый: некоторого некоторые
необработанный: необработанных
неоптимальный: неоптимально
неотличимый: неотличимы
нешуточный: нешуточный
новость: новостей
новый: новая новые новый
ночной: ночного ночном
оба: оба
обещать: обещает
обзор: обзор
облако: облаков
область: области областях
обнаружить: обнаружен обнаружили
обработать: обработанных
обработка: обработки
образ: образом
образоваться: образуются
обращение: обращения
обсерватория: обсерватории
объединить: объединенные
объект: объекта объектов объекты
объектив: объективах
обычный: обычная
овен: овна
огромный: огромное
один: одним
около: около
окончание: окончании
определение: определение
определять: определять
оранжевый: оранжевая оранжевой
орбита: орбите орбиту орбиты
основной: основной
отказ: отказа
отличный: отличного
отправить: отправить
оттенок: оттенках
оцениваться: оценивается
память: памяти
пара: пар пара
параметр: параметру
парсек: парсека
партнёрство: партнерстве
первый: первая первым
перебираться: перебирается
передавать: передавал
передать: передал
переходить: переходит
перигелий: перигелия
период: период периоду
периодический: периодической
песенка: песенке
песочный: песочные
пингвин: пингвин
планета: планет планета планетах планетой планеты
планетезималь: планетезималей
планетология: планетологии
планетоподобный: планетоподобных
планироваться: планировалась
плотность: плотность
поверхность: поверхности поверхность
подниматься: поднимается
подобие: подобием
подобный: подобных
подтвердиться: подтвердилось
позволить: позволили
позволять: позволяют
поздний: позднего позже
показать: показано
покидать: покидает
покрытие: покрытия
полный: полная
полупрозрачный: полупрозрачный
получаться: получается получаются
получить: полученных
полушарие: полушарии полушария
польза: пользу
полёт: полета
помощь: помощью
понс: понса
пончик: пончик
понятный: понятные
попадать: попадает
порог: порог порога
портрет: портреты
посадка: посадка
поток: потоков
похожий: похожа
почему: почему
поэтому: поэтому
появление: появлению
правда: правда
практика: практике
превышать: превышает
превышение: превышение
предел: предел
предмет: предметом
предоставлять: предоставляя
предполагать: предполагали
предполагаться: предполагалось
представление: представлениям
предстоять: предстояла
предыдущий: предыдущие
прекрасный: прекрасную
приближение: приближение
прибыть: прибыл
привести: приведшим
прижать: прижать
примерно: примерно
принять: принято
пристальный: пристальнее
причальный: причальные
программа: программы
продолжаться: продолжалось
происходить: происходит
происхождение: происхождение
пройти: пройдет прошла
пролетать: пролетая
промежуток: промежутками
протопланетный: протопланетного
проходить: проходит
прохождение: прохождения
публиковать: публикуем
пульсар: пульсары
пыль: пылью
работа: работ работе работу работы
разбудить: разбудить
разглядеть: разглядеть
различный: различных
размер: размером
разогреть: разогреты
район: районе
рамка: рамках
располагаться: располагается
расположить: расположена
распределение: распределение
рассмотреть: рассмотреть
расстояние: расстояние
расти: растут
реакция: реакции
результат: результате результаты
рекорд: рекорд
решение: решение
решётка: решетке
розетта: розетта розетты
рыба: рыб рыбах
сам: самого самой самом
самоподдерживающийся: самоподдерживающиеся
самый: самых
сверхновый: сверхновой
свести: свести
светимость: светимости
световой: светового световых
светосильный: светосильным
свидетельствовать: свидетельствует
свой: своей
связать: связаны
север: северу
северный: северного
сентябрь: сентябрь сентября
середина: середине
серый: серый
сильный: сильнее
синий: синего
синтез: синтез
система: системе системы
сиять: сиять
скорее: скорее
скорость: скорости
сложно: сложно
смотреть: см смотрим
смочь: смогли
смысл: смысл
снижение: снижения
снимок: снимка снимки снимков
собрать: собрала
совершить: совершить
современный: современным
согласно: согласно
созвездие: созвездие созвездии
солнечный: солнечной
солнце: солнца солнцу
состав: состав
составлять: составляет
союз: союз
спектральный: спектрального
спектрометрия: спектрометрии
спор: споры
спускать: спускаемого спускаемый
спячка: спячку
сработать: сработали
сравнивать: сравнивают
сравнить: сравнить
средний: средняя
стадия: стадии
становиться: становится
станция: станция
стартовать: стартовала стартовали
стать: стал стать
столкновение: столкновения
столкнуть: столкнуть
столкнуться: столкнувшись
строка: строках
субкарлик: субкарлики
субкоричневый: субкоричневого субкоричневый субкоричневыми субкоричневых
судьба: судьба
существование: существования
считать: считают
считаться: считалось считаются
счёт: счету
сюд: сюды
также: также
телескоп: телескоп телескопом
тело: тел телом
тельце: тельца
температура: температуру температуры
теория: теория
термоядерный: термоядерные термоядерный
тип: типа
толстяк: толстяк
точка: точки
туд: туды
тёмный: темном
тёплый: теплый
уверенно: уверенно
уверенность: уверенности
углерод: углерода
удаться: удалось
уникальный: уникальная
управление: управления
условие: условия
утро: утрам
уэбба: уэбб уэбба
фил: филы
фильм: фильма
формирование: формирование формирования
формироваться: формируются
фото: фото
фотография: фотографии
хаббнуть: хаббла
хамаль: хамаля
химический: химический
хороший: хороший
цвет: цвет цвета
целое: целом
центр: центре
час: часов
частность: частности
часть: части часть
часы: часы
чей: чей
честь: честь
четвёртый: четвертый
четыре: четырех
чурюмов: чурюмова
шарик: шарик
шуточный: шуточной
эдакий: эдакая
этот: эта этих этому
юбилей: юбилей
южный: южной южном
юпитер: юпитера юпитеров
явление: явлений
являться: является
ядро: ядра ядре
язев: язев
яйцо: яйцом
яркий: яркой
ярко: ярко
яркость: яркость
