аббревиатура: аббревиатура
абсолютный: абсолютного абсолютное абсолютным
автор: авторов
академик: академика
активность: активность
алексей: алексей алексея
альберт: альберт альбертом
американец: американцами американцы
американский: американские американским американской
аномальный: аномального
апостериорный: апостериорное
аппарат: аппаратов
армстронг: армстронг армстронга
архив: архиве
ассамблея: ассамблее ассамблея
астронавт: астронавтам астронавты
астроном: астрономами астрономов астрономы
астрономический: астрономические астрономический астрономических астрономического
астрономия: астрономии
астрофизик: астрофизика астрофизиком
атмосфера: атмосферы
атомный: атомного атомное атомному атомные атомным атомных
африка: африке
база: баз база базах
базза: базза
бардак: бардак
барицентрический: барицентрическим барицентрическое
башня: башни
безбожно: безбожно
бендер: бендера
беседовать: беседует
блестяще: блестяще
блок: блоках
болтаться: болтаются
больший: большая большим большими
большой: большого велико
борисович: борисовича
бросать: бросал
будущее: будущее будущем
буква: буквами буквой
бурный: бурное
быстро: быстро
быть: будем будут суть
важный: важное
вакханалия: вакханалию
ваш: ваши ваших вашу
ввести: введена введено ввели
век: век века веке
вековой: векового вековое вековой
величина: величины
венера: венера венеру
верить: верить
версия: версии
вершина: вершины
вести: ведут вести
весь: всей всеми всему
весьма: весьма
видеозапись: видеозапись
видеть: видел видеть
видный: видна
вклад: вклад
включать: включать включают
включая: включая
влиять: влияет
вместе: вместе
вносить: вносит
возвращаться: возвращается
возвращение: возвращения
воздушный: воздушных
возможно: возможно
возникнуть: возник возникло возникнет
вокруг: вокруг
волна: волн
вообще: вообще
вопрос: вопрос вопроса вопросе вопросов вопросом вопросы
восприятие: восприятие
впервые: впервые
вперёд: вперед
впоследствии: впоследствии
вращаться: вращается вращающаяся
вращение: вращение вращением вращении вращения
временами: временами
временной: временную временные временных
время: времена временем времени время
вроде: вроде
вселенная: вселенная вселенной
вспомнить: вспомнить
вспять: вспять
встретиться: встретиться
всё: всё
вывод: вывод
выглядеть: выглядит
вызывать: вызывает
вынести: вынесли
вынуждать: вынуждая
выполняться: выполняется
выстраиваться: выстраивается
выше: выше
выясниться: выяснилось
галактика: галактике галактики
галактический: галактическое
галилей: галилеем галилей
галилео: галилео
генеральный: генеральная
геодезист: геодезистами геодезисты
гипотеза: гипотеза
главный: главной
глобальный: глобальная глобальной
глонасс: глонасс
говорить: говорим говорю говоря
говориться: говорится
год: год года году лет
годиться: годится
голова: голове
город: городе
гравитационный: гравитационное гравитационном гравитационный гравитационным гравитационных
греческий: греческой
группа: групп группа группами группой группы
группировка: группировка группировкой группировку
давать: давать дает
давно: давно
дальний: дальний
далёкий: далеком
данные: данных
дать: данные
два: двух
двигаться: движется движутся
движение: движение движении движения движениями
дебют: дебют
дедушка: дедушку
действительно: действительно
делать: делать делают
делаться: делается
дело: дела деле дело
день: день днем
дерево: дерева
десяток: десятков
десять: десяти десять десятью
джеймс: джеймса
диаграмма: диаграммы
динамический: динамическим
диссертация: диссертацию
дифференциальный: дифференциальные
длительный: длительный длительных
добрый: добрый
довольно: довольно
доказательство: доказательство
докт: докт
докторский: докторскую
долго: долго
долететь: долетели
должный: должно должны
дополнительный: дополнительную дополнительные
допустить: допустим
достаточно: достаточно
достигать: достигали
достигнуть: достигли
друг: друг друга другом друзей
другой: другая другим других другое другому
дублёр: дублера
дыра: дыры
европеец: европейцы
европейский: европейская
естественный: естественное естественный
жизненно: жизненно
жизнь: жизни жизнь
жить: живем живут
зависимость: зависимости
завязать: завязаны
загадочно: загадочно
загадочный: загадочной
задавать: задаваемое
задаваться: задается
задача: задачей
задуматься: задуматься
заключаться: заключается
закончить: закончили
замедлять: замедляет
заметить: заметить
замечательный: замечательные замечательным
заниматься: занимались заниматься занимаясь
записать: записанным
запустить: запущены
заранее: заранее
затем: затем
защитить: защитили
звезда: звезда звезды
здравствуйте: здравствуйте
зельдович: зельдовича
земля: земле земли земля
земной: земное земные земным
знать: знаем знаете знать
зрение: зрения
идеализация: идеализацию
идеальный: идеальная идеального идеальное идеальным идеальными
идти: идет идут
известно: известно
известный: известны
изготавливать: изготавливают
излучить: излучили
изменение: изменение изменения
изменяться: изменяется
измерение: измерения
измерять: измеряем измерять
изображение: изображение
изобрести: изобретены
изучать: изучали
именно: именно
иметь: имеет
иметься: имеется имеются
импульс: импульс
индекс: индекс
индус: индусы
инженер: инженеры
институт: института
интервал: интервалами интервалах интервалу
интервью: интервью
интересный: интересным
интерпретация: интерпретации
исаак: исаак
искать: ищут
искусственный: искусственных
использование: использованием
использовать: использован использовано использованы использовать используем используемые используемых используют
использоваться: использовалось используется
исправить: исправить
исправление: исправления
исследование: исследований исследования исследованиями
исследовать: исследовать
итак: итак
к: ко
каждый: каждому каждый
казаться: кажется
каковой: каковым
какой: какие каким какого
кандидатский: кандидатскую
карлик: карлика
кафедра: кафедры
кварцевый: кварцевые
кино: кино
кинофильм: кинофильмы
кип: кипом
китаец: китайцы
китай: китае
классический: классические
климат: климат
клуб: клубе
км: км
коллаж: коллаж
коллега: коллегами коллеги
коллинза: коллинза
колумбия: колумбия
командировка: командировка
командный: командном
комбинированный: комбинированное
комментарий: комментариев
компактный: компактная
консенсус: консенсус
консервативный: консервативных
конструкция: конструкция
концептуальный: концептуальные концептуальным
концепция: концепции концепцию концепция концепциях
координата: координат
координатный: координатным
координировать: координированное
копейкин: копейкин копейкиным
корабль: корабли
космический: космические космических
космологический: космологические космологическое
космонавт: космонавтам
космос: космос космоса
костюм: костюме
который: которая которого которое которой котором которую которые который которыми которых
крабовидный: крабовидной
край: крае
крайний: крайней
кратер: кратера
кроме: кроме
круговой: круговых
кудрить: кудря
лаборатория: лаборатории
легенда: легенде
легендарный: легендарного
летать: летать летают
либо: либо
лишь: лишь
ловелла: ловелла
логический: логическими
луна: луна луне луной луну луны
лунный: лунного лунное лунных
любим: любим
майкл: майкла
маленький: маленькая маленький маленькой
марс: марс
масса: масса массы
масштаб: масштабов
мат: мат
математика: математики
математически: математически
математический: математическая математические математическую
машина: машина машину машины
мгу: мгу
международный: международного международное международный международным
меняться: меняется
мера: мере
меркурий: меркурий
место: месте
металл: металла
метрический: метрическим
метролог: метрологами метрологи
метрологический: метрологические
метрология: метрологии
механика: механика
механический: механические
микросекунда: микросекунда микросекунды
мимо: мимо
мир: мира миру
миссури: миссури
мистически: мистически
михаилович: михайлович
модель: моделей модели
модуль: модуле модуль модуля
мой: мои мою
момент: момент
монография: монографии
морской: морской
мочь: могли могло могу могут можем
мс: мс
мы: нам нами
наблюдатель: наблюдателей наблюдатели наблюдатель наблюдателя наблюдателям
наблюдать: наблюдавшего наблюдали наблюдать
наблюдение: наблюдений наблюдения наблюдениях
наверное: наверное
навести: навести
навигатор: навигаторами навигаторы
навигационный: навигационная навигационного навигационной навигационную навигационных
навигация: навигации навигацию навигация
наводить: наводить
надводный: надводных
надеяться: надеюсь
надёжный: надежном
назад: назад
наземный: наземного наземных
называть: называемого называемое называемый называю
называться: называется
наиболее: наиболее
найти: найти
наклонный: наклонной
намного: намного
наоборот: наоборот
написать: написаны написать
направление: направлении
например: например
наряду: наряду
насколько: насколько
настоящий: настоящее настоящий
насчёт: насчет
наука: наук наука
научный: научной научных
находиться: находится находиться находясь находятся находящегося находящиеся находящийся находящимся находящихся
национальный: национального
начало: начала начале
начинать: начинает начинают
наш: наш наше нашей наши наших
небесный: небесная небесной небесные
небольшой: небольшом
неважный: неважна
неверный: неверна
невозможно: невозможно
невозможный: невозможной
недавно: недавно
неделя: неделю
недопустимо: недопустимо
нежели: нежели
независимый: независимая независимым
некий: некая некие некую
некоторый: некоторые некоторых
немножко: немножко
необходимо: необходимо
необходимость: необходимость
необычный: необычным
неосязаемый: неосязаемые
неправильный: неправильными
неравномерно: неравномерно
несколько: нескольких несколько
несуществующий: несуществующего
неточность: неточность
нетривиальный: нетривиально
никакой: никаких никакого
нил: нил
нобелевский: нобелевской
новость: новость
новый: новые новых
номер: номере
нужно: нужно
нужный: нужна нужны нужные
ньютон: ньютон ньютона
ньютоновский: ньютоновской
оба: оба
обернуть: обернуть
обеспечение: обеспечение
обеспечивать: обеспечивать обеспечивают
обзор: обзор
область: области
обнаружить: обнаружили
обозначаться: обозначается
обозначить: обозначено обозначены
обозримый: обозримом
обосновать: обоснована
обрабатывать: обрабатывает
образ: образом
обратный: обратной
обсерватория: обсерватории
обстоять: обстоят
обсуждать: обсуждали обсуждать
обсуждение: обсуждение
общий: общая общей общую
объект: объектов
обычный: обычный
один: одна одним одной одном одну
одинаково: одинаково
одинаковый: одинаковым
однако: однако
одновременно: одновременно
озаботить: озабочены
оказаться: оказались оказалось
оказываться: оказывается
окончание: окончание
окончательно: окончательно
окрестность: окрестности окрестностях
олдрина: олдрина
он: нему
оно: оно
опасность: опасности
оператор: оператором
опережать: опережали
оперировать: оперировать
описываться: описывается
определение: определение определении определению определения
определённый: определенное определенной определенные
оптический: оптических
опубликовать: опубликовали опубликованы
орбита: орбитах орбите
осень: осенью
осмыслить: осмыслить
основа: основой
основание: основании
основать: основанная основанного основанное основанными основано
основной: основной
основный: основная основным
особенно: особенно
оставаться: остаются
остап: остапа
остаться: оставшегося
осуществлять: осуществляемой
ось: оси
ответ: ответ
ответить: ответил ответить отвечу
отвечать: отвечает
открытие: открытие
открытый: открытый открытым
отличаться: отличается отличаться
отличие: отличие отличием
отметить: отметил отметить отмечу
относительно: относительно
относительность: относительности
относить: относить
отношение: отношению
отождествляться: отождествляется
отрицательный: отрицательным
отставать: отставали
отсчитать: отсчитать
отсчитывать: отсчитываемое отсчитывать отсчитывают отсчитывая
отсчитываться: отсчитывается
отсчёт: отсчета отсчетов
оттуда: оттуда
очень: очень
очередной: очередной
очередь: очередь
ошибиться: ошибемся ошибся
ошибка: ошибка ошибки ошибку ошибок
ошибочный: ошибочным
ощутимый: ощутимый
падать: падают падающего падающей
парадокс: парадокс
параметр: параметр параметра
параметризовать: параметризует
парижский: парижской
первый: первая первого первых
передавать: передавать передают
передвигаться: передвигаются
передвижение: передвижения
передний: переднем
передовой: передовых
перейти: перейти
переписаться: перепишется
пересчитывать: пересчитывать
периодический: периодические
перипетия: перипетии
пизанский: пизанской
писать: пишут
планета: планет планете планеты
плохой: плохими
плутон: плутоном
побеседовать: побеседовать
поверхность: поверхности поверхность
повседневный: повседневной
погибнуть: погиб
подвергнуться: подверглась
поддержка: поддержки
подозрение: подозрение
подробно: подробно
подумать: подумать
подход: подходов подходы
подходящий: подходящее
подчиняться: подчиняться
позволить: позволившие позволило
позволять: позволяют
пойти: пошло
пока: пока
показание: показания
показать: показаны показать
показывать: показываемое показывать показывают
полагать: полагаю
поле: поле
полностью: полностью
положение: положениями
полстолетие: полстолетия
получаться: получается
получить: получили
пользоваться: пользуются
полёт: полет
помимо: помимо
помнить: помню
понимание: пониманием понимания
понимать: понимаем понимать
понятие: понятие
понятно: понятно
понять: понял понять
поправка: поправки поправок
пора: пор
породить: породило
порядок: порядка порядок
последний: последнее последняя
последовательность: последовательность
послужить: послужила
посмотреть: посмотрели посмотреть
посоветовать: посоветовали
посредством: посредством
поставить: поставлена поставленных
постараться: постарались
постньютоновский: постньютоновских
построение: построения
постулировать: постулированным
посчитать: посчитаем посчитан посчитанные посчитать
посылать: посылаем
потенциал: потенциал потенциале потенциалом
потребитель: потребителя потребителям
почему: почему
поэтому: поэтому
появиться: появилась появились появиться
появление: появления
появляться: появляется
правда: правда
правило: правило
правильно: правильно
правильный: правильна
правительство: правительства
практика: практике практики
практически: практически
практический: практическая практических практической
практичный: практичными
превосходить: превосходит
предел: пределами
предлагать: предлагаем
предполагать: предполагаемой
предполагаться: предполагается предполагалось
предположить: предположить
предсказание: предсказание
предсказывать: предсказывает
прежний: прежнему
премия: премии
прецизионный: прецизионная прецизионной прецизионную прецизионные
привести: привел привести
приводить: приводит приводить
привязать: привязать
приглашение: приглашение
придумать: придумали
приехать: приехать
прийти: прийти
приложение: приложений приложения
приложить: приложено
пример: пример
примерно: примерно
принадлежать: принадлежал
принцип: принцип принципа принципе
принципиальный: принципиальным
принять: принятых
приписывать: приписывать
природа: природой природу
присоединиться: присоединятся
причина: причине
причём: причем
проблема: проблема проблемах проблемой проблему
проверка: проверках
провести: проведем провели
проводить: проводить проводят
программа: программы
продолжать: продолжать продолжают
продолжение: продолжение
произойти: произойти
происходить: происходит происходящие
пройти: прошел
промахнуться: промахнется промахнулись
промежуток: промежутка промежутке
промежуточный: промежуточные
проработать: проработать
просто: просто
простой: простой
пространственно: пространственно
пространство: пространства
противоречие: противоречиями
протяжение: протяжении
профессор: профессор
проходить: проходит
прочитать: прочитал
прошлое: прошлого прошлое
прямолинейно: прямолинейно
пульсар: пульсар пульсаров
пульсарный: пульсарное
путешествовать: путешествовать
путём: путем
пять: пять
работа: работа работах
работать: работает работать
равномерно: равномерно
равномерный: равномерного равномерную
равный: равными
радиационный: радиационных
радиолокационный: радиолокационные
радиолокация: радиолокации
радиус: радиусом
разбираться: разбираются
разбушеваться: разбушевался
развитие: развитие развитием
развить: развить
разгадка: разгадке
разделять: разделяя
различить: различить
различный: различных
размер: размеров
размышлять: размышляем размышлять
разный: разной разному разные разным разных
разобраться: разберутся
разрабатываться: разрабатываются
разработка: разработке разработки разработкой
разрешить: разрешен
рамка: рамках
ранее: ранее
расположить: расположенные расположенными расположены
расположиться: расположился
рассказать: рассказать
рассматривать: рассматриваете
рассогласование: рассогласования
расстояние: расстояние расстоянии расстояний расстояниях
рассчитывать: рассчитывать
расширение: расширения
реализация: реализации реализация
реализовать: реализует
ребята: ребята
регион: регионах
резолюция: резолюций
результат: результат результаты
релятивистский: релятивистская релятивистскими релятивистских
рентгеновский: рентгеновских
речь: речь
решение: решения
рис: рис
российский: российская
россия: россии
руководство: руководством
ряд: ряд
рядовой: рядового
сам: сама само самой самом саму
самый: самая самый
сатурн: сатурна
свет: свет света
свободно: свободно
свой: свое своего своей своими своих свой
связать: связано
связаться: связаться
связь: связи
сделать: сделал сделан сделана сделанные сделать
себя: собой
сей: сих
сергей: сергеем сергей
сессия: сессий
сесть: сядет
сигнал: сигнал сигналы
сидеть: сидим сидящий
сила: силу
сильно: сильно
сильный: сильном
синхронно: синхронно
синхронный: синхронное
система: систем система системам системе систему системы
ситуация: ситуации
скажем: скажем
сказать: сказал сказать
скаляр: скаляром
склон: склон
скорость: скорость скоростью
слабый: слабом
слава: славу
слегка: слегка
следовать: следует
следствие: следствием
следующий: следующего следующем
слишком: слишком
слово: слова
сложность: сложностях
служба: службу
смартфон: смартфонах
смерть: смерти
смотреть: см смотреть смотрит
смочь: сможем
смысл: смысл
сначала: сначала
собираться: собираемся
собственно: собственно
собственный: собственного собственное собственную собственными
событие: событий
совершать: совершал
совершенно: совершенно
советский: советская
современный: современные
согласно: согласно
согласный: согласен
согласование: согласованию
согласовывать: согласовывать
содержать: содержала содержит
создание: созданием создании создания
создать: созданные созданы создать
солнечный: солнечная солнечной
солнце: солнца солнце
сомнение: сомнений сомнению
соответствовать: соответствующим
соответствующий: соответствующих
составлять: составляет
сосчитать: сосчитать
союз: союз союза
спасибо: спасибо
специалист: специалисты
специальный: специальная
спешить: спешат спешили
способ: способом
спросить: спросили
спускать: спускаемый
спутник: спутник спутника спутниками спутники спутников
средство: средств
стабильность: стабильности стабильность
ставить: ставить
сталкиваться: сталкивается
стандарт: стандарта стандартов
станция: станции
стараться: стараются
стать: стали стало
статья: статьи статью статья
столетие: столетия
столь: столь
сторона: стороне стороны
страна: странах
стрелочка: стрелочками
строго: строго
строить: строит строить
структура: структуры
стукнуть: стукнуть
субстанция: субстанцией
сутки: сутки
суть: сути
существенный: существенный
существовать: существовать существует
сущность: сущности сущность
сфера: сфере
схема: схема схему
считать: считали считать
считаться: считалось
сша: сша
также: также
таки: таки
такой: такая такие таким такими таких такое
тело: тел тела телом
тема: теме тему
темп: темпом
тензор: тензором
тензорный: тензорный
теоретически: теоретически
теоретический: теоретические теоретический теоретических теоретическое теоретической
теория: теории теорию теория
термозащитный: термозащитном
технический: техническую
технология: технологий
течь: течет
тикать: тикают
тонкий: тончайшие
торный: торном
тот: те тех той тому ту
точка: точек точках точки
точнее: точнее
точно: точно
точность: точности точностью
точный: точные точными
трв: трв
требоваться: требуется
третий: третьей третья
трудно: трудно
тт: тт
туманность: туманности
тяготеть: тяготеющих
уверенный: уверен
угроза: угрозы
удовольствие: удовольствием
удостоить: удостоен
указать: указали
уклонение: уклонения
умный: умные
универсальный: универсального универсальное универсальную универсальным
университет: университета
упоминать: упоминал
уравнение: уравнение уравнений уравнения уравнениям
уровень: уровне
усиленно: усиленно
усилие: усилий
ускорение: ускорение ускорением ускорения
ускоренный: ускоренное
ускоряться: ускоряются
условие: условиях
условно: условно
условный: условного
устроить: устроена устроить
уход: уход
учесть: учесть
учитывать: учитывать
учитываться: учитывается
учёный: ученые ученых
учёт: учетом
факт: факт
фактически: фактически
фантаст: фантасты
ферми: ферми
физ: физ
физик: физикам физиками физиков
физика: физика физики
физический: физическим физическими
физфак: физфак
форма: форме
формула: формулы
французский: французского
фундаментально: фундаментально
фундаментальность: фундаментальность
фундаментальный: фундаментального фундаментальных
функция: функцией функциями
характер: характер
характеризовать: характеризует
ход: ход хода ходе ходу
хороший: хорошей
хотеть: хотят
хотеться: хочется
хотя: хотя
хранить: хранящей
целое: целом
целый: целый
цель: цели
цивилизация: цивилизация
цифра: цифр цифру
час: часа часам часов
часами: часами
частность: частности
частота: частота
часы: часы
человек: людей люди
человечество: человечества
четвёртый: четвертая
четыре: четырьмя
число: чисел число
чёрный: черные
шаг: шаг
шар: шара
шахматный: шахматном
шкала: шкал шкала шкалам шкалу шкалы
штат: штата
щепетильный: щепетильный
эйнштейн: эйнштейн эйнштейном эйнштейну
эквивалентность: эквивалентности
эксперимент: эксперимент
экспериментальный: экспериментальное экспериментальных
электромагнитный: электромагнитный
эпоха: эпохи
это: этим
этот: этих
эфемерида: эфемериды
эфемеридный: эфемеридного эфемеридное
эффект: эффектов эффекты
южный: южной
юпитер: юпитеру
явление: явления
являть: являет
являться: является являются
яков: якова
ясно: ясно
