автоматизированный: автоматизированного
автор: авторы
айер: айер
активный: активных
алексей: алексей
амай: амая
анализ: анализ
апертура: апертурой
астероид: астероид
астроновость: астроновости
астроном: астрономам астрономы
астрономический: астрономический астрономических
астрофизик: астрофизики
балдж: балдж
барселона: барселоне
белый: белый
беспрецедентный: беспрецедентную беспрецедентные
благодаря: благодаря
ближ: ближ
близкий: ближайшего близкая
близко: близко
близость: близости
большинство: большинство
большой: большого большое большой
будущий: будущих
быстро: быстро
важный: важны важные
вблизи: вблизи
вверху: вверху
вега: веги
вероятный: вероятной
вертикальный: вертикальной
вещество: вещества
взаимодействие: взаимодействий взаимодействия
взаимодействовать: взаимодействуют
взаимоотношение: взаимоотношения
взгляд: взгляд
взрыв: взрыв взрыва взрывов
вид: вид виде
видео: видео
видный: виден
включая: включая
влиять: влиять
внешний: внешний
внизу: внизу
внутри: внутри
водолей: водолея
водород: водорода
воздействие: воздействием
возле: возле
возможно: возможно
возникать: возникающий
возраст: возрастом возрасту
вокруг: вокруг
волна: волны
воочию: воочию
вполне: вполне
вращаться: вращается вращающиеся
вращение: вращения
время: времени
вселенная: вселенной вселенную
вспышка: вспышка вспышки
всё: всё
второй: второго вторых
входящий: входящие входящих
выборка: выборки
выброс: выбросы
вывод: выводу
выделить: выделены
выпуклость: выпуклость
высокий: высокая высоким высокой высокую
выступать: выступать
вытянутый: вытянутую
выявить: выявлено
газ: газ газа
газовый: газовые
галактика: галактик галактика галактиками галактике галактики галактику
галактический: галактического галактическом
гало: гало
гамма: гамма
гарафий: гарафия
гикеан: гикеан
говорить: говорят
год: года годах году лет
гораздо: гораздо
гравитационный: гравитационного гравитационное гравитационной
гравитация: гравитацией гравитации
группа: группа
густонаселённость: густонаселенность
давать: дает
давно: давно
далёкий: далекая далекого
данные: данных
данный: данный
дать: данной данные дать
два: две двум двух
двигаться: движутся
движение: движения
двойник: двойник
двойной: двойная двойной двойную
де: де
дева: деве
декабрь: декабря
демонстрир: демонстриру
демонстрировать: демонстрирует
день: день дня
десятка: десяток
десяток: десятка
джеймс: джеймс
джет: джеты
диаметр: диаметр диаметра
диапазон: диапазоне
диск: диск диске
дисперсия: дисперсией
дистанция: дистанция
длить: дли
дождевой: дождевую
доказывать: доказывает
долгий: долгого
должный: должны
доплеровский: доплеровским
дополнительный: дополнительные
достигать: достигающую
достигнуть: достигла достигнет
др: др
древний: древнему
друг: друг другу
другой: другими
дуэт: дуэт
дыра: дыр дыра дырам дыры
европейский: европейской
единственный: единственный
естественный: естественный
ет: ет
журнал: журнале
зависимость: зависимость
загадка: загадка загадкой
затем: затем
захватывать: захватывающей
звезда: звезд звезда звездам звездой звезду звезды
звёздный: звездное звездной звездном звездных
зелень: зелень
зелёный: зеленое
значение: значение
значительно: значительно
идеальный: идеальное
известно: известно
известный: известному известных
извлечь: извлеченную
излучение: излучения
измерение: измерения
изображение: изображение изображении изображения
изучать: изучать
изучение: изучение
изучить: изучил изучила
иметь: имеет
институт: института
инструмент: инструменты
интересный: интересное
инфракраса: инфракрас
инфракрасный: инфракрасного инфракрасном
искажение: искажения
испанский: испанском
испускать: испускающие
исследование: исследований исследования
исследователь: исследователей исследователи
исследовательский: исследовательская исследовательский
исходный: исходный
итог: итоге итоги
каждый: каждой каждый
канада: канады
канарский: канарский канарского
капля: каплю
карлик: карлик
карликовый: карликовая
карта: карту
картейк: картейк
картинка: картинке
каталинский: каталинский каталинского
каталонский: каталонского
категория: категории
качество: качестве
квинтет: квинтет
километр: километров
китай: китае
количество: количестве
колледж: колледж
колумбийский: колумбийский
кольцо: кольцо
команда: команда
компактность: компактностью
компаньон: компаньона компаньоны
компаньонка: компаньонки
компонент: компонентов компоненты
конденсироваться: конденсируется
конечный: конечном
концентрация: концентрации
короткий: короткий коротких
космический: космические космический космических
космос: космос
который: которая которое которые которых
крайне: крайне
красный: красное красной
крис: крис
кроме: кроме
кругом: кругом
кружка: кружками
крупный: крупнейшее крупнейших
кудрить: кудря
ламия: ламия
линза: линзой
линзирование: линзирование
линия: линией линии линий
лир: лиры
лишь: лишь
локация: локации
лос: лос
люси: люси
максимальный: максимального максимальной
маленький: маленькой
мало: мало
манёвр: маневры
марс: марса марсе
масса: масс масса массам массой массу массы
массивный: массивного массивных
международный: международная
мелкий: мелкими
месяц: месяца
метод: методы
метровый: метрового
механизм: механизмах
миллиард: миллиардов миллиарды
миллион: миллиона
мимо: мимо
мир: мир
мкм: мкм
млечный: млечного млечному млечный млечным
модель: моделям
молодой: молодой молодые молодых
моул: моула
мочь: могут
мощный: мощнейшие
муниципалитет: муниципалитете
мучачос: мучачос
мы: нам
набирать: набирает набирают
наблюдать: наблюдаем наблюдаемая
наблюдаться: наблюдаются наблюдающиеся
наблюдение: наблюдения
надежда: надежду
наименование: наименование
найти: найден
наличие: наличия
намагнитить: намагниченные
напоминать: напоминает
направление: направлении направлению
население: население
насчитывать: насчитывает
наука: наук
находиться: находится находятся находящейся находящемуся находящихся
находка: находка
национальный: национальный
начало: начала
наш: наш нашей нашему нашим
небо: неба
небольшой: небольшая небольшое небольшой небольшом
невозможно: невозможно
нейтронный: нейтронные
некоторый: некоторые
немой: нем
необходимо: необходимо
необычный: необычные необычный
непосредственно: непосредственно
непосредственный: непосредственной
несколько: нескольких
низкий: низкой
новость: новостей
новый: новые новый новым новых
ной: ной
ном: ном
номер: номера
ные: ные
обвести: обведена
обзор: обзор обзора
обитатель: обитателю
обладать: обладает обладают
область: области область
обнаружение: обнаружение
обнаруживаться: обнаруживаются
обнаружить: обнаружен обнаруженным обнаружено обнаружены обнаружив обнаружил обнаружили обнаружить
обозначение: обозначение
обозначить: обозначена обозначено обозначены
обращаться: обращаются обращающееся
обрести: обретет
обсерватория: обсерватории
общий: общая общего
объединить: объединенные
объект: объекта объектов объекты
объяснение: объяснение
обычно: обычно
обычный: обычной
один: одна одно одного одну
однако: однако
означать: означает
около: около
окрестность: окрестностях
опровергать: опровергает
оптический: оптический оптических
опубликовать: опубликована опубликованной
оставаться: остается
остров: острове
остывать: остывает
отдельный: отдельном
открытие: открытие открытии открытия
открытый: открытого
открыть: открыть
отличие: отличие
отметить: отметили
относительно: относительно
относиться: относится
оцениваться: оценивается
очень: очень
пальма: пальма
параметр: параметры
парсек: парсека
первый: первого первым первых
передний: переднем
пересекать: пересекают
период: периодом
перспектива: перспективы
пиковый: пиковой
пк: пк
план: плане
плотность: плотностью
плотный: плотных
поверхностный: поверхностной
поглотить: поглотила
поглощать: поглощает
подводить: подводя
подобный: подобные подобных
подсказка: подсказки
подтвердить: подтвержденных
подтвердиться: подтвердится
подтверждение: подтверждения
позволять: позволяет позволяют позволяющего
показать: показали показать
показывать: показывают
пол: полу
поле: поля
полностью: полностью
положение: положение
получать: получать
получить: получен полученные получившая получивший получить
полёт: полеты
поместиться: поместились
помочь: помогла
помощь: помощью
понимание: понимания
порядок: порядка порядок
последний: последних
последовательный: последовательных
последующий: последующие
поток: потоки потоков
потускнеть: потускнела
поэтому: поэтому
пояснять: поясняют
правило: правило
правильно: правильно
превосходящий: превосходящее
предел: пределах
предполагать: предполагаемая
предположение: предположение
предположить: предположить
предсказать: предсказано предсказать
представление: представлениям
прежде: прежде
препринт: препринтов
признак: признаки
признать: признан
прийти: пришла
примерно: примерно
примечательный: примечательное
принадлежащий: принадлежащего
принадлежность: принадлежности
присутствовать: присутствует
провести: провести
проводиться: проводились
произойти: произошедшее произошел
происхождение: происхождение
пройти: пройдут
промежуточный: промежуточной
протекать: протекающие
профиль: профили
проходить: проходит
процесс: процесс процессах процессы
прошлый: прошлом
псевдоцвет: псевдоцвете
публикация: публикация
пузыриться: пузырящаяся
пульсар: пульсар пульсара пульсаров пульсаром пульсары
путь: путей пути путь
путём: путем
пучок: пучки
пылевой: пылевые
пыль: пыли
радиовсплеск: радиовсплесков
радиотелескоп: радиотелескопа
раз: раза
развитие: развития
различаться: различающиеся
размер: размера размерам
разрешать: разрешающая
разрешение: разрешением
рамка: рамках
ранее: ранее
ранний: ранней раннюю
располагаться: располагаются
расположить: расположены
рассеянный: рассеянное рассеянном рассеянных
рассказать: рассказали
рассказывать: рассказывает
расстояние: расстояние расстоянии расстоянию расстояния
расчёт: расчетам
реальный: реальном
регистрация: регистрации
регистрироваться: регистрировалось
результат: результате
рентгеновский: рентгеновских
рзс: рзс
рок: роке
роль: роли
руководство: руководством
рядом: рядом
самый: самых
сверкать: сверкающий
сверхмассивный: сверхмассивная сверхмассивной сверхмассивных
сверхновый: сверхновая сверхновой сверхновых
свет: света
светимость: светимости
светлячок: светлячок
световой: световых
свидетельствовать: свидетельствует
свой: своего своей своих
свойство: свойства
свыше: свыше
связанный: связанных
связать: связано
сдвиг: сдвигом
сделать: сделали
северный: северный
сегодняшний: сегодняшний
секунда: секунд секунду
сервер: сервере
серый: серыми
серьёзно: серьезно
сигнал: сигнала
сильно: сильно
сильный: сильного
симметричный: симметричной
синий: синее
синь: синей
система: систем системе системой системы
скопление: скопление скоплении скоплений скоплению скопления скоплениях
скорее: скорее
скорость: скорости скорость скоростью скоростями
скромный: скромными
слева: слева
следовательно: следовательно
слиться: сольются
слияние: слияний
случай: случае случаев
сместить: смещены
смоделировать: смоделировала
смотреть: см
смочь: смог
снизиться: снизилась
снимок: снимки
собрать: собрал
собственный: собственного
событие: событие событий
совершенный: совершенные
совет: совет
современный: современные современным
согласно: согласно
содержать: содержат содержит
содержимое: содержимом
созвездие: созвездии созвездию
солнечный: солнечных
солнце: солнца
сообщить: сообщено сообщили
соответствовать: соответствует соответствующей
соответствующий: соответствующими
соседка: соседки
сосредоточить: сосредоточенных
состав: состав
составить: составило
составлять: составляет
спектр: спектра спектры
спектральный: спектральные
специалист: специалистов
сплюснутый: сплюснутый
спонтанность: спонтанности
способность: способность
справа: справа
спустя: спустя
спутник: спутника спутники
сравнение: сравнению сравнения
сравнимый: сравнимую
сравнительно: сравнительно
среда: среды
среднее: среднем
срок: срок
стадия: стадии
старший: старше
статья: статье статья
сторона: сторону
стрелец: стрелец стрельца
строительный: строительных
суммарный: суммарная
существовать: существовала существовать
сферический: сферического сферической
сформировать: сформировали
сформироваться: сформировавшегося сформировалась
считать: считает считают
считаться: считалось
также: также
такой: такие такими таких такого такое такому
телескоп: телескоп телескопа телескопов
терраформирование: терраформирование
тесно: тесно
течение: течение
тип: типа
точка: точками точки
точный: точные
транзиентный: транзиентные транзиентных
трудно: трудно
тысяча: тысяч
тёплый: теплый
увеличение: увеличением
увеличивать: увеличивая
угловой: угловое
удивительно: удивительно
удивительный: удивительной
уиллотта: уиллотт
указание: указанием
указывать: указывает указывают
улучшить: улучшило
уместно: уместно
университет: университет
уникальный: уникальные уникальным
условие: условиях
уступать: уступает
участвовать: участвующих
учёный: ученые ученых
уэбба: уэбб уэбба
уэллслить: уэллсли
фактор: факторам
форма: форма формой форму
формирование: формирование формирования
формироваться: формировались формироваться формируется
фотограф: фотограф
фундаментальный: фундаментальных
характеризоваться: характеризуются
характеристика: характеристиками
ход: ходе
центр: центра центрах центре центру
центральный: центральная центральной центральную центральный
чандра: чандры
частота: частотой
часть: части
ченный: ченные
четыре: четыре
число: числе число
чрезвычайно: чрезвычайно
чёрный: черная черной черные черным черных
чёткий: четкое четкую
шаров: шаровых
шаровой: шаровое шаровые
широкий: широкие
эволюционировать: эволюционировать
эволюция: эволюции эволюцию
эйнштейн: эйнштейна
экстремальный: экстремальной экстремальных
электромагнитный: электромагнитного
элемент: элементов
этап: этапе
этот: эта этих этому
эффект: эффект
южный: южной
юпитер: юпитера
являться: является
явный: явные
ядро: ядра
яркость: яркости яркость яркостью
