автоматический: автоматических
автономный: автономных
активность: активности
активный: активнейшее
альбедо: альбедо
альварес: альваресов
альтернатива: альтернатив
американский: американская американские
амс: амс
анализ: анализ анализа
анализатор: анализатор
андрей: андрей
антенна: антенны
античный: античных
апокалиптический: апокалиптические
апофис: апофис
аппарат: аппарат аппарата аппаратов аппараты
ассигнование: ассигнованиям
астероид: астероид астероида астероидам астероидов астероидом астероиду астероиды
астероидный: астероидная астероидно астероидного
астробиологический: астробиологических
астробиология: астробиологии астробиология
астроновость: астроновости
атмосфера: атмосфере атмосферу атмосферы
атомный: атомный
аэлит: аэлита
безымянный: безымянного
бесконтактный: бесконтактные
биомаркер: биомаркеров
биосигнатура: биосигнатур
благодаря: благодаря
ближний: ближней
близкие: близким
близкий: ближайшему ближайшие ближайшую ближе близки близких близкое
близко: близко
близость: близость близостью
блок: блоком
блокбастер: блокбастерам
бо: бо
боеприпас: боеприпасов
бок: бокам
боковой: боковых
больший: большие
большинство: большинства
бортовый: бортовых
будущее: будущее
будущий: будущих
бур: буром
бурить: бурить
бушевать: бушующий
быстро: быстро
быстрый: быстрой быстрыми
быть: будут
бюджет: бюджета бюджеты
важный: важен важна важнее важнейшим важным
вариант: вариант варианта вариантами вариантов варианту варианты
вариация: вариации
вблизи: вблизи
век: века
венера: венера венере венеры
вернуть: вернули
вернуться: вернулись
вероятно: вероятно
вероятный: вероятная вероятнее вероятны
версия: версию
вести: ведет
весь: всей всему
весьма: весьма
вечный: вечные вечными
вещество: веществ
взгляд: взгляд взглядов
взор: взора
взрыв: взрыва
вибрация: вибрации
вид: виде
видно: видно
видный: видное
викинг: викинги
включать: включают
включая: включая
вместо: вместо
вначале: вначале
внеземной: внеземная внеземной внеземных
внешний: внешней
внутри: внутри
вовлечь: вовлечен
вода: воды
водяной: водяного
возврат: возврату
воздействие: воздействия
возле: возле
возможно: возможно
возможность: возможности
возможный: возможен возможны
возникать: возникала
возрасти: возросла
война: война
войти: вошла
вокруг: вокруг
вопрос: вопрос вопросом вопросы
восемь: восемь
восполнение: восполнения
восьмой: восьмое
вояджер: вояджеров
впоследствии: впоследствии
врезаться: врежется
временной: временного
время: времен время
вскоре: вскоре
вслед: вслед
всплеск: всплеск
всё: всё
второй: вторая второй вторую
вход: входа
выбираться: выбираться
выбор: выбор
выбрасывать: выбрасываемых
выбрать: выбрана
выброс: выбросов
выбросить: выброшенного
вывод: выводу
вымирание: вымирания
выпускник: выпускник
высадиться: высадившиеся
высокий: высоким высокой
выступать: выступают
вытянутый: вытянутую
выхлоп: выхлоп
выход: выход выхода
выходить: выходить
выше: выше
выявить: выявлены
выявление: выявления
выяснить: выяснить
галилеев: галилеевых
галилей: галилеем
галилео: галилео
галька: галька
ганимед: ганимеда ганимеду
гвоздь: гвоздь
гейзер: гейзера гейзеров
генератор: генераторы
геологический: геологической
гигантский: гигантскими
гидрат: гидратов
гипотеза: гипотеза гипотезы
глава: глава
гладкий: гладкая
глобальный: глобального
глубина: глубине глубины
говорить: говоря
говориться: говорилось
год: год года годов году годы лет
голливудский: голливудским
гомановский: гомановская
горячий: горяча
гравитационный: гравитационное гравитационные гравитационным
гравитация: гравитацией
гроб: гроба
грунт: грунта
давать: дает
далеко: далеко
дальнейший: дальнейшими
дальний: дальней дальних
далёкий: дальше
данные: данными данных
данный: данного
дартс: дартс
дата: дата
дать: данная
два: две двум двух
двигатель: двигателей двигателя
двигательный: двигательная
движение: движении
двойной: двойная
двуликий: двуликий
двухлетний: двухлетняя
девять: девять
деймоса: деймоса
действительно: действительно
действовать: действующего
делать: делали делать
демонстрация: демонстрация
десятилетие: десятилетия
десять: десяти
детализировать: детализированное
деталь: детали
детектор: детектор
джон: джон
джулия: джулии
диапазон: диапазонах
дидим: дидим дидима
дидимос: дидимос
дидимоса: дидимоса
дизайн: дизайну
диморф: диморф диморфа
диморфос: диморфоса диморфосе
динамика: динамики
динозавр: динозаврами динозавров
длинный: длинной
длительный: длительных
добавить: добавили
довольно: довольно
договор: договоров
долгий: долгий долгое
должный: должна
долл: долл
дополнительно: дополнительно
дополнительный: дополнительной
дорогой: дорогим дорогих
доставлять: доставляемых
достаточно: достаточно
достаточный: достаточную
достигнуть: достичь
доступный: доступной
др: др
другой: другие других другое другому другую
европа: европе европой европу европы
европеец: европейцы
европейский: европейская европейские европейский европейскими европейской
естественный: естественным
ждать: ждать
железа: железе
жидкий: жидкой
жизнь: жизни жизнь
забить: забили
завершение: завершение завершения
зависеть: зависят
зависимость: зависимости
задача: задача задачами задачи
задействовать: задействуют
задержка: задержек задержки
заключаться: заключалась
закон: закон
закончить: закончат
закрытый: закрыто
заметить: заметит заметить
заметно: заметно
замкнутый: замкнутую
занимать: занимает
занятый: заняты
занять: займет
запланировать: запланированных
запретить: запрещено
запуск: запуск запуска запуски запусков
запустимть: запустимть
запустить: запустили запустить запущена запущенная запущенный запущены
зарождаться: зарождается
заряд: заряда
засветка: засветки
зато: зато
затормозить: затормозить
затрагиваться: затрагивается
зачастую: зачастую
защита: защита защиты
звезда: звезды
зевс: зевс
земля: земле землей земли земля
земной: земную
златовласка: златовласки
знать: знаем
значительный: значительна
зона: зона
зонд: зонд
зондирование: зондирования
зрение: зрения
идентификация: идентификации
идея: идеи идея идеями
идти: идущее
из: изо
известный: известной
изменение: изменение
измерить: измерить
изначальный: изначальный
изображение: изображение изображений
изучение: изучение изучения
изучить: изучить
илона: илона
иметь: имеет
импакт: импакта
иначе: иначе
индикатор: индикаторов
инженер: инженер инженеру
инструмент: инструмент инструментами инструментов инструментом инструменты
инструментарий: инструментарием
интеграция: интеграции
интересно: интересно
интуитивный: интуитивном
инфографик: инфографика
информация: информации
ионник: ионников
ионный: ионных
искать: искать
использование: использование
использовать: использовал использовали использует использующими
испытание: испытания
исследование: исследований исследования
исследователь: исследователей исследователи
итак: итак
итальянский: итальянские
каждый: каждой
казаться: кажутся
какой: какие каким
каменный: каменный
камера: камеры
канал: каналы
карлик: карлик
карта: карт карту
картирование: картирования
картографирование: картографирование
картографический: картографический
касаться: касается касалось
кассинь: кассини
качнуться: качнулся
кг: кг
кеплер: кеплер
километр: километра километров
километровый: километрового
кинетический: кинетический кинетическом
кирпичик: кирпичиков
кислота: кислот
китайский: китайская китайский
класс: класса
ключевой: ключевой ключевым
км: км
колин: колин
количество: количества
коллега: коллегами
коллектив: коллектив коллективы
кольцо: кольцо
комета: комету
кометный: кометная
комиссия: комиссии
коммерческий: коммерческих
компонент: компоненты
конгресс: конгресс конгресса
конгрессмен: конгрессмен
конец: конца конце
конкурс: конкурсов
конфигурация: конфигурации
концепция: концепция
координация: координации
кора: коры
корабль: корабля
короткий: короткие
коррекция: коррекций
космический: космическая космические космический космических космического
космос: космос космосе
который: которого которой которые который которых
коэффициент: коэффициентом
крайне: крайне
кратер: кратера
крупный: крупнейшая крупные крупный
крышка: крышку
кто: ком
куб: куб
кубсат: кубсатов
кубсата: кубсата кубсатами кубсаты
кульберсон: кульберсон кульберсона
культура: культуре
лагранж: лагранжа
лакуна: лакун
ледяной: ледяной
лендёр: лендер
лететь: летевший летит летят
либо: либо
личный: личное
локальный: локального
льший: льшие
любой: любого любое любой
любопытно: любопытно
лёгкий: легких
лёд: лед льда льдами
магнитный: магнитного
магнитометр: магнитометр
максимальный: максимальные
максимум: максимум
маленький: меньше поменьше
мало: мало
маловероятный: маловероятными
малый: малой малых
маневрировать: маневрировать
манёвр: маневров маневром маневры
маринера: маринеры
марс: марс марса марсе марсу
марсианский: марсианские марсианских марсианское
марсоход: марсоход
маска: маска
масса: масс масса массам массе массу массы
массивный: массивный массивных
массовый: массовой
материал: материала материалов
маятник: маятник
международный: международными международных
межпланетный: межпланетная межпланетные межпланетных
мейнстрим: мейнстрим
мексика: мексике
менее: менее
мера: мера мере
место: мест место
местонахождение: местонахождение
местоположение: местоположения
метод: метод методе методы
метр: метра
метровый: метрового метровый
механика: механики
мильтон: мильтон
минералогический: минералогического
мир: миров
миссия: миссии миссий миссия миссиям миссиях
мкс: мкс
многие: многие
многое: многом
множественный: множественных
множество: множество множеством
могущественный: могущественный
модель: моделям
модификация: модификация
модуль: модулями
молодой: молодая
момент: момент момента моментов
мочь: мог могут
мощный: мощная мощной мощную
мур: мур
мыслитель: мыслителей
мягко: мягко
наблюдатель: наблюдатель
наблюдение: наблюдений наблюдения наблюдениях
набраться: набрались
навигация: навигации
нагрузка: нагрузку
надежда: надежды
надеяться: надеются
назад: назад
назвать: назвали
наземный: наземной наземные наземных
называть: называемая называемые называемых
наименование: наименование наименования
найти: найден найти
найтись: нашелся
наличие: наличие
намного: намного
нанести: нанести
напоминать: напоминающих
направить: направленному
например: например
настолько: настолько
насчёт: насчет
наука: науке
научный: научному научную научный научными научных
начало: начале
начальник: начальник
начальный: начальное начальные
начать: начнет
начаться: начавшаяся начнется
начинаться: начинается
небесный: небесных
небольшой: небольших небольшого небольшой
недалеко: недалеко
неделя: неделю
недолго: недолго
незагрязнение: незагрязнением
незадолго: незадолго
некоторый: некоторых
нелегко: нелегко
немедленный: немедленных
немецкий: немецкой
немногое: немногим
необходимость: необходимостью
необходимый: необходимы
необычно: необычно
неожиданно: неожиданно
неопасный: неопасного
неплохой: неплохое
неподалёку: неподалеку
неправильный: неправильном
непростой: непроста
нерегулярный: нерегулярные
несколько: несколько
несмотря: несмотря
нести: несет нести
новый: нового новый новых
носитель: носителе носителя
нужно: нужно
нуклон: нуклон
оба: оба обе обеим обоих
обеспечить: обеспечил обеспечило
обзорный: обзорный
обитаемость: обитаемости
обитаемый: обитаемых
обитать: обитает
обнаружение: обнаружение обнаружения
обнаружить: обнаружены обнаружил
оболочка: оболочки
оборудование: оборудования
оборудовать: оборудован
обосноваться: обосновалась
образ: образом
обращение: обращения
обсерватория: обсерватории
обследование: обследование
обсуждение: обсуждений
общественный: общественную
общий: общего общее общим общих
объединить: объединены
объединять: объединяет
объект: объект объекты
объём: объема объемы
обычно: обычно
один: одна одной
однако: однако
одновременно: одновременно
однозначный: однозначного
одноразовый: одноразовая одноразовой одноразовую
океан: океан океана океанах
окно: окна окно
около: около
околоземный: околоземного околоземные
окрестность: окрестности
округ: округе
октокоптер: октокоптер
октябрь: октября
он: нему
она: нею
они: ними
оно: оно
опасность: опасность
опасный: опаснейшей опасный опасных
операция: операций
определение: определение определения
определять: определять
оптимизировать: оптимизировать
оптимизм: оптимизм
оптимсальный: оптимсальное
опыт: опыта
орбита: орбита орбитами орбитах орбиту орбиты
орбитальный: орбитального орбитальной орбитальные орбитальный орбитальных
органический: органических
освещение: освещение
осложнение: осложнения
основание: основании
основной: основной
основный: основная основным основными
особенно: особенно
особенность: особенностей
особо: особо
остаться: оставшегося останутся
осуществить: осуществить
ответ: ответ ответа ответов
ответственный: ответственному
отделение: отделение
отец: отца
отклонение: отклонение отклонения
открытый: открытого открытом
отличие: отличии отличий
отложить: отложен
отмена: отмены
отменный: отменен
отметить: отметить
относительно: относительно
отправить: отправить
отснять: отснять
отсрочка: отсрочки
оттуда: оттуда
официальный: официальное
оценка: оценка оценки
очень: очень
падение: падение
панель: панелей панели панелями
пара: пара пары
параллельно: параллельно
параметр: параметр параметры
парусник: парусников
первоначальный: первоначальных
первый: первая первого первое первой первом первую первый первых
переделка: переделок
переименовать: переименованного
перейти: перешел
перелёт: перелет
перемещаться: перемещаться
перенос: переносу
перепланировка: перепланировки
период: период
песок: песка
плазменный: плазменный
план: план планах плану планы
планета: планет планетах планеты
планирование: планирование планировании
планировать: планировать планируемое планируют
планироваться: планируется
пластичность: пластичности
плотность: плотность
площадка: площадок
плутоний: плутонии
побочный: побочная
повезти: повезет
поверхность: поверхности поверхность поверхностью
повлиять: повлиять
подготовка: подготовка
поддержка: поддержку
подкомитет: подкомитета
подлёдный: подледного
подобный: подобного
подповерхностный: подповерхностного подповерхностной подповерхностном
подробный: подробную
подрыв: подрыв
подтвердить: подтвердив
позвать: позвали
позволить: позволили позволит
позволять: позволявших позволяет позволяющие
поздний: позже
поздно: поздно
позиция: позицию
поиск: поиск поисках поисков поиском поиску
поймать: поймать
пока: пока
показать: показавшие
показывать: показывающая
покровитель: покровитель
покрыть: покрытом
поле: поле поля
полететь: полетит
политический: политическую
полностью: полностью
половина: половине половину
полуостров: полуострова
получение: получения
получить: полученных получил получили получить
получиться: получится
полёт: полета полетах
помощь: помощь помощью
понятно: понятно
понятный: понятны
попадаться: попадающегося
попасть: попасть
популярность: популярности популярность
попутчик: попутчика
попытаться: попытается попытаются
пора: пор порах
поработать: поработать
порядок: порядке
посадка: посадки
посадочный: посадочными посадочных
последний: последней последние
последователь: последователи
последствие: последствий
последующий: последующее
постоянный: постоянных
потенциально: потенциально
потенциальный: потенциальной потенциальных
потребовать: потребовал
похожий: похожая похожий
поэтому: поэтому
появиться: появилась появился
появление: появлением появления
правило: правилами правило
превысить: превысила
предварительный: предварительное
предел: пределах
предлагать: предлагаемые
предложение: предложение предложения
предложить: предложена предложил
предотвратить: предотвратить
предполагать: предполагал
представление: представлении
представлять: представляет
предшественник: предшественника
предыдущий: предыдущих
прежде: прежде
прежний: прежнего
приближение: приближение
прибор: прибор
прибытие: прибытия
привести: привели
приводить: приводит
пригодность: пригодности
приземление: приземление
прийти: прийти пришел
прийтись: придется
прилёт: прилета
применять: применять
пример: пример
примерно: примерно
принять: принял принято принять
приняться: принялись
приоритет: приоритетом
причина: причиной
проблематичный: проблематичны
провести: провели
прогнозировать: прогнозируемые
программа: программа программой программу программы
продление: продление
продолжительность: продолжительности
продолжить: продолжили
продолжиться: продолжилась
продукт: продукты
проект: проект проектами
прожить: проживет
произойти: произошло
пройти: пройдет
пролегать: пролегал
пролететь: пролететь пролетят
пролёт: пролета пролетов пролеты
пролётный: пролетных
проникать: проникающий
простой: проще
пространственный: пространственного
пространство: пространстве
против: против
профинансировать: профинансирована
процесс: процессе
прочий: прочих
прямой: прямой прямую
пуск: пуска пуском
пустынный: пустынна
путь: пути путь
путём: путем
пыль: пыли
работа: работах работе
работать: работать
работоспособность: работоспособности
равно: равно
радар: радар
радиатор: радиаторами
радиация: радиации
радиоизотопный: радиоизотопные
радиус: радиусом
развернуть: развернутом
развитие: развития
разгонный: разгонным
разделить: разделена разделить
размах: размах
размер: размера
разница: разница разницей
разный: разного разных
разработка: разработка разработкой разработку
разработчик: разработчиков
разредить: разреженной
разрешение: разрешением
разумный: разумной
район: районе
ракета: ракете ракеты
ракетный: ракетных
рамка: рамках
ранжирование: ранжирования
ранний: пораньше раньше
раскрыть: раскрыли
распределение: распределения
расследование: расследование
рассматриваться: рассматривались
рассмотреть: рассмотреть
расстояние: расстояниях
расход: расходу
расширить: расширенной
рб: рб
реактор: реактором
реголит: реголита
регулярный: регулярные
редко: редко
результат: результатов
решение: решения
решить: решено
рн: рн
род: рода
рой: рой
роскосмос: роскосмоса
россия: россии
рост: роста
рядом: рядом
сам: самих само самого самой
самый: самую
сатурн: сатурна сатурну
сближение: сближения
сбор: сбора
сверхразвить: сверхразвитая
сверхтяжёлый: сверхтяжелого сверхтяжелой
свет: света
своевременный: своевременное
свой: своего своей свой
свойство: свойств
свыше: свыше
связаться: связались
связываться: связываются
связь: связь
сделать: сделан
сей: сей
середина: середине
серьёзность: серьезности
серьёзный: серьезную
сесть: сесть
система: систем система системе системой системы
системный: системный
сквозь: сквозь
скорость: скорости скорость
скрытый: скрытой
слабый: слабее
след: следов
следить: следящими
следующий: следующие следующими
слишком: слишком
сложность: сложностью
сложный: сложной
слой: слое
случай: случае
случиться: случился
смелый: смелая смелыми
смена: смену
сместиться: сместился
смотреть: см
смочь: смогут
смысл: смысл
снабдить: снабженные
снаряд: снаряд
сначала: сначала
снижение: снижение снижения
снова: снова
совершенно: совершенно
советский: советские
совместный: совместной
согласно: согласно
создавать: создают
создать: созданного
солнечный: солнечное солнечной солнечные солнечными солнечных
солнце: солнца солнце солнцу
соль: солей
солёность: солености
сообщество: сообществу
соответственно: соответственно
соприкосновение: соприкосновение
сопутствовать: сопутствующих
сориентировать: сориентировали
соседство: соседства
сосредоточиться: сосредоточиться
состав: состава
составить: составить
составление: составлением
состояние: состоянии состояния
состоять: состоит
состояться: состоялись состоялось
спектрограф: спектрограф
спектрометр: спектрометр
специалист: специалистам специалистами специалисты
список: списков
способный: способны
спрогнозировать: спрогнозирована
спрятать: спрятана
спустя: спустя
спутник: спутник спутника спутникам спутнике спутников спутнику
срабатывание: срабатывании
сравнение: сравнения
сражение: сражении
среди: среди
срочность: срочность
стадия: стадии
становиться: становится
станция: станцией
стараться: стараются
стартовать: стартовать
старый: старая старые
стать: стала стали стало
статья: статью
стоимость: стоимости
стоить: стоит
столкновение: столкновение столкновения
сторона: стороной сторону стороны
странник: странниками
страшилка: страшилок
строго: строго
строительство: строительства
структура: структуры
ступень: ступени
суметь: сумел сумела
существенный: существенная существенный
существовать: существовавшей существовать
сход: сходе
сходный: сходных
сценарий: сценариев сценарии
считать: считали
считаться: считавшийся считалось считаются
съёмка: съемки
сын: сына
сэкономить: сэкономить
также: также
таки: таки
таковой: таковой
такой: такая такие таким такого
твердотопливный: твердотопливным твердотопливных
твёрдый: твердый твердых
текущий: текущие
телескоп: телескоп телескопов
тело: тел тела
тема: темами темы
температурный: температурных
тенденция: тенденция
тепло: тепла
тепловой: тепловые
теплофизический: теплофизических
термин: термин
тест: тесты
тестирование: тестирования
технический: технических
технологически: технологически
титан: титану
толстой: толстого
толщина: толщины
топливный: топливной
топливо: топлива
топография: топографии
торговый: торговых
торможение: торможение торможению
тот: те тех той тому
точка: точка точки
точно: точно
траектория: траектории траекторий траекторию траектория траекториями
требовать: требовавшие требуемая требует
требоваться: требуется
три: трех
тривиальный: тривиален
трёхлетний: трехлетнюю
туда: туда
тунгуска: тунгуской
тысяча: тысячи тысячу
тягач: тягачи
тёплый: теплой
угловой: углового
угроза: угроз угроза угрозой угрозы
удар: удара ударами
узкий: узкое
узкоугольный: узкоугольной
ультрафиолетовый: ультрафиолетовый
уменьшение: уменьшения
уничтожение: уничтожения
ураган: ураган
усиление: усиления
усилие: усилиям
усилиться: усилилась
ускользать: ускользают
ускользнуть: ускользнут
ускоритель: ускорителей
условие: условий условия
условно: условно
успеть: успела
успешно: успешно
установка: установка
уступить: уступил
утвердить: утверждена утвержденных
утверждение: утверждение
уточнение: уточнение
уточнить: уточнить
уход: уход уходу
участие: участие участия
участок: участке
учесть: учтены
учёный: ученым
ущерб: ущерб
уэллс: уэллса
фаза: фаз
фалкон: фалкона
фильм: фильм фильмах фильмов
финал: финал
финальный: финальными
финансирование: финансирование
фирма: фирмой
флорида: флориде
фокус: фокус
фокусироваться: фокусируются
фон: фоне
форма: формы
фото: фото
фотографирование: фотографирования
характеризация: характеризации
характеризовать: характеризовать
химический: химических
ход: ходе
холл: холла
холодный: холодном
хороший: лучших наилучшим
хотеться: хотелось
художник: художника
цель: целей цели цель целью
цена: цены
центр: центра
цивилизация: цивилизаций цивилизация
частица: частиц
часть: части часть
честь: честь
четыре: четыре четырех
чехарда: чехарда
число: числе
член: член
чрезвычайно: чрезвычайно
шар: шар
шесть: шесть
широкий: широким
широкоугольный: широкоугольной
экзопланета: экзопланет
экзотический: экзотические
экономия: экономия
экспансия: экспансия
экспедиция: экспедиции экспедиция
эластичность: эластичности
электричество: электричества
эллиптический: эллиптическая
эмиратский: эмиратской
энергетика: энергетика энергетики
энергия: энергии
энтузиазм: энтузиазма
энцелад: энцеладом
энцеладь: энцеладе
эпоха: эпохи
эра: эра
это: этим
этот: эта этих этому
эффективность: эффективность
юкатана: юкатан
юпитер: юпитер юпитера юпитеру
юпитерианский: юпитерианской
ядерный: ядерного ядерным ядерных
япония: японии
японский: японской
яркий: яркий
