абориген: аборигенов
австралия: австралии австралия
австралопитек: австралопитек австралопитеки австралопитеков
адаптация: адаптацию адаптация
адаптировать: адаптированы
азия: азии азию
александр: александр александром александру
америка: америка америке
амфибия: амфибии
аналог: аналогов
аналогичный: аналогичный
андаманский: андаманскими
археолог: археологи
археология: археологии археология
африка: африке африки
африканский: африканских
ашельский: ашельской
барьер: барьер
бег: бегу
безудержный: безудержному
берег: берегу
беседа: беседа беседе беседы
бизон: бизоном
биол: биол
биолог: биолог
биология: биология
биосфера: биосфера биосферу
благодаря: благодаря
благоприятный: благоприятны
ближний: ближнем
больший: большая большей большие большим наибольшие
большинство: большинстве
большой: большого большое большой
борис: борис бориса
будущее: будущее будущем
бумеранг: бумеранга бумеранги
бутылочный: бутылочные
бывать: бывает
быстро: быстро
быстрый: быстрому быстрый
быть: будем будут суть
важный: важная
вариант: вариант
ваш: вашим
верно: верно
вернуться: вернемся
вероятность: вероятность вероятностью
вероятный: вероятная
верхний: верхнего верхнему верхний
вести: ведут
вестись: ведется
весь: всей всем всему
ветвь: ветвей
вещь: вещи вещь
взрослый: взрослых
взять: взяли взять
вид: вид вида видами видов виды
видео: видео
видеоверсия: видеоверсия
видеть: видим
видимо: видимо
видимый: видимому
включая: включая
влечь: влекло
вместе: вместе
внятный: внятных
вовлечь: вовлечены
вода: воде
возвращаться: возвращаемся
возможно: возможно
возможный: возможной
возникать: возникают
возникновение: возникновение возникновении
возникнуть: возник возникла возникли возникло
возраст: возраст
волков: волков
вообще: вообще
вопрос: вопрос вопросы
ворон: ворон
ворона: вороны
восстановить: восстановить
восток: востоке
восточный: восточную
впечатление: впечатление впечатлением
впечатляющий: впечатляющая
вполне: вполне
время: временем времени время
вряд: вряд
вселенная: вселенной
встретить: встретили
всякий: всякие
всё: всё
второе: второе
второй: вторая
втрое: втрое
вы: вами
выводить: выводит
выглядеть: выглядит
выдающийся: выдающихся
выйти: выйти вышедших вышли
вымахать: вымахал
вымереть: вымерли вымерших вымрут
вымирание: вымирания
вымирать: вымирают
выполнять: выполняя
выпутаться: выпутаться
вырабатывать: вырабатывать
вырасти: вырос
вырваться: вырвался
высокий: высокая высокий высокой высшие
высокоразвитый: высокоразвитая высокоразвитые
высота: высот
выступление: выступления
выход: выход
вычеркнуть: вычеркнули
вязкий: вязком
гарпун: гарпуны
ген: ген генах гены
геометрический: геометрические
гибрид: гибридами
гигантский: гигантским
главное: главного главное
глупый: глупее
говорить: говорили говорить говоря говорят
говориться: говорится
говорящий: говорящий
год: года лет
голод: голода
гоминид: гоминид
гораздо: гораздо
горлышко: горлышки
город: города
гость: гостях
грань: грани
грузия: грузии
грунт: грунте
группа: групп группа группе группой группу
гумилёв: гумилёв
давать: давайте давали
давно: давно
далёкий: дальше
дарвин: дарвина
дарвиновский: дарвиновская
дать: дадим дали дать
два: две двух
двигаться: двигаться
движение: движения
двуногий: двуногие двуногих
деградация: деградация
деградировать: деградировала деградировать деградирует
действительно: действительно
делать: делает делали делать
дело: дела деле дело
демонстратор: демонстратор
денисовца: денисовцами
дерево: дерева
десяток: десятков
десять: десяти
детёныш: детеныши
деятельность: деятельность
диета: диете
дикий: дикой дикую
динозавр: динозавров динозавры
добавить: добавить
добыча: добыче
довольно: довольно
дойти: дошли
доказать: доказать
докт: докт
долгий: долгое долгому
долго: долго
должный: должен должны
доминировать: доминирующей
допустить: допустим
достататочно: достататочно
достаточно: достаточно
достигать: достигали
достигаться: достигалось
достигнуть: достигли достигнув достичь
драйв: драйв
древний: древнего древний
другой: другая другие другим других другого другое
думать: думать думаю
дух: духом
евразия: евразии
европейский: европейские
жевательный: жевательные
желаемый: желаемой
жертва: жертвам
жест: жестами
животное: животного животные животных
жизненный: жизненные
жизнь: жизни жизнь жизнью
жить: живут жил жили
жёсткий: жесткие жесткий
загнать: загнали
задавать: задавать
задать: заданной
задача: задача задачах задачей задачи задачу
заимствование: заимствование
заканчивать: заканчиваем
заключительный: заключительное
закономерность: закономерность
закономерный: закономерная
заметить: замечены
заметный: заметным
замысловатый: замысловатые
занять: займет заняла
запасти: запасенный
записать: записано
записка: записки
запрет: запрет
запуститься: запустился
запутывать: запутывать
зарождение: зарождении
затем: затем
заучиваться: заучиваться
зацепиться: зацепиться
зацепка: зацепки
зачаточный: зачаточный
защита: защиту
защитный: защитное
звуковой: звуковой
звёздный: звездной
здорово: здорово
земля: земли земля
знание: знание знаний
знать: знаем знаю знают
значит: значит
зрение: зрение
зуб: зубы
иголка: иголки
идеальный: идеальный
идти: идем идет шел
известный: известной
изготавливать: изготавливать
изготавливаться: изготавливаться
изготовление: изготовлении изготовления
издать: издать
изложить: изложите
изображение: изображения
изобразительный: изобразительное
изобрести: изобрели изобретет
изобретаться: изобретается
изобретение: изобретением изобретения
изолировать: изолированных
изолироваться: изолировалась
изоляция: изоляции
изощрённый: изощренной изощренные
израиль: израиле
илл: илл
именно: именно
иметь: имеет имели иметь имеют имеющим
иметься: имеется
имя: имена именами
иначе: иначе
индивид: индивиды
инновация: инновации инноваций
иной: ином
инструмент: инструменты
интеллект: интеллект интеллекта
интеллектуальный: интеллектуальных
интервью: интервью
интерес: интерес
интересно: интересно
интересовать: интересует
интернет: интернете
интуиция: интуиции
информация: информации информация
искалечить: искалечены
ископаемое: ископаемых
ископаемый: ископаемой
искусство: искусство
использовать: использовать
испытать: испытала
исторический: историческом
история: истории
исчезать: исчезает
исчезнуть: исчезли исчезнут
итак: итак
июнь: июня
каждый: каждого каждый
казаться: кажется казалось
кайнозой: кайнозое
кайнозойский: кайнозойскую
какой: какие какими каких какого какое какую
каменный: каменные каменными каменных
камень: камень камне камня
качественный: качественное
кит: киты
китообразный: китообразные
класс: класс
классический: классический
климат: климат климата
книжка: книжке книжки
когнитивный: когнитивная когнитивные
колоссальный: колоссальное колоссальную
комментарий: комментариев
коммуникация: коммуникацией коммуникации коммуникация
компьютер: компьютеры
конец: конце концов
конкретно: конкретно
конкурент: конкурент
конкуренция: конкуренцией конкуренции
контакт: контакты
контекст: контексте
копирование: копирование копирования
копировать: копируете копируют
кора: коры
корабль: корабли
короче: короче
косвенный: косвенных
космический: космические
кость: костей кости
костяной: костяных
который: которая которое которой которую которые который которым
коэволюция: коэволюция
край: крае
красивый: красивые
креационист: креационисты
кроме: кроме
крупный: крупного крупный крупных
кстати: кстати
кто: кого
культура: культура культуре культуру культуры
культурный: культурная культурного культурной культурную культурные культурный культурных
кумулятивный: кумулятивной
кусочек: кусочкам
ласко: ласко
лев: лев
леваллуазский: леваллуазская
легко: легко
лекция: лекциях
лестница: лестнице
летопись: летописи
либо: либо
линия: линии линия линиях
личный: личные личными
лишь: лишь
лодка: лодки
локально: локально
лужа: лужу
лука: луки
любить: любят
максимум: максимума
маленький: маленькая меньше
мало: мало
марков: марков марковым
масса: массы
массово: массово
мат: мат
материк: материках
материковый: материковой
матриархальный: матриархальным
медленный: медленный
мезозойский: мезозойской
менее: менее
меняться: менялся
место: места местах месте место
миллион: миллион миллиона миллионов
минимальный: минимальная
минус: минус
мир: мир мире
митинг: митинг
михаил: михаилом
млекопитающее: млекопитающие млекопитающих
многие: многие
многий: многих
многое: многого
многочисленный: многочисленная
множество: множество
мозг: мозг мозга мозгом
мой: моему
момент: момент момента
море: моря
мореплаватель: мореплаватели
москва: москве
мочь: мог могла могу могут можем можете
мощный: мощные
мы: нам
мысленный: мысленный
мышца: мышцы
мясо: мяса
наблюдать: наблюдать
наблюдаться: наблюдалось
набор: наборы
наверное: наверное
навсегда: навсегда
навык: навык
назад: назад
название: название
наземный: наземных
называть: называемое называют
наизусть: наизусть
найти: найденные найдены найдет найти
накапливать: накапливать
накапливаться: накапливаться накапливаются
накопительный: накопительной накопительную
накопление: накопление
намёк: намеки
например: например
народ: народом
насколько: насколько
настолько: настолько
наука: наук наука науки
научиться: научились
находить: находил находят
находиться: находятся
находка: находкам находок
начало: начала начало
начать: начал начали начнем
начаться: началось
начинать: начинает начинали
начинаться: начинается начиналось
наш: наш наша наши наших
неандерталец: неандертальцами неандертальцев
небольшой: небольшой
невероятный: невероятные невероятных
невозможно: невозможно
недавно: недавно
независимо: независимо
независимый: независимые независимых
неизбежно: неизбежно
неизбежный: неизбежен неизбежный
некий: некая некие некий неких некого
некоторый: некоторого некоторых
немного: немного
немножко: немножко
необходимость: необходимостью
необходимый: необходима необходимых
неочевидный: неочевидное
неплохо: неплохо
нервный: нервная
несколько: несколько
несчастный: несчастный
неторопливый: неторопливый
ниже: ниже
низкий: низком
никак: никак
никакой: никаких никакого никакой
никитин: никитиным
никто: никто
никуда: никуда
ниша: ниш
новый: новой новом новую новый новых
нога: ногах
номинант: номинанты
нужно: нужно
нужный: нужна
нуль: нуля
обезьяна: обезьян обезьяна обезьяны
обезьяний: обезьяньим
обкалывать: обкалывая
обладать: обладают
облегчение: облегчение
обмен: обмен
обнаружить: обнаружены
обозримый: обозримом
обработка: обработки
образ: образ образом образу
образование: образования
обрезать: обрезал
обсудить: обсудили
обсуждать: обсуждали обсуждать
обсуждение: обсуждение
обучение: обучение обучения
общаться: общаться
общение: общение
общественный: общественное
общий: общем общий
объявить: объявлены
объяснить: объяснить
объём: объем объема
обязательно: обязательно
обязать: обязано
огонь: огня
ограничение: ограничения
ограничить: ограничены
огромный: огромным
один: одна одни одних одно одной одном
одинаковый: одинакового
одновременно: одновременно
ожидать: ожидаю
озеро: озера
оказаться: оказалось
оказываться: оказываются
окончательно: окончательно
олдувайский: олдувайская олдувайскую
оно: оно
опережение: опережением
описывать: описывал
определение: определения
определить: определить
определённый: определенной определенном определенный
оптимистичный: оптимистичного
опубликовать: опубликовали
опыт: опыт опыта
орудие: орудие орудий орудия орудиям орудиями
орудийный: орудийная орудийную
основа: основе
основание: основания
основной: основной
особенно: особенно
особенный: особенным
особый: особые
особь: особи
оставаться: оставалось остается
оставить: оставленные
оставлять: оставляет
останавливаться: останавливается
остаться: остались
остров: островами острове
отбор: отбор
ответ: ответа
ответить: ответить
отдел: отделы
отдельно: отдельно
отдельный: отдельные
открывать: открывает
открытие: открытия
отличаться: отличающаяся
отнюдь: отнюдь
отрастить: отрастить
отрыв: отрывом
отряд: отряд
отсталый: отсталым
отсутствие: отсутствие
охотник: охотниками
очень: очень
очередной: очередная
ошибка: ошибки
ощущение: ощущений
палеолит: палеолит палеолита палеолиту
палящий: палящим
параллельно: параллельно
параллельный: параллельные
парантроп: парантропов парантропы
первобытный: первобытных
первый: первая первое первый первыми первых
передавать: передавали передавать
передаваться: передаваться передается
передача: передача
передний: переднем
перескочить: перескочат
переставать: перестает
переход: переход
пещера: пещеры
план: план плане
планета: планета планете
платить: платить
плацентарный: плацентарных
площадь: площадь
плюс: плюс
побочный: побочный
поведать: поведаете
поведение: поведение
повторяться: повторяющееся
повышение: повышении повышения
погулять: погуляли
поддерживать: поддерживаю
поддержка: поддержки
подняться: поднялся
подозрение: подозрения
подробный: подробные
подслушивать: подслушивает
подумать: подумать
подчёркивать: подчеркиваю
подъязычный: подъязычной
пожизненно: пожизненно
позволить: позволить
позволять: позволяет позволять
поздний: позже
поздно: поздно
пойти: пойдем пойдет пошел пошла пошло
пока: пока
показывать: показывает показывать
поколение: поколение поколений поколения
полдеть: полдела
полезный: полезное
ползать: ползают
полтора: полтора
полуостров: полуостровом
получаться: получается
получить: получить
получиться: получится
пользоваться: пользоваться пользуются
полёт: полет полетом полету
помощь: помощью
поначалу: поначалу
понимать: понимает понимаете понимаю понимают
понять: понял
попугай: попугаев попугаи
популяция: популяции популяция
поразительный: поразительная
порог: порога
породить: породил
порядок: порядка
послать: пошли
последний: последнее последние последним
последовательный: последовательного
постепенно: постепенно
построение: построению
построить: построила
постёгивать: постегиваемой
потеря: потерь
потомок: потомков
поумнение: поумнение
похоже: похоже
похожий: похожего
почему: почему
поэма: поэму
поэтому: поэтому
появиться: появилась появились появилось появился появиться появятся
появление: появление появлением появлению
появляться: появляется появляются
правда: правда
правильно: правильно
правильный: правильное
практика: практики
практически: практически
предвидеть: предвидеть
предел: пределами пределах пределы
предок: предки предков
предопределённость: предопределенность
предполагать: предполагает предполагала
предположение: предположением
представить: представить
представлять: представляет представляя
предстоять: предстоит
предугадать: предугадать
прежде: прежде
преимущество: преимущество
прекрасно: прекрасно
прекрасный: прекрасный
премия: премии
преодолеть: преодолеть
препятствие: препятствие
привести: приведет приведу привело привести
приводить: приводит
признак: признаков
прийти: придут прийти
прийтись: пришлись пришлось
примат: приматами приматов приматы
пример: пример примеры
примерно: примерно
примитивный: примитивная примитивного примитивной примитивные примитивный примитивными
приносить: приносить
принцип: принципе
прислать: пришли
присутствовать: присутствует
приходить: приходят
приходиться: приходилось приходится
причина: причинам
проблема: проблему
прогресс: прогресса
прогрессивный: прогрессивной прогрессивных
продвинуть: продвинутых
проделать: проделать
проиграть: проиграют
производить: производящему
производство: производства
произойти: произошел произошли произошло
происходить: происходили происходят
прорывный: прорывным
просветитель: просветитель
простенький: простенькие
просто: просто
простой: попроще простой
протяжение: протяжении
проход: проходу
процветание: процветанию
процветать: процветал
процесс: процесс
прошлый: прошлый
проявлять: проявляют
проявляться: проявляться
птица: птиц птицами птицы
птицеголов: птицеголовым
пускай: пускай
путь: путей пути путь
пытаться: пытались
работать: работает
рабочий: рабочее
ради: ради
радикальный: радикального
радостно: радостно
развиваться: развивались развиваться
развивающийся: развивающаяся
развитие: развитие развитию развития
развитой: развитого развитому
развиться: развился
разговаривать: разговаривает
разговор: разговор разговоры
разделить: разделить
разделять: разделяют
размер: размер размера размеров размеру
разнообразный: разнообразным
разный: разными разных
разойтись: разошлись
разрыв: разрывом
разум: разум разума разумом
разумный: разумное разумной
район: районах районе
ранить: раненным
ранний: ранних раньше
рано: рано
раскачиваться: раскачивалось
раскрой: раскрою
распространиться: распространившаяся распространилась
распространяться: распространялись
расселяться: расселяться расселяются
рассуждение: рассуждения
рассчитывать: рассчитываем
расти: расти
растительный: растительной
расцвет: расцвета
расширяться: расширялась
реагировать: реагирует
реально: реально
ребята: ребят ребята
революция: революцией революции революций революция
редактор: редактора
редкий: редкие
результат: результате
ремесло: ремесла
репликация: репликации
рептилия: рептилии
речь: речи речь
решать: решать
решение: решение
род: рода
родиться: род
рождение: рождение
россия: россии
рост: рост росту
рот: ртом
рука: рук
русло: русле
рыбалка: рыбалки
ряд: ряд
саванна: саванн саванне саванну
сам: самого самом
самка: самки
самоподдерживающийся: самоподдерживающийся
самый: самая самое самые самым самых
сапиенс: сапиенсов
свет: свет свете
свидание: свидания
свидетельство: свидетельств
свой: своего своей свои своим своих
свойство: свойство
связанность: связанность
связать: связанная связано
сделать: сделали сделать
себя: собой
сегодня: сегодня
секрет: секреты
сельский: сельского сельское сельскому
серия: серия
серьёзно: серьезно
серьёзный: серьезные серьезный
сесть: севшими
сеть: сети
сильно: сильно
сильный: сильный
система: система системы
систематически: систематически
скажем: скажем
сказать: скажешь сказал сказать
скачок: скачок
скептик: скептика
сколько: сколько
скорее: скорее
след: следов следы
следующий: следующий
слово: слов словам словами словах слово
сложиться: сложились сложилось сложиться
сложно: сложно
сложноватый: сложновато
сложный: сложна сложная сложное сложную сложны сложные сложный сложных
слон: слоны
случай: случае случаев случаи случай случаях
случайность: случайность
случиться: случилось
слушатель: слушателям
смотреть: см смотрите
смочь: смог смогли сможет
смущать: смущает
смысл: смысле
сначала: сначала
снова: снова
собака: собак собака собаки собаку
собиратель: собирателями
собираться: собираемся
собственно: собственно
событие: событие событием
совершенно: совершенно
совершенный: совершенного
совершенствоваться: совершенствовался
совершить: совершен совершили
современный: современного современному современную современный современных
согласиться: согласятся
согласно: согласно
согласный: согласен
согласоваться: согласуется
сожаление: сожалению
создавать: создавала создавать создает
создать: создала создали создаст создать
сойти: сойти
солнце: солнцем
сон: сном
соображение: соображений соображения
сообразительный: посообразительнее сообразительны сообразительные сообразительным
соответственно: соответственно
соответствовать: соответствующим
соревноваться: соревноваться
сосуществовать: сосуществовали
сотня: сотен
сохранение: сохранения
сохранять: сохраняли
социальность: социальность
социальный: социальное социальную
сочинить: сочините
спасаться: спасаться
спасибо: спасибо
спекулятивный: спекулятивный
специализироваться: специализироваться
специалист: специалистов специалисты
спешить: спешат
спорный: спорные
способ: способа способами
способность: способностей способности
способный: способна способны
справиться: справилась
спросить: спросил
сразу: сразу
среди: среди
среднее: среднего
среднепалеолитический: среднепалеолитическая среднепалеолитические среднепалеолитическим среднепалеолитических
средний: среднему
средство: средство
срок: срок
ссылка: ссылку
стадия: стадии стадию
становиться: становились становилось становиться
стартовать: стартовала стартовать
старый: старом старые старых
статус: статуса
стать: стал стала стали стало
статья: статьи статью статьях
сторона: стороны
страдать: страдают
страшно: страшно
стрела: стрелами
стремительный: стремительного
стремиться: стремится
студент: студенты
ступень: ступени ступень
судить: судя
суперумный: суперумных
сутки: суток
суша: суше
существо: существа существо
существовать: существуют
сцена: сцена
считать: считаем считать считаю считают
считаться: считается
счёт: счет
также: также
таки: таки
такой: такая такие таким такими таких такого такое таком такому такую
тасманиец: тасманийцы
тасмания: тасмании тасмания
тело: тела
тема: тему
тенденция: тенденции тенденция
теоретический: теоретических
теория: теории
тесно: тесно
тетрапод: тетрапод
техника: техника
технологический: технологические технологических технологического
технология: технологии технологий технологию технология
течение: течение
тип: типа
топкий: топком
торопиться: торопятся
тот: те тех тому
точность: точности точность
точный: точное
традиция: традиции традиций
траектория: траекторию
трактовать: трактовать
трв: трв
требоваться: требовалось
труд: труд
трудно: трудно
тысяча: тысяч тысячи
тысячелетие: тысячелетий
убогий: убогие
убрать: убран
увеличение: увеличение увеличению увеличения
увеличиваться: увеличивается
увеличиться: увеличился
угол: угол
ужасно: ужасно
ужасный: ужасного
ужинать: ужинать
узкий: узкие
узнавать: узнаваемые
улица: улицу
улучшить: улучшенные
ум: ума
уменьшение: уменьшение
умнеть: умнеть
умный: умнее умны умные умным умными
уникальный: уникальной уникальным
упорно: упорно
уровень: уровень уровне уровня
ускорение: ускорением
условие: условия условиях
условно: условно
усложнение: усложнение усложнению
усложняться: усложняется усложнялся
успех: успех
успешный: успешными
устойчивый: устойчиво
устроенный: устроен
устройство: устройство устройством
уточнять: уточняем
участник: участников
ученик: ученик ученику
учитель: учитель
учиться: учатся учиться
учёный: ученые
факт: факт фактов
фактически: фактически
фигуративный: фигуративное
физ: физ
форма: форма формы
хватать: хватало
хитрый: хитрыми хитрых
хищник: хищники
хобот: хобот
хоботный: хоботные хоботных
ход: ходе ходы
ходить: ходить
ходьба: ходьбе
хозяйство: хозяйства хозяйство хозяйству
хороший: лучшие хорошая хорошей
хотеть: хотел хочет
хотеться: хочется
хотя: хотя
царапинка: царапинки
цветовой: цветовое
цель: цель
цена: цену
цепочка: цепочке
цивилизация: цивилизации цивилизацию цивилизация
часть: частями
человек: людей люди людьми человек человека человеком человеку
человекообразный: человекообразных
человеческий: человеческий человеческой
челюсть: челюсти
черви: черви
череда: череде
черепаха: черепах
четвероногий: четвероногих
четвёртый: четвертый
четыре: четырех
численность: численность
читать: читать
членистоногий: членистоногие
чужой: чужие
чёткий: почетче четкого
шанс: шанса шансы
широко: широко
школа: школа
шляться: шлялись
штерн: штерн штерна
штука: штуки
эволюционировать: эволюционировать
эволюционный: эволюционная эволюционное эволюционной эволюционную эволюционный эволюционным эволюционных
эволюция: эволюцией эволюции эволюцию эволюция
экосистема: экосистемы
эксперимент: эксперимент эксперименты
эпоха: эпоху
эра: эру эры
этап: этапе
это: этим
этот: эта этих этому
эффект: эффект
юго: юго
южный: южной
являться: являемся
явно: явно
язык: язык языка языку
языковой: языковые языковых
яркий: яркая
