абсолютно: абсолютно
абсолютный: абсолютным
автор: авторов
адам: адама
активность: активности
алексей: алексей
антенна: антенной
аппарат: аппарат аппарата
аризонский: аризонского
архивный: архивной
аспирантка: аспирантка
астероид: астероиде
астроновость: астроновости
астроном: астроном астрономам астрономов астрономом астрономы
астрономический: астрономические астрономический астрономических
астроёлочка: астроёлочка
атакамский: атакамской
бабочка: бабочка
барсоня: барсони
белый: белого белый
бенна: бенну
близкий: ближайшее ближайших близких
близко: близко
близнец: близнецов
боде: боде
больший: большую
большинство: большинство
большой: большое большой
бортовый: бортового
будущее: будущем
будущий: будущая
бургассер: бургассера
буря: бури
быстрорастущий: быстрорастущий
быстрый: быстрым
величина: величине
венера: венере
вернуться: вернулся
верный: верна
вероятно: вероятно
версия: версии версий
вертолетик: вертолетик
весь: всей
взаимодействие: взаимодействия
взрослость: взрослости
взрыв: взрыв взрывов взрывом
виброакустический: виброакустической
вид: виде
видимый: видимой
видный: видны
включать: включающие
внимание: внимание
возможность: возможности возможность
возобновить: возобновил возобновить
возобновление: возобновление
возраст: возраста возрасте возрастом возрасту
вокруг: вокруг
волна: волн
восторг: восторгом
вояджер: вояджера
впечатляющий: впечатляющей
вращаться: вращаться
время: времен временем времени время
вселенная: вселенная вселенной
вспыхнуть: вспыхнули
вспышка: вспышке вспышкой
всё: всё
второй: втором
вулкан: вулкан
входящий: входящая
выбросить: выбросил выбросить
выйти: вышел
вылететь: вылетела
выработать: выработать
высокий: высокой
вытянутый: вытянутой
выявить: выявила выявить
выяснить: выяснить
газопылевой: газопылевых
галактика: галактик галактика галактике галактики галактику
галька: галька
гершель: гершелем
гиперскоростной: гиперскоростная гиперскоростные
гипотеза: гипотезу
гипотетический: гипотетической
глаз: глазами
говориться: говорится
год: год года году лет
гончий: гончих
группа: группа группу
давно: давно
давность: давности
данные: данным данными данных
дать: данные
два: две двумя двух
движение: движения
двойной: двойной двойные двойных
двуликий: двуликий
действие: действия
действительность: действительности
действовать: действующий
декурси: декурси
делиться: делится
десять: десять
детектор: детектора детекторов
джеймс: джеймс
джет: джетов джеты
диагностика: диагностикой
диапазон: диапазона диапазонах диапазоне
диего: диего
динамика: динамика
диск: диски дисков диском
длина: длинах
добраться: добраться
доказать: доказать
документ: документы
долгожитель: долгожителей
должный: должна
дополнительно: дополнительно
дополнительный: дополнительные
друг: друг друга другом
другой: другие другому
дыра: дыр дыры
евклид: евклид
единица: единиц
заканчиваться: заканчивается
занятый: заняты
записывать: записывает
зарядить: заряженных
захватывать: захватывающих
звезда: звезд звезда звездами звезде звезду звезды
звездообразование: звездообразования
звёздный: звездная звездной звездном звездную звездных
земля: земли землю
змееносец: змееносца
знать: знали
значение: значение
значит: значит
зонд: зонд зонда
зёрнышко: зернышко
играть: играть
идентифицировать: идентифицировать
известно: известно
известный: известная известную известных
излучение: излучения
измерение: измерения
изначально: изначально
изображение: изображение изображении изображения
изучать: изучают изучая
изучение: изучения
изучить: изучить
именно: именно
иметь: имеет
инженер: инженерам инженеры
инструмент: инструментов инструменты
информация: информации информацию
инфракрасный: инфракрасного инфракрасном
ио: ио
искать: искала
использование: использование
использовать: использовали использовать используя
использоваться: используются
испускать: испускала
испытание: испытаниями
исследование: исследования
исследователь: исследователей исследователи
источник: источник источники
исходящий: исходящие исходящих
исчезать: исчезали
итог: итоге
каждый: каждая
казаться: кажется казалось
какой: какого
калифорнийский: калифорнийского
каменный: каменный
карлик: карлик карлика
карликовый: карликовая
катаклизм: катаклизма
катапульта: катапультами
квазар: квазар
кеплер: кеплера
класс: класс
км: км
код: кода
количество: количество
команда: команду
компаньон: компаньона
комплекс: комплекса комплексе
компьютер: компьютерах
конец: конец
конструировать: конструировавших
космический: космический космическим космических космического
космос: космос
который: которая котором которые который которых
красный: красная красного
криста: криста
крохотный: крохотной
кудрить: кудря
кумулятивный: кумулятивного
курс: курса
лаборатория: лаборатории
летний: летнего
лишь: лишь
логика: логику
луч: лучей
любой: любых
магелланов: магелланово
магнитометр: магнитометра
магнитофон: магнитофона
май: мае
маленький: маленькая
маломассивный: маломассивным
марс: марса
марсианский: марсианский
масса: масс массой массы
массивность: массивности
массивный: массивных
машина: машина
межзвёздный: межзвездный
менее: менее
меняться: меняется менялась
месяц: месяцев
микроквазар: микроквазара
миллиметровый: миллиметрового
миллион: миллионов
мир: миром
миссия: миссии
младенческий: младенческой
млечный: млечного млечный
многоволновый: многоволновые
множественный: множественных
множество: множество
моделирование: моделирование
модернизация: модернизация
молекулярный: молекулярных
молодой: молодой молодых моложе
момент: момент
морфология: морфологии
мочь: могут
мпк: мпк
мы: нами
мэри: мэри
наблюдать: наблюдаемой
наблюдаться: наблюдаются
наблюдение: наблюдений
надеяться: надеются
назад: назад
называться: называются
наладить: наладить
намного: намного
направить: направили
направление: направлению
наслать: нашли
научный: научной научную научных
находиться: находилась находится находятся находящихся
находка: находок
национальный: национальной
наш: наша наше нашего нашей нашу
небо: неба
невидимый: невидимое
невозможный: невозможное
невообразимый: невообразимым
негласный: негласное
недавно: недавно
нейтронный: нейтронная
некоторый: некоторые
немногие: немногие
несколько: несколько
нестись: несущаяся
низкий: низкая низкой
новогодний: новогодний
новый: новая новые новый
номер: номера
ноябрь: ноябре ноября
обзор: обзоре
облако: облаках облако облаков
область: области
обнаружение: обнаружения
обнаружить: обнаружена обнаруженные обнаружено обнаружили обнаружить
обозначение: обозначение
обозреть: обозреть
образовывать: образовывать
обращаться: обращается
обсерватория: обсерватории
обслуживание: обслуживание
общий: общей
объединить: объединенные объединены объединив
объект: объект объектов объекты
огромный: огромное огромные огромным
один: одна одной
оказаться: оказалась оказался
оказываться: оказываются
около: около
окружить: окружена
определяться: определяется
опубликовать: опубликованном
осложнить: осложнена
остальной: остальных
остаток: остаток
остаться: оставшихся
отдельность: отдельности
открыть: открыта
отличный: отличными
отменяться: отменяется
относительно: относительно
оценка: оценкам
очень: очень
пара: пары
параллельный: параллельные параллельных
пенсия: пенсии
первый: первой
передавать: передавать
передача: передачу
перенос: переноса
перепрограммирование: перепрограммирование
переходный: переходные
пик: пик
пироударный: пироударными
плазма: плазме
плазменный: плазменных
план: планах
планетный: планетных
планировать: планируют
плюс: плюс
повод: поводу
поглощение: поглощение
подобный: подобных
подобраться: подобраться
подробность: подробности
подростковый: подросткового
подтвердить: подтвержденную
позволить: позволившую позволило позволит
позволять: позволяет позволяющие
поистине: поистине
пока: пока
покинуть: покинуть
полмиллиона: полмиллиона
полноценный: полноценной
полувековой: полувековой
получение: получение
получить: полученное полученном полученные полученных получила получить
полётный: полетных
помощь: помощью
понять: поняли понять
последний: последнего
потерять: потерял
поток: потока
потребоваться: потребовалось
похожий: похожа
починить: починить
поэтому: поэтому
появляться: появлялись
превышать: превышало
предел: пределами
предполагаться: предполагается
представить: представлены
представление: представлении
представлять: представляет
предстоять: предстоит
прежде: прежде
прекрасный: прекрасные
прибор: прибора приборов
прибыть: прибыл
привлечь: привлекло
придать: придало
примерно: примерно
приобрести: приобрести
приходиться: приходилось
причина: причиной
причём: причем
приёмник: приемника
проблема: проблем
провести: провести
программа: программа программе программы
продолжить: продолжить
произойти: произошел
прокомментировать: прокомментировала
пролетать: пролетая
пролить: пролить
пронаблюдать: пронаблюдал
пропасть: пропавшие
проходить: проходят
процесс: процессы
прочь: прочь
прошлое: прошлого
прошлый: прошлом
пузыриться: пузырящаяся
пульсар: пульсара
путешествие: путешествия
путь: пути путь
путём: путем
пытаться: пытаясь
пять: пять
пёс: псов
работа: работе работу работы
работать: работающих
радио: радио
радиоастрономический: радиоастрономической
разбивка: разбивка
разгадывать: разгадывать
различный: различный
размер: размер размерам размером
разница: разницей
разный: разные разных
разрушение: разрушения
рамка: рамках
ранее: ранее
ранний: ранней ранних
расположить: расположена расположенной расположенными
рассеяться: рассеялись
расстояние: расстоянием расстоянии расстояния
реактивный: реактивного
редкий: редкий
режим: режиму
результат: результата результатами результате
рекорд: рекорд
ремонт: ремонт
решение: решение
решётка: решетки
рисовый: рисовое
родить: рожденных
рождение: рождением
рой: рой
роль: роль
рука: руки
рыба: рыбах
ряд: ряд
рядом: рядом
сайт: сайте
самый: самые самых
сан: сан
сближаться: сближается
сверхновый: сверхновая сверхновой сверхновые сверхновыми сверхновых
свет: свет света
световой: световых
свой: своего своей своим своими
свыше: свыше
связанный: связанные
сделать: сделанных
себя: собой
серьёзный: серьезных
сигнал: сигналу
сила: силах
система: систем система системе системой систему системы
ситуация: ситуация
скопление: скоплении скоплений скопления
скоростной: скоростная
скорость: скорости скорость скоростью
скрытый: скрытых
слева: слева
след: следы
следующий: следующим
слишком: слишком
сложиться: сложилось
сложно: сложно
сложность: сложности
сложный: сложная сложнейшие
смещение: смещения
смотреть: см
снимок: снимки снимков
собранный: собранные
совместно: совместно
совместный: совместное
согласно: согласно
сожаление: сожалению
созвездие: созвездию
солнечный: солнечной
солнце: солнца солнце
сообщение: сообщении
соответствовать: соответствует
соревнование: соревнование
сосед: соседей
соседний: соседних соседнюю
состав: состав
составлять: составляет
составной: составном
состоять: состоит
спектр: спектра
спектроскопически: спектроскопически
специалист: специалистам специалистов специалисты
спитцер: спитцер
справа: справа
спутник: спутника спутником
спутниковый: спутниковую
сравнить: сравнила
среднее: среднем
стадия: стадии
старый: старые
стать: стало
столкнуться: столкнулся
столь: столь
строй: строя
струить: струи
стюард: стюарда
субкарлик: субкарлик субкарлики
судить: судя
суметь: сумели
сценарий: сценарии
считаться: считается
счёт: счет
сша: сша
сюрприз: сюрприз
тайна: тайны
также: также
такой: такие такое
текущий: текущий
телеметрия: телеметрии телеметрию
телескоп: телескоп телескопа телескопами телескопов телескопом
тело: тел
температура: температурой
тестирование: тестирование
техноархеолог: техноархеологов
течение: течением
тип: типа
толстяк: толстяк
тот: тех
траектория: траектории
транзиентный: транзиентными
требоваться: требуется
третий: третьего
три: трех
тусоня: тусоне
тысяча: тысячи
увеличить: увеличенное
увидеть: увидеть
удаваться: удается
удалить: удалена
удалёнка: удаленке
удаться: удалось
удержаться: удержаться
удивительно: удивительно
уильям: уильямом
указание: указанием
умереть: умерло
университет: университета
уран: уран
усилить: усилит
ускорение: ускорение
усовершенствовать: усовершенствованные
уточнить: уточненным
участок: участка участке
учёный: ученые ученых
уэбба: уэбб уэбба
форма: формы
формирование: формированием
фото: фото
фотограф: фотограф
фотография: фотографии
функционировать: функционирующих
хаббл: хаббл
хаббнуть: хаббла
химический: химический химических
ход: ходе
храниться: хранилась
художник: художника
целое: целом
центр: центра центрах
чандра: чандры
час: часа часов
частица: частиц
часть: части часть
человек: человек
четыре: четырех
чип: чип
число: числе
чувствительность: чувствительность
чёрный: черные черных
шаг: шагом
шаровой: шарового шаровом
штатный: штатному
экзолуна: экзолуны
электромагнитный: электромагнитного
элемент: элементов
энергия: энергии
этот: эта этих
юпитер: юпитер
яркий: яркий
яркость: яркость
