авария: аварий
август: августа
авиация: авиации
автономный: автономную
администратор: администратора
айзекман: айзекман
айзекмана: айзекмана
александр: александр
ангар: ангаре
ангара: ангара
анонс: анонс
аппарат: аппаратов аппаратом
апрель: апрель
арендовать: арендовала
артемида: артемида артемиды
астронавт: астронавта астронавтов
астронавтика: астронавтики
атмосфера: атмосферы
баржа: баржу
барри: барри
безос: безос
безоса: безоса
беспилотный: беспилотных
благополучно: благополучно
блок: блок блоков
боинг: боинг боинга
будущее: будущем
важный: важнейшие
вариант: вариантов
вернуться: вернулся
вероятность: вероятностью
версия: версией
верхний: верхней верхняя
весенний: весенний
весна: весной
включая: включая
включить: включить
вновь: вновь
возвращать: возвращаемым возвращать
возвращение: возвращение возвращении возвращения
воздействие: воздействие
возможный: возможна
возобновить: возобновила
восточный: восточный
впервые: впервые
вполне: вполне
время: времени время
встретиться: встретиться
второй: вторая второго второй втором
вход: входе
выведение: выведении
вывести: выведено вывела
выдать: выдало
высадка: высадка
высокий: высокой
выход: выхода
генеральный: генерального
главное: главного
го: го
говорить: говорить говорят
год: год года году годы
голосовать: голосовать
государство: государства
готовый: готова
гражданский: гражданской
группировка: группировки
далеко: далеко
два: двух
декабрь: декабре декабрь
десятилетие: десятилетия
джаред: джаред
джареда: джареда
джефф: джефф джеффа
дм: дм
должность: должность
должный: должен должна
дональд: дональд
дополнительный: дополнительные
доставлять: доставлять
достаточный: достаточной
дракон: дракон
другой: других
европа: европа
женщина: женщиной
задать: заданную
заказ: заказу
заказчик: заказчиков
закончиться: закончился
залив: залива
заменить: заменила
заметно: заметно
заметный: заметные заметным
запланировать: запланирована
запуск: запуск запуска запускам запуске запусков запуску
запустить: запущен
заря: заря
затаиться: затаившийся
захват: захвата
защита: защиту
земля: землю
зимбабве: зимбабве
идти: идет идущие
избранный: избранный
изначально: изначально
илона: илон
имитатор: имитатором
инаугурация: инаугурации
индийский: индийском
иностранный: иностранных
инспектор: инспектора
интерес: интересах
интересный: интересный
информация: информация
ионосфера: ионосфера
иран: иран
исключительно: исключительно
использоваться: использоваться
испытатель: испытателя
испытательный: испытательного испытательный испытательных
исследовательский: исследовательских исследовательскую
история: истории
июнь: июне
канаверал: канаверал
кандидатура: кандидатуре
качество: качеством
китай: китай китая
класс: класса
кластерный: кластерного кластерный
клипер: клипер
колонизация: колонизация
командир: командир командиром
коммерческий: коммерческие коммерческого коммерческой
компания: компанией компании компания
комплекс: комплекса
конец: конец конца конце
конкурент: конкурент конкурента
конкуренция: конкуренции
корабль: корабле кораблей корабль корабля кораблях
корпорация: корпорацией корпорации корпорация
космический: космическая космические космическим космических космического
космодром: космодроме
космонавтика: космонавтика космонавтике космонавтики
космос: космос
который: которая которое который которыми
край: крае
красный: красную
критиковаться: критикуется
кстати: кстати
лето: лето
лицензия: лицензию лицензия
лицо: лиц
личный: личным
луна: луне луну луны
лунный: лунной лунных
малый: малых
марс: марс марса
март: марте
маск: маск
маска: маска
международный: международного
межпланетный: межпланетного межпланетной
мексиканский: мексиканского
менее: менее
место: месте место
месяц: месяц
мехазилла: мехазиллой
миллиардер: миллиардера
миссия: миссии миссию миссия
мкс: мкс
многоразовый: многоразовая многоразовой
момент: момент
московский: московскому
мочь: могут
мыс: мысе
мягкий: мягкое мягкой мягкую
наблюдать: наблюдать
нагрузка: нагрузки нагрузкой
назначение: назначения
направление: направления
например: например
наука: наука
научный: научных
неделя: неделю
ненадёжный: ненадежном
неожиданный: неожиданное
несколько: несколько
неудача: неудач
неутомимый: неутомимый
новость: новости
новый: новая нового новой
номер: номера
номинировать: номинировал
носитель: носителей носитель носителя
ноябрь: ноябре ноября
нуль: нулю
нумерация: нумерации
оба: обе
облёт: облет
образовательный: образовательных
обсуждаться: обсуждалось
объясняться: объясняется
ограничиться: ограничились
один: одна одним
одновременно: одновременно
одноразовый: одноразовых
озвучить: озвучены озвучили
океан: океане
октябрь: октябре
опережать: опережает
опубликовать: опубликованном
орбита: орбиту
орбитальный: орбитальной орбитальные
орион: орион
орёл: орёл
осень: осенью
основной: основной основные
основный: основная
остаться: осталась остались
осуществить: осуществила
осуществление: осуществления
отвечать: отвечает
отлётный: отлетную
отметить: отметить
отправить: отправит отправить
отправиться: отправится
отправка: отправка
отработка: отработки
отсутствие: отсутствием
отчёт: отчете
официальный: официальных
пегги: пегги
первый: первая первое первой первому первый первых
переговоры: переговорах
передний: переднем
перенести: перенес перенесен перенесена
персонал: персонала
перспективный: перспективный
пилотировать: пилотируемого пилотируемой пилотируемую пилотируемые пилотируемых
плазма: плазмы
план: планам планы
планета: планету
планировать: планирует
планироваться: планировалась планируется
плотный: плотные
подготовить: подготовленного
поддерживаться: поддерживалась
подробно: подробно
позволить: позволило
поймать: поймана
поколение: поколения
полгода: полгода
полезный: полезной
полететь: полетел полетит
полноценный: полноценные
полный: полным
получить: получена получило получить
польза: пользе
полёт: полет полета полетами полетах полете полетов полеты
помощь: помощью
популяризатор: популяризатор
попутный: попутной
посадка: посадки посадкой посадку
посещение: посещения
последствие: последствия
потерять: потеряны
появиться: появилась
предыдущий: предыдущим
президент: президент президента
приводнение: приводнение приводнении
приводняться: приводнялась
приемлемый: приемлемой
примерно: примерно
приоритет: приоритет
причина: причина
проблема: проблемы
провести: провести
программа: программах программы
продажа: продаже
продолжать: продолжая
продолжаться: продолжалась
продолжение: продолжение
продолжить: продолжим
проект: проект проектов
прямой: прямом
пуск: пуск
пятый: пятом
работа: работа работой работы
равный: равен
раз: раза
разгонный: разгонный разгонных
разделиться: разделились
разный: разных
разрабатывать: разрабатываемой
разработать: разработанного
разрушиться: разрушились
ракета: ракет ракета ракетой ракету ракеты
ракетный: ракетной
ребёнок: дети
революция: революция
регулировать: регулирует
рекордный: рекордное
решить: решило
рисковать: рисковать
роскосмос: роскосмос
российский: российских
россия: россии россия
россонавт: россонавты
руководитель: руководителя
руководство: руководство
рутинный: рутинная
садиться: садилась
сверхтяжёлый: сверхтяжелой сверхтяжелую
свой: свой
связь: связь
сдвиг: сдвиг
сделать: сделал
седьмой: седьмой
семейство: семейства
сенат: сенат
сентябрь: сентябре сентября
середина: середину
серия: серия
серьёзный: серьезные
система: системе системы
сквозной: сквозной
следующий: следующего следующем следующих
слово: словам
слой: слои
случай: случае случаи
смотреть: см
событие: событие событием события
совершить: совершили
советский: советской
согласно: согласно
согласовать: согласовало
создаваться: создавались
сократить: сокращенным
состояться: состоялось состоятся
союз: союз
спасатель: спасателя
спутник: спутников
спутниковый: спутниковой
среди: среди
станция: станции
старлайнер: старлайнер
стартовать: стартовать
стартовый: стартового
стать: став стал стала
степень: степени
сто: ста
столь: столь
страна: стран
страница: страницах
ступень: ступеней ступени ступень ступенью
суборбитальный: суборбитальные суборбитальным суборбитальных
сунита: сунита
суть: сути
сша: сша
также: также
твиттер: твиттера
текущий: текущие
тепловой: тепловую
теплозащита: теплозащиты
тестирование: тестированием
точка: точку
траектория: траекторию
трамп: трамп
транспортный: транспортной транспортный
трв: трв
третий: третьего третьем
трудность: трудностей трудности
тяжёлый: тяжелого тяжелой
увидеть: увидеть
удачный: удачен
уилмор: уилмор
уильямс: уильямс
уитсон: уитсон
универсат: универсат
управление: управление управлением управления
успех: успеха
успешно: успешно
успешный: успешным успешными
устройство: устройством
уходить: уходящего уходящем
участие: участием
факт: факт
фактически: фактически
федеральный: федерального федеральное
фиаско: фиаско
флорида: флориде
фон: фоне
фото: фото
хантяньюань: хантяньюани
ход: ходом
хотя: хотя
хохлов: хохлов
целое: целом
целый: целые
цель: цели
частично: частично
частный: частная частной
человек: людей человек
четыре: четырех
число: числе число
шанс: шанс
шестой: шестого шестой
экипаж: экипаж экипажа экипажами экипажем экипажи
экспансия: экспансия
экспедиция: экспедиции
эпичный: эпично
этот: этих
эфир: эфире
юпитер: юпитеру
январь: январь
яркий: ярким
