автор: авторов
адаптироваться: адаптироваться
активно: активно
актуальный: актуальны
амфибия: амфибию
анальный: анального анальные
антибиотик: антибиотикам
база: базе
бактерия: бактерии бактерий
ббс: ббс
бегать: бегает бегают
безмятежный: безмятежна
белковый: белково
белый: белого белое белом
берег: берега берегу
береговушка: береговушек береговушки
биолог: биолога
биологический: биологических биологического
биология: биологии
биотоп: биотопами
благодаря: благодаря
бо: бо
болото: болота
бороздить: бороздящую
бороться: бороться
бывать: бывает
быстро: быстро
важный: важнейших
вампиризм: вампиризма
век: века
великое: великое
вести: ведет
весь: всему
взрослый: взрослая взрослые
вид: вид вида видов
видеть: видим
видимо: видимо
видимый: видимому
виртуозно: виртуозно
включая: включая
вода: вода воде водой воду воды
водный: водных
водомерка: водомерки
водоросль: водоросли водорослями
водоём: водоемах
воздействие: воздействию
воздух: воздух воздуха
возлюбить: возлюбил
вокруг: вокруг
волосок: волоскам волоски
вольный: вольные
вопрос: вопрос
время: время
всемирный: всемирный
встретить: встретить
встречаться: встречаются
всё: всё
выводить: выводить
выделять: выделяют выделяющие
выдерживать: выдерживает
выжить: выжить
выращивание: выращивания
высокий: высокую
выстилка: выстилки
высыхать: высыхает
выход: выхода
выше: выше
выяснить: выяснить
генетика: генетика
география: география
главный: главных
год: году лет
голова: голова
горячий: горячее горячей
грамм: граммов
граница: границе
давление: давлении
далеко: далеко
далёкий: далеких
дать: дана
два: двумя
дважды: дважды
двукрылый: двукрылые двукрылых
действие: действие
день: день
дерево: дерева
держаться: держится
деятельность: деятельности
дискомфорт: дискомфорта
длинный: длиннее длинной
дождь: дожди
должный: должны
дом: дом
доминировать: доминируют
другой: другое
духов: духовой
дыхальце: дыхалец дыхальца
дыхание: дыхания
дыхательный: дыхательная дыхательного дыхательной
дышать: дышат дышать
екатерина: екатерина
естественный: естественные
железа: железы
железо: железа
живой: живое
животное: животных
жидкость: жидкости
жизнь: жизни жизнь
жить: живут живущую
задний: задние задний задних
заливайк: заливайка
заметка: заметки
заметно: заметно
заплеск: заплеска
зарасти: заросло
затоплять: затопляемая
защитить: защищена
защитный: защитной
защищать: защищает
зеландия: зеландии
земля: земли
значит: значит
зона: зона
зоолог: зоолог
избрать: избрали
известковый: известковая
известный: известном
излучение: излучения
изучение: изучения
илистый: илистые
иллюстрировать: иллюстрируют
именно: именно
иметь: имеют
индекс: индекс
иной: иным
инсектицид: инсектицида
институт: института
интересно: интересно
интересный: интересных
ион: ионов
исландия: исландии
использовать: использовать
использоваться: использовался используются
испытывать: испытывают
история: история
источник: источниках источников
ихтиандра: ихтиандра
йеллоустоун: йеллоустоуна
какой: каких
калифорнийский: калифорнийском
калифорния: калифорнии калифорния
камень: камней камням камнях
канд: канд
капелька: капельки
карбонатный: карбонатных
качество: качестве
кислый: кислой кислых
кишечник: кишечнике
кишка: кишки
клетка: клеток
клуб: клуб
книга: книгах
кожица: кожица
колебание: колебаниями
колебаться: колеблется
комар: комара комары
комфортно: комфортно
конец: конец конце
конкуренция: конкуренция
конкурс: конкурса
короткоусый: короткоусых
который: которая которое которому которые который которых
крайне: крайне
крайний: крайней
красота: красотой
крон: кроне
крылатый: крылатые
крыло: крыл
кстати: кстати
кто: кого
куба: кубе
куколка: куколка куколки
культивирование: культивировании
курьёз: курьезов
кусаться: кусаться
кутикула: кутикулой
кутикулярный: кутикулярной
лабораторный: лабораторных
лапка: лапках
лата: лат
левый: лева
легко: легко
лист: листьях
литораль: литорали литораль
литр: литр
личинка: личинка личинкам личинки личинок
личиночный: личиночный
лишний: лишнюю
лишь: лишь
лишённый: лишенный
ложный: ложные ложных
лужа: луж лужа лужах лужи
льшать: льшая
маленький: маленькие
малый: малую
мангровый: мангровые
мгу: мгу
мембрана: мембрана
менее: менее
мера: мере
место: мест место местом
местообитание: местообитание местообитаний местообитания местообитаниях
микроорганизм: микроорганизмы
микроскоп: микроскопе
микрофотография: микрофотографий
мир: мира мире миру
мировой: мирового
мл: мл
многочисленный: многочисленный
множество: множество
момент: моментов
моно: моно
море: море моря
морской: морским морскими морской морском
морфология: морфологией
мочь: могут
мускулистый: мускулистее
муха: мух муха мухе мухи
мушиный: мушиного мушиную
набитый: набитый
нагреваться: нагревается
надёжно: надежно
название: названия
называть: называют
найти: найти
наполняться: наполняются
например: например
насекомое: насекомого насекомые насекомых
населять: населяющие
настоящий: настоящее настоящему
насчитывать: насчитывает
наука: наук
научий: науч
научно: научно
научный: научному
находиться: находятся
наш: нашей
нежный: нежный
нейтрализовать: нейтрализовать
некоторый: некоторых
немногие: немногие
необычный: необычное необычных
неосвоенный: неосвоенный
несомненно: несомненно
нетипичный: нетипична
нефть: нефти нефть нефтью
нефтяной: нефтяная нефтяной нефтяную нефтяные
низкий: низкий
никакой: никакого
новый: новой новый
нога: ноги
ножка: ножек ножки
обеспечивать: обеспечивающая
обитатель: обитателей обитатели обитателям
обитать: обитает обитают
обмен: обмен
обнаружить: обнаружено
оболочка: оболочка
образоваться: образуется
общий: общий
один: одним одно
одиночный: одиночном
однако: однако
озеро: озера озере озеро
означать: означает
озёры: озерах
океан: океана
около: около
окружающий: окружающая окружающей
окукливание: окукливании
оно: оно
опасно: опасно
описать: описана описанных описано
организм: организм организма организмов
органика: органике
освоение: освоению
освоительница: освоительницы
освоить: освоивших освоили
осмотический: осмотическом
оставаться: остается
осушать: осушаемая
отверстие: отверстия
открытый: открытом открытым
отлить: отлив
отмель: отмели
отряд: отряд
отступать: отступает
отучить: отучить
очень: очень
папилла: папиллы
пара: парами
паразитоида: паразитоиды
паритет: паритет
первый: первой
передвигаться: передвигаются
передний: передние передних
переносить: переносят
перепад: перепадам
перечисленный: перечисленные
период: период
перитрофический: перитрофическая
песчаный: песчаные
писать: писал
питаться: питаться питаются
пить: пьет
пища: пищи
пищеварительный: пищеварительного пищеварительную пищеварительных
планета: планете планету
пластичность: пластичность
пластичный: пластичной
пластрон: пластрон пластроне
плотный: плотной
площадь: площадь
пляж: пляжи
плёнка: пленку
побережье: побережье
поверхность: поверхности поверхность поверхностью
погружаться: погружаются
погружение: погружение погружении
подвергаться: подвергаются
поделить: поделили
подлодка: подлодку
подробный: подробнее
подталкивать: подталкивает
подушечка: подушечки
пожалуй: пожалуй
пойти: пойдет
показать: показали
половина: половине
положить: положено
помогать: помогает помогают помогающий
помощь: помощью
попадание: попаданию
попадать: попадает
популярный: популярных
поражающий: поражающих
посредством: посредством
постоянный: постоянным
почему: почему
правило: правило
практически: практически
превращаться: превращается
предел: пределах
предок: предки
представитель: представителей представители представителях
предстоять: предстоит
прежний: прежнему
препятствовать: препятствует
пресный: пресную пресных
прибрежный: прибрежных
привести: привели
прилив: прилива
пример: примере примеров примером примеру
приносить: приносят
природа: природе
приспособить: приспособлены
приспособиться: приспособились
приток: приток
приходиться: приходится
причина: причине
причудливость: причудливостью
приятный: приятная
проваливаться: проваливаться
проводить: проводит проводящих
прозвучать: прозвучит
промилле: промилле
проницаемый: проницаемая
просачивание: просачивания
прослойка: прослойка
процентный: процентный
пруд: прудах
пугать: пугают
пузырёк: пузырьке
пусто: пусто
пусть: пусть
работать: работает
равный: равной
радуга: радуга
развиваться: развиваться развиваются
развитие: развитию развития
разлагаться: разлагающейся
различаться: различаются
различный: различны
разнообразие: разнообразие
разный: разных
ракообразный: ракообразные ракообразных
ран: ран
ранее: ранее
располагаться: располагаются
расположить: расположены
распространить: распространены
рассказать: расскажем
раствор: раствор
растение: растений
растягиваться: растягивается
рацион: рацион
рачок: рачки
регулировать: регулировать
результат: результат
ресурс: ресурс
речь: речь
рис: рис
род: рода
родный: родной
родня: родней
роды: родов
ручеёк: ручейки
рытьё: рытья
самый: самые
свет: свет
свой: своей своими своих свой
связанный: связанным
связать: связали связана
святой: свято
сделать: сделать
сегодняшний: сегодняшний
секрет: секрет
секреторный: секреторной
семейство: семейства семействе
сжиматься: сжимается
сивуновый: сивунова
сидеть: сидят
синхронный: синхронного
система: система систему
ситуация: ситуация
сказать: сказанные сказать
сканировать: сканирующем
скафандр: скафандр
сквозной: сквозного
скипидар: скипидара
скорее: скорее
следовать: следует
слово: слова
случай: случае
смешиваться: смешивающиеся
смотреть: см
снятой: снятая
содержаться: содержащимися
создание: созданий
солевой: солевой
солончак: солончаки
соль: соли соль
солёность: солености соленость соленостью
солёный: соленой соленую соленых
сообщество: сообщества сообщество
соприкасаться: соприкасается
соскабливать: соскабливает соскабливают
составлять: составляет
состоять: состоит
сотр: сотр
спектр: спектре
специальный: специальная специальный
способный: способны
справа: справа
справляться: справляются справляющегося
среда: средой среды
среди: среди
среднее: среднем
средний: средней средняя
стабильный: стабильную
становиться: становится
стать: стала
статья: статье статьи
степень: степени
сто: ста
стоить: стоит
странно: странно
стресс: стрессом
студентка: студентка
стык: стыке
субстрат: субстрата субстрате
сульфатный: сульфатных
супралитораль: супралитораль
суровый: суровое суровые суровых
сухой: сухой
сухопутный: сухопутных
суша: суше
сушить: суши
существование: существование
сформировать: сформированная
счёт: счет
сша: сша
сырой: сырой
также: также
такой: таким таких
творец: творец
тело: тела
температура: температуру
тенденция: тенденция
терять: теряет
типичный: типичную
токсический: токсическое
токсичность: токсичности
толстой: толстой
толща: толще
тонуть: тонет
торп: торп торпа
тот: ту
трава: траве
тракт: тракта
трахейный: трахейная
трахея: трахеи трахей
треть: треть
тринидад: тринидаде
трубка: трубка трубке трубкой
тёплый: теплых
углеводород: углеводородами углеводороды
удивительный: удивительное удивительные удивительных
уильям: уильям уильяма
укоротиться: укоротилась
ультрафиолетовый: ультрафиолетового
универсальный: универсальной
уникальный: уникальное
упавший: упавших
условие: условий условия условиях
успех: успеха
успешно: успешно
успешный: успешный
устойчивый: устойчивых
уступать: уступающее
фактор: факторов
факультет: факультета
фермент: ферментов
форма: формах
фото: фото
хитиновый: хитиновая
хищник: хищниками хищники
хлоридный: хлоридных
холодный: холодной холодных
хотя: хотя
хрестоматийный: хрестоматийным
целое: целого
частность: частности
часть: часть
чей: чьи
человек: человек
челюсть: челюстями
читатель: читателей
чудо: чудеса
чёрный: черная
шип: шип
широкий: шире широких широчайшая широчайшем широчайшую
шкаф: шкаф
щелочной: щелочная щелочной щелочные
щёлочность: щелочностью
эволюционный: эволюционного эволюционные
экологический: экологических экологическую
экология: экологии
экон: экон
эксперимент: эксперименты
экстремальный: экстремальные
экстремофил: экстремофилы
электронный: электронном
энтомологический: энтомологический
энтомология: энтомологии энтомология
эпителий: эпителий
это: этим
этот: этих
эфидрид: эфидрид эфидриды
являться: является
яковлев: яковлева яковлевой
яркострекотать: яркострекочущих
