август: август
аккреции: аккреции
аккреционный: аккреционный
активность: активности активность активностью
активный: активное активным
акц: акц
алексей: алексей
анализировать: анализируя
артемида: артемида
архив: архива
астероид: астероиде
астронавт: астронавтов астронавты
астроновость: астроновости
астроном: астрономам астрономами астрономов астрономы
астрофизик: астрофизики
атмосфера: атмосферы
атмосферный: атмосферных
аэрокосмический: аэрокосмический
базовый: базовая
безуспешный: безуспешными
белый: белый
бенна: бенну
берн: берне
беседовать: беседует
бизнес: бизнеса
близкий: ближайших близки
больший: большая большими
бса: бса
будущий: будущие
буря: бури
бывать: бывает
быстрый: быстрых
важный: важнейшего важным
вблизи: вблизи
вдоль: вдоль
ведомый: ведомой
вернуть: вернуть
вертикаль: вертикали
вертикальный: вертикальной
верхний: верхней
весьма: весьма
вещество: вещество
взаимодействие: взаимодействие взаимодействия
вид: виде
видеть: видеть видят
видимый: видимом видимый
видно: видно
видный: виден видны
включая: включая
внегалактический: внегалактическое
внешний: внешней
внимательно: внимательно
внутренний: внутренняя
вода: вода водой
водород: водорода
возбуждать: возбуждаемого
возле: возле
возможность: возможность
возможный: возможны возможных
возникать: возникают
возникнуть: возникла
вокруг: вокруг
волна: волн волны
восполнить: восполнить
воссоздать: воссоздаст
восстановить: восстановленный
вояджер: вояджера
вращаться: вращающихся
время: временем время
вселенная: вселенной
всплеск: всплески всплесков
вспышка: вспышек вспышки
второй: второй
выборка: выборки
выброс: выброс выбросов выбросы
выглядеть: выглядит
вызвать: вызвали
выйти: вышла
высадка: высадке
высокий: высокий высокой
выше: выше
выяснить: выяснено
газопылевой: газопылевыми
галактика: галактик галактика
гамма: гамма
геологический: геологическим
геомагнитный: геомагнитные
гигант: гигант
гипотеза: гипотезы
го: го
год: года году годы лет
гораздо: гораздо
горизонт: горизонты
горизонтальный: горизонтальная
готовиться: готовится
гравитационный: гравитационного
груз: грузов
группа: группа группой
далёкий: далеких
данные: данных
дать: данные
два: двух
девять: девяти девять
декабрь: декабрь
демонстрация: демонстрация
демонстрировать: демонстрирует
день: день дня
десяток: десятка
десять: десяти
детализация: детализацией
деталь: деталях
джеймс: джеймс
джет: джет джетами джетов джеты
диапазон: диапазоне
динамика: динамики
динамический: динамический
диск: диск дисками диски дисков
дисперсия: дисперсии
длина: длин длиной
длительность: длительностью
добавлять: добавляя
довольно: довольно
дозаправка: дозаправка
долететь: долететь
должный: должна
дополнительный: дополнительных
доставить: доставить
доставлять: доставлять
достаточно: достаточно
достигнуть: достигнут достичь
достижение: достижении
достоверный: достоверного
дракон: дракон
другой: другими других
дыра: дыр дыра
евклид: евклид
естественный: естественного
жизнеобеспечение: жизнеобеспечения
журналист: журналистами
загадка: загадкой
заключаться: заключается
закончиться: закончились
заниматься: занимающееся
запланировать: запланирована
запуск: запусков
зарегистрировать: зарегистрированных
зарождаться: зарождаются
заря: зарю
затаиться: затаившийся
затем: затем
затенить: затененных
зафиксировать: зафиксировали зафиксированы
звезда: звезд звезда звездами звезды
звёздный: звездные
земля: земли
зона: зон
зонд: зонда
идти: идут
известный: известных
излучать: излучает
излучение: излучение
изначально: изначально
изображение: изображение изображении изображений изображения
изучение: изучения
именно: именно
иметь: имеет иметь имеют
импульс: импульс импульса импульсов импульсу
интенсивный: интенсивное интенсивными
информация: информация
инфракрасный: инфракрасного инфракрасную
ио: ио
искать: ищут
использоваться: используются
испускать: испускают
испытание: испытаний
исследование: исследование исследовании исследований
история: истории
источник: источник источника источником
итог: итоге
кадр: кадров
каждый: каждом каждый
камера: камера
канал: каналы
кандидат: кандидатов
карлик: карликами карлики карликов
карта: карта
китайский: китайского
км: км
количество: количества количество количеству
коллаж: коллаж
команда: команда
компактный: компактного
компания: компанией
компаньон: компаньона
компонент: компонент компонента
конец: конец концу
конечный: конечном
концентрация: концентрации
копейкин: копейкиным
корабль: корабля
коричневый: коричневые коричневыми коричневых
корональный: корональной корональных
коротковолновый: коротковолновой
космический: космический космическим космическими космических космического космической
космос: космос
который: которая которой котором которые который которых
край: край
красный: красная
криогенный: криогенный
кудрить: кудря
ламантин: ламантина
ландшафт: ландшафты
левый: левая
ледяной: ледяные
летний: летних
линия: линий линия
лишь: лишь
локализовать: локализован
луна: луна луне луну луны
лунный: лунного лунной лунных
луноход: луноход
луч: лучах лучей лучи
магнитар: магнитаров магнитаром
магнитный: магнитного магнитными магнитных
мазер: мазера
мазерной: мазерное
мазка: мазки
максимум: максимум максимума
маленький: маленькими малы
малый: наименьший наименьшую
маск: маск
масса: масс массе массу массы
массивный: массивной массивные
мгц: мгц
межгалактический: межгалактическую
международный: международная международной
межзвёздный: межзвездную
мексика: мексике
менее: менее
местность: местности
место: мест места местах место
метровый: метровом
микроквазар: микроквазар микроквазара
минимальный: минимальной
минимум: минимума
мир: мире миром
миссия: миссии миссия
млечный: млечного
мнение: мнению
многолучевой: многолучевой
модель: моделью
модуль: модуль
мозаика: мозаику
молодой: молодых
момент: момент
мочь: могут
мощный: мощную мощный мощных
мс: мс
наблюдать: наблюдаемые
наблюдаться: наблюдаются
наблюдение: наблюдений наблюдения
назад: назад
найти: найденный найти
наличие: наличием
направить: направлен
направление: направлениях
напрямую: напрямую
нарушение: нарушения
наслать: нашли
настоящий: настоящее
наступить: наступил
научный: научное
находиться: находится находиться
находка: находка
национальный: национальное
начать: начнет
наш: нашей
небо: небе
небольшой: небольшой
недавно: недавно
неделя: недели
неизвестный: неизвестной
некоторый: некоторые
необычайный: необычайной
необычный: необычный необычных
несколько: нескольких несколько
неутомимый: неутомимый
неясно: неясно
ниже: ниже
нижний: нижней
низкий: низкой
никакой: никакой
новорождённый: новорожденные новорожденных
новость: новостей
новый: новая новой новом новые новых
номер: номера
нужно: нужно
оба: обеих
обеспечить: обеспечить
обещать: обещает
обзор: обзор
обитаемый: обитаемый
область: областей области область
обнаружение: обнаружения
обнаружить: обнаруженного обнаруженных обнаружено обнаружила обнаружили
обновить: обновленный
обозначение: обозначение
обработка: обработка
образоваться: образуются
обратно: обратно
обсерватория: обсерваторией обсерватории обсерватория
обсуждать: обсуждаемой
обусловить: обусловлены
объект: объект объекта объектов объекты
объявить: объявили
объясняться: объясняются
обычный: обычных
один: одним одного одной
одинаковый: одинакова
однако: однако
ожидать: ожидать
ожидаться: ожидался
оказаться: оказалась оказался оказаться
океанический: океанических
около: около
околоземный: околоземной
околосветовой: околосветовыми
окружать: окружают
окружить: окружены
октябрь: октября
оливье: оливье
опасность: опасностях
определить: определить
опубликовать: опубликован опубликовано
орбита: орбите орбиты
орион: ориона
освещать: освещающее
особенность: особенность
оставаться: остается
остаток: остатках остатки остатков
остаться: остались
осуществляться: осуществляться
ось: оси ось
отдельный: отдельные
отделённый: отделенный
отечественный: отечественном
открывать: открывает
открытый: открытая
отличаться: отличается
отложение: отложения
отметить: отметило
отмечать: отмечающие
отображаться: отображается
отправиться: отправиться
отслеживание: отслеживания
оценка: оценкам
очень: очень
падать: падает
панель: панелей
параллельный: параллельные
пенсильвания: пенсильвания
первый: первая первое первой первым
передача: передачи
переход: переходу
период: период периода периодом
перипетия: перипетии
песочный: песочные
пик: пик
пк: пк
планета: планетами планеты
планироваться: планируется
плотность: плотность
поведение: поведение
поверхность: поверхность
повторный: повторные
поглощать: поглощает
погода: погоды
подобный: подобные подобных
подробность: подробности
подтвердить: подтвердили
подходить: подходят
позволить: позволил
позволять: позволяет
поиск: поиск поиска поиске
показатель: показателем показатель
показать: показан показана показано показаны
поле: полей поля полями
полмиллиона: полмиллиона
половина: половине
получить: полученные полученный полученных получила
полюс: полюса полюсе полюсов
полярный: полярные полярных
полёт: полетом
помочь: помогут поможет
помощь: помощью
понимание: понимании
понять: понять
попытаться: попытаться
попытка: попыток
пора: пор
посадка: посадки
поскольку: поскольку
последний: последние
последствие: последствия
постепенно: постепенно
постоянно: постоянно
поступать: поступают
потенциально: потенциально
потенциальный: потенциальных
поток: потока
потребоваться: потребуется
поэтому: поэтому
пояснить: пояснил
правый: правая
прао: прао
предел: пределами пределах
предназначить: предназначенной
предоставить: предоставила
предполагать: предполагают
предсказать: предсказать
представлять: представляет представляют
предупреждать: предупреждать
предыдущий: предыдущие
препринт: препринтов
прерывание: прерывания
прецессия: прецессии
приблизительный: приблизительный
прибыть: прибыл
приводить: приводит
пример: примеров
примерно: примерно
природа: природа
присвоить: присвоено
причина: причина
пробел: пробелы
проблема: проблем
провести: проведенном провести
проводить: проводимых
прогнозирование: прогнозированию прогнозирования
прогнозировать: прогнозируют
продажа: продажи
продлиться: продлится
продолжать: продолжают
проект: проект проекта
произойти: произойдет
происходить: происходил происходит
происхождение: происхождение
пройти: прошел
пролетать: пролетая
простой: простое
противоположный: противоположных
протопланетный: протопланетные протопланетных
прохладный: прохладные
процесс: процессе
публикация: публикации
пульсар: пульсаров
пульсировать: пульсирует
пусковой: пусковой
путь: пути
пущинский: пущинская пущинский пущинской
пятно: пятен пятна пятнами пятнах
пять: пять
работа: работе
работать: работающая
радиоастроном: радиоастрономов
радиоастрономический: радиоастрономическая
радиоастрономия: радиоастрономией
радиовсплеск: радиовсплеск радиовсплеска радиовсплески радиовсплесков
радиовспышка: радиовспышка
радиоимпульс: радиоимпульс
радиотелескоп: радиотелескопах
радиотранзиент: радиотранзиентов
разглядеть: разглядеть
разлетаться: разлетаются
различный: различные
разнообразие: разнообразием
разный: разной разных
разрабатываться: разрабатывается
разработка: разработка разработки
ракета: ракеты
ракетный: ракетного
ранее: ранее
ранний: ранней
расположить: расположена
рассматривать: рассматривает рассматривать
рассматриваться: рассматриваются
расстояние: расстоянии расстояния
расти: растущих
регион: регионах регионе регионов
редкость: редкость
резкий: резкий
результат: результаты
рекорд: рекорд
ремонт: ремонт
ресурс: ресурсов
рисунок: рисунка
розоватый: розовато
российский: российские российских
россия: россии
руководитель: руководитель
руководство: руководством
рыба: рыбах
самый: самую самые самых
сверхмассивный: сверхмассивных
сверхмощный: сверхмощной
сверхновый: сверхновой сверхновые сверхновых
свет: свет света
световой: световых
своевременно: своевременно
свой: своего своим
свойство: свойства
связать: связаны
связь: связи
себя: собой
сегодняшний: сегодняшний
сей: сих
секундный: секундных
сервер: сервере
сергей: сергеем сергей сергея
серия: серией
серьёзный: серьезные
сигнал: сигнал сигнала
силовой: силовых
синий: сине
синтез: синтез синтеза
синхротронный: синхротронного синхротронное
система: систем системе системы
сияние: сияний сияния
скоростной: скоростная
скорость: скорости скоростями
слева: слева
следить: следить следят
следующий: следующего следующим
слишком: слишком
сложный: сложными
служить: служит
случайный: случайная
смена: сменой
смотреть: см
смочь: смогут сможет
снижаться: снижается снижаться
снимка: снимок
снимок: снимках снимке
снятой: снятая
собственный: собственные
событие: события
совпадать: совпадает
совпадение: совпадения
содержать: содержит
созвездие: созвездии
солнечный: солнечная солнечного солнечной солнечную солнечные солнечный солнечными солнечных
солнце: солнца солнце солнцем
сообщение: сообщения
составить: составленный
состояние: состояния
состоять: состоит
спад: спада
спектр: спектр
спектрометр: спектрометра
спектроскопия: спектроскопию
список: список
спокойный: спокойного
способный: способные
справа: справа
спрогнозировать: спрогнозировать
спутник: спутника спутники спутников
сравнение: сравнении
среда: среду
среди: среди
срок: срок
срыв: срыва
срываться: срывается
стартовать: стартовал
старый: старейшее
стать: стал станет стать
столь: столь
сторона: сторону
струна: струн
стыковочный: стыковочной
суммирование: суммирование
суперюпитер: суперюпитер
сформировать: сформировавшая
сходство: сходство
считаться: считается
сша: сша
сюрприз: сюрприз сюрпризы
также: также
такой: такая таких такого такое
текущий: текущем текущий
телеконференция: телеконференции
телескоп: телескоп телескопа телескопов телескопом
тело: телами
теория: теорию
тераэлектронвольт: тераэлектронвольт
термоядерный: термоядерного
течение: течение
тип: типов
толстяк: толстяк
топливо: топлива
тот: теми
точно: точно
транзиент: транзиентов
трёхлетний: трехлетнем
туманность: туманностей туманности туманность
тюльбашев: тюльбашев тюльбашева
увеличение: увеличения
угроза: угрозой
удалёнка: удаленке
удивительный: удивительного
указывать: указывает
улавливать: улавливающих
ультрафиолетовый: ультрафиолетовое
университет: университета
уникальный: уникальные уникальным
управление: управление
успешно: успешно
учреждение: учреждение
учёный: ученые ученых
учёт: учетом
уэбб: уэббом
уэбба: уэбб уэбба
ферми: ферми
фиан: фиан
физический: физическая
финансовый: финансовых
фиолетовый: фиолетовый
фон: фоне
фоновый: фоновое
формироваться: формируются
фото: фото
фотографировать: фотографировать
хаббл: хаббл
хабблом: хабблом
характеризоваться: характеризуется
хвост: хвост
ход: ход хода ходе
холодный: холодны холодный
цель: цель
центр: центра центрах
центральный: центральной
цикл: цикл цикла цикле циклов циклы
часто: часто
частота: частоте
частотный: частотные
часть: части часть
часы: часы
человечество: человечеству
чувствительный: чувствительных
чёрный: черная черных
широкоугольный: широкоугольная
штат: штата
экзотический: экзотический
экипаж: экипажем
экспедиция: экспедиция
экспоненциальный: экспоненциальный
энергия: энергией
этап: этапов этапом
этот: этих этому
южный: южного южном
юпитер: юпитера
явление: явления
являться: является являются
яркий: яркая яркие
