аббревиатура: аббревиатурами
абсолютно: абсолютно
автоматически: автоматически
адам: адам
акустический: акустические
амплитуда: амплитуда
антропный: антропный
аризона: аризоне
атака: атак
барионный: барионные
безграмотный: безграмотных
белок: белков
бесплодный: бесплодных
бесполезный: бесполезны
благодаря: благодаря
бозон: бозоны
больший: большей
большой: большого большой
борис: борис
быстрый: быстрей
быть: будут будь
важно: важно
важный: важен важная важную важные важный важным
вакуум: вакуум вакуума вакууме
вакуумный: вакуумное вакуумным
вариант: вариант варианте варианты
великий: великого
величина: величину
верить: верил
вероятность: вероятность
весить: весящего
вечный: вечного вечное
взрыв: взрыв взрыва
видно: видно
видный: виден видны
висячий: висячие
включать: включающим
вкратце: вкратце
вместе: вместе
внимание: внимание внимания
возможно: возможно
возможный: возможна возможной возможны
возмущение: возмущений
возникнуть: возникнет возникшая
возраст: возраста возрастов
вокруг: вокруг
волна: волны
восемь: восьми
вполне: вполне
время: времен временем времени время
всевозможный: всевозможных
вселенная: вселенная вселенной вселенную вселенных
всяческий: всяческим
всё: всё
второй: второй вторых
вывести: выведено
выглядеть: выглядеть
выгорать: выгорает
выгореть: выгорит
выдвинуть: выдвинутая
выделить: выделенный
выделяться: выделяется
выжить: выжили
выражаться: выражается
выручалочка: выручалочку
выявление: выявления
галактика: галактик галактиках галактику
галактический: галактических
гармоника: гармоникам
главное: главного
главный: главный
говорить: говоря
год: год лет
гора: горе
гораздо: гораздо
горб: горб горбу
горизонтальный: горизонтальная
гравитационный: гравитационные
грамм: грамм
давать: дают
даваться: дается
давление: давление
данные: данным данных
данный: данном данный
дать: данной данные
два: двух
движение: движение
двухточечный: двухточечной
де: де
действие: действие
действительно: действительно
делать: делает
дерзновенный: дерзновенных
десять: десять
джеймс: джеймс
диаметр: диаметре
динамика: динамика динамики динамикой
дирак: дирака
длина: длины
добиться: добиться
довольно: довольно
должный: должна
дополнительный: дополнительная
допустить: допустим
другой: другие другое
думать: думать
дутый: дутых
единица: единицах
естественный: естественной
ждать: ждал
жизнь: жизнь
жить: жить
зависеть: зависела зависит
зависимость: зависимости
завязать: завязаны
задача: задачу
закон: законам
заметно: заметно
замылиться: замылился
заполнить: заполнен
затишье: затишье
зацепка: зацепки
зачастую: зачастую
заявлять: заявлять
звучать: звучит
зеркало: зеркалом
знак: знак
знать: знаем
значение: значения
значит: значит
зрение: зрения
идея: идей идея
идти: идет
иерархия: иерархия
изложение: изложение
изложить: изложены
излучение: излучение излучении излучению излучения
изменение: изменении
изменить: изменить
измерение: измерений измерения
измерить: измеренные измерила
изображение: изображение
изобразить: изображена
изоляция: изоляции
именно: именно
иметь: имеет
имманентный: имманентное
инвариантность: инвариантность
инвариантный: инвариантны
инструмент: инструмент
интересный: интереснее интересней интересной интересным
интерпретатор: интерпретаторов
инфляция: инфляции инфляция
использование: использовании
исследование: исследованию
исчезать: исчезает
каждый: каждого
казаться: кажется
какой: какие
карта: карта карты
картинка: картинка
каталог: каталоги
квантовый: квантовой
квинтэссенция: квинтэссенция
китта: китт
классический: классическом
км: км
колебание: колебаниями
колебаться: колебаться
коллаборация: коллаборации коллаборация
команда: команда
комментарий: комментарий
конец: конце концов концы
конструкция: конструкция
контраст: контраст
корректировать: корректирующей
корреляция: корреляции
космический: космического
космологический: космологическая космологические космологический
космология: космологии космология
который: которая которой которому которую которые которым
кпк: кпк
край: крае
красный: красное
кривая: кривой
крупномасштабный: крупномасштабная крупномасштабной крупномасштабную
левый: левое
ликбез: ликбез
линейка: линейка линейки
линейный: линейному
линия: линия
лишний: лишний
лоренц: лоренц
любой: любой любом
люфт: люфт
максимальный: максимального
маленький: меньше
мало: мало
малый: малой
масса: масс массы
массовый: массовую
масштаб: масштаб масштаба масштабе
масштабный: масштабная масштабный
материя: материя
медленно: медленно
медленный: медленного
меняться: меняются
мера: мере
место: места
методика: методике методики
метровый: метровое
микроволновый: микроволновое
миллион: миллион
минимум: минимуме
минус: минус
мир: мир миром
множество: множества
модель: модели модель
модификация: модификации модификаций
модифицированный: модифицированной
момент: момент
монтаж: монтаж
море: море
мочь: могут
мпк: мпк
мультиполь: мультиполям
наблюдать: наблюдаемую
набор: набора
название: названии
назвать: назвал
наземный: наземном
называть: называемые называемым
называться: называется
найти: найдены найти
наметиться: наметился
написать: написаны
напрягаться: напрягаться
напряжённость: напряженность
народ: народ
нарушение: нарушение
наспех: наспех
настоящий: настоящего настоящий
насчёт: насчет
натяжение: натяжение натяжения
натянуто: натянуто
находиться: находящееся
начинать: начинает
наш: нашей нашим нашу
небо: неба небеса
невозможно: невозможно
неинтересный: неинтересное
нейтрино: нейтрино
некрасиво: некрасиво
некрасивый: некрасивым
немного: немного
немой: нем
неоднородность: неоднородностей неоднородности
непонятно: непонятно
непосредственно: непосредственно
нептун: нептуна
нерушимый: нерушимой
нести: несет
несущий: несущих
нигде: нигде
низкий: низкими низкой низком
никакой: никаких
новость: новость
новый: новая новом новому новый
нужный: нужны
нулевой: нулевой нулевую нулевыми
нуль: нулю нуля
ньютоновский: ньютоновской
обзор: обзор
обнаружить: обнаружить
образ: образом
обратить: обратил
обсерватория: обсерватории обсерватория
общий: общая общей
объект: объектом
объяснение: объяснения
объяснить: объясню
объяснять: объяснять
объём: объеме
огромный: огромная огромного
один: одна одному одну
одновременно: одновременно
ожидание: ожидание
ожидать: ожидаемая
означать: означает
оказаться: оказалась
оказываться: оказывается
около: около
окончание: окончание
окончательный: окончательной
окрепнуть: окреп
оно: оно
опираться: опирается опирающимися
описание: описание описания
описывать: описывает
описываться: описывался
определяться: определяется
опровержение: опровержение
оптика: оптики
оптоволокно: оптоволокно
ослабевание: ослабевания
ослабевать: ослабевает
ослабление: ослабление
основа: основ
основной: основной
особенно: особенно
оставаться: остается
осциллировать: осциллирующей
осцилляция: осцилляции осцилляциям
открытие: открытии
отличаться: отличается
относительность: относительности
отработать: отработаны
отражать: отражает отражающая
отражение: отражение
отражённый: отраженных
отрицательно: отрицательно
отрицательный: отрицательное отрицательную
отсчёт: отсчета
отчётливый: отчетливый
очень: очень
очередь: очередь
ошибка: ошибками
палочка: палочку
параметризовать: параметризовать
первый: первой первых
передний: переднем
перекрёстный: перекрестным
перелом: перелома
перенасытить: перенасыщены
переоборудовать: переоборудован
перспектива: перспективы
пертурбация: пертурбаций
пик: пик пика пики
план: планах
планк: планка
планковский: планковская планковской
плечо: плечо
плоскость: плоскости плоскость
плотность: плотности плотность плотностью
плюнуть: плюнуть
плюс: плюс
подкопаться: подкопаешься
подобный: подобные
подозрение: подозрений
подтверждение: подтверждения
подходить: подходит
подчиняться: подчиняется
позволять: позволяющая
позитивный: позитивный позитивным
позиционироваться: позиционируются
пока: пока
показывать: показывают
поле: поле полей поля
полевой: полевого
полностью: полностью
положение: положение
положительный: положительная положительную
получаться: получается
получение: получение
получить: получен полученным получено
получиться: получилась получилось
помощь: помощью
попытка: попыток
пора: пор
порядок: порядка порядков
посвятить: посвящен посвящено
последний: последнее
послужить: послужила
постоянный: постоянная постоянной постоянным
потенциал: потенциала
потенциально: потенциально
поток: потоке
почему: почему
поэтому: поэтому
появиться: появились появиться
правда: правда
превратиться: превратится
превышать: превышает
предсказание: предсказания
представление: представлении представлениях
предшественник: предшественник
предыдущий: предыдущего предыдущем
прежде: прежде
прекрасно: прекрасно
препринт: препринтах препринте
привлекать: привлекает
привлечь: привлечешь
признаться: признаюсь
приклеиться: приклеился
примерно: примерно
принцип: принцип принципе
причём: причем
провал: провалы
проверка: проверкам
проделать: проделана
проект: проект
произойти: произойдет
происходить: происходивших происходило
пропорциональный: пропорциональный
просветление: просветление
пространство: пространстве пространство
путь: путь
пятно: пятен
пятый: пятая
работа: работа
равно: равно
равномерный: равномерного
равняться: равняться
разлить: разлитого
разложение: разложение разложении
размер: размера размере размеру
размножение: размножение
разница: разницей
разный: разного разных
ранний: ранней ранний
раскрытие: раскрытие
располагаться: располагается
распределение: распределении распределения
рассасываться: рассасывается
рассосаться: рассосались
расстояние: расстояние расстоянии
растянутый: растянутая
растянуться: растянувшаяся растянулись
расширение: расширение расширением расширения
расширить: расширенным
расшириться: расширилась
расшифровать: расшифрованы
расшифровываться: расшифровывается
реально: реально
режим: режим
результат: результат результатами результатов результатом результаты
рекомбинация: рекомбинации
релиз: релиз релиза релизе релизу
реликтовый: реликтового реликтовое реликтовом реликтовому реликтовые
речь: речь
рис: рис
рисс: рисс
рисунок: рисунках
родить: рожденных
рост: роста
рутина: рутина
самый: самая самое
сахаров: сахарова сахаровым
сахаровский: сахаровским
сверхновый: сверхновым
свет: света
светоприёмник: светоприемника светоприемники светоприемников
свой: свое своей своем своему своим
свойство: свойство
сгущаться: сгущается
сенсационно: сенсационно
сенсационный: сенсационную
сенсация: сенсации сенсаций
серьёзно: серьезно
сила: сил
сильный: сильные
система: система системы
систематик: систематики
ситтер: ситтера
скалярный: скалярное
скатывание: скатывания
скатываться: скатывается
скорее: скорее
скромный: скромном
слегка: слегка
след: следы
слоановский: слоановский
сложный: сложная
случай: случае
случайно: случайно
смещение: смещение
смонтировать: смонтирован
смотреть: см
смочь: смогли
снимать: снимать
снова: снова
совпадать: совпадает
современный: современного современной современных
согласно: согласно
содержимое: содержимого содержимое
создать: создана
соответствие: соответствии
соответствовать: соответствует
соотношение: соотношение соотношением
сопутствовать: сопутствующие
состояние: состояния
спектр: спектров спектры
спектрограф: спектрографов
спектроскопический: спектроскопическая
спектроскопия: спектроскопию
спекуляция: спекуляции
ссылка: ссылки
стабильный: стабильное
стандартный: стандартной стандартную
становиться: становится
старение: старение
стать: стала
стоить: стоит
столь: столь
столько: столько
сторона: стороны
строго: строго
структура: структура структуре структуру структуры
судьба: судьба судьбу
сумма: сумма
существенно: существенно
существо: существа
существовать: существует
сформировать: сформировавшей
также: также
таков: таковы
такой: таким такими такого такое таком
текущий: текущие
телескоп: телескоп телескопа телескопе
температура: температура
теоретико: теоретико
теория: теории теория
термин: термин
тип: типа
типичный: типичное
тот: та тех той
точка: точка точки
точно: точно
точность: точности
трение: трение трения
триллион: триллион
трёхмерный: трехмерная
тяжело: тяжело
тёмный: темная темной темную
тёплый: теплая
уверенно: уверенно
уверенность: уверенности
угловой: угловом угловым
удаться: удалось
уделяться: уделяется
удивительно: удивительно
указание: указания
укладываться: укладывается
уменьшаться: уменьшается уменьшающейся
уменьшение: уменьшения
унылый: унылой
уравнение: уравнение уравнением уравнении уравнениях
ускорение: ускорением
уэбба: уэбб
факт: факт
фактор: фактор
фермион: фермионы
физика: физики
физический: физическим физического физическое
фиктивный: фиктивные
фокальный: фокальная фокальной
формально: формально
фото: фото
фотон: фотоны
фред: фред
фридман: фридмана
хаббловский: хаббловская
хаббнуть: хаббла
хаотически: хаотически
характер: характера
хватить: хватило
хойло: хойл
холодный: холодная
хороший: хорошая
хотя: хотя
целое: целом
цена: ценой
цифровой: цифровой
частица: частиц частицы
часть: часть
четырёхметровый: четырехметровым
число: числе
читать: читать
член: член члену
что: чему
чувствительный: чувствительна
шишка: шишка
штерн: штерн
штурм: штурма
эв: эв
эволюция: эволюция
эйнштейн: эйнштейна
эквивалентный: эквивалентно
экспоненциальный: экспоненциальное
энергетический: энергетическом
энергия: энергии энергию энергия
эрг: эрг
этот: эта
ясный: ясное
