август: августа
агент: агенты
академия: академии
активно: активно
алексей: алексей алексея
аллель: аллелей
альфа: альфа
амборелла: амборелла
амёба: амебы
анализ: анализ анализа
анекдот: анекдоты
арабидопсис: арабидопсиса
ареал: ареале
арифметически: арифметически
архейный: архейная
архея: археи
аспирант: аспирантов
атлантический: атлантическом
африканский: африканских
бабочка: бабочек
бабушка: бабушки
байка: байка
бактерия: бактерии бактерий бактериях
бегемот: бегемотов
бедно: бедно
безумно: безумно
безусловно: безусловно
белые: белые
белый: белого
беседа: беседа
бесконечный: бесконечное
беспозвоночный: беспозвоночных
бесценный: бесценны
биол: биол
биолог: биолог
биология: биологии биология
биомедицина: биомедицине
биомедицинский: биомедицинским
биомолекула: биомолекула
биофак: биофака
близкий: ближайшими ближе
болтаться: болтается
больший: большей большие
большинство: большинстве
большой: большого большое большой большому
ботаник: ботаники
брак: брак
брать: берем
буква: букв
бурый: бурого бурой
бутстрёп: бутстрепы
бывать: бывает
быстро: быстро
бытовать: бытует
быть: будут
важно: важно
важный: важных
вариант: вариант вариантами
вдоль: вдоль
ведро: ведро
везде: везде
великое: великое
венерический: венерическая
верблюд: верблюдом
верно: верно
вернуться: вернуться
вероятностный: вероятностном
вероятность: вероятности вероятность
вести: ведут
весь: весь всем
ветвление: ветвление ветвления
ветка: ветка веток
вещь: вещи вещь
взаимоотношение: взаимоотношения
взгляд: взгляд
взрослый: взрослыми
взрывной: взрывное
взять: взяла взяли
вид: вид вида видами видов виду виды
видеть: видим видите
видимо: видимо
видимый: видимому
видно: видно
видный: видны
видообразование: видообразование видообразования
википедия: википедия
вирус: вирус вирусы
вица: вице
включаться: включаются
вложить: вложить
вместе: вместе
внешний: внешним
внимание: внимания
внутренний: внутренних
вода: воду
возвращаться: возвращаясь
возможность: возможность
возможный: возможны
возникать: возникала
возникнуть: возник возникло возникшие
волосистоножковый: волосистоножковая
вольбахий: вольбахии
вообще: вообще
вопрос: вопрос вопросы
воспроизводиться: воспроизводится
восстанавливаться: восстанавливается
вполне: вполне
время: времени время
вроде: вроде
встроить: встроен
всюду: всюду
всякий: всякие всякого всяком
всё: всё
вторичный: вторичных
второе: второе
второй: второй вторых
выбор: выбор выбора
вывести: вывести
выделять: выделяем выделяли
выключаться: выключаются
вылазить: вылазит
выражение: выражение
вырасти: выросла
высказать: высказаны
высокий: высокого
выстроиться: выстроилось
выход: выходе
вычислительный: вычислительной вычислительный
вычислить: вычислили
выяснить: выяснили
вёз: вёзе
гад: гады
геккель: геккель
гельфанд: гельфанд гельфандом
ген: ген гена генов гену гены
генетик: генетиков
генетика: генетика
генетически: генетически
генетический: генетические генетическим генетическую
генный: генные
геном: геном генома геномам геномами геномах геномов геномы
гибкий: гибкая
гибрид: гибрид гибриды
гибридизация: гибридизации гибридизация
гибридизоваться: гибридизовались гибридизуются
гибридный: гибридных
гигиена: гигиены
гигиенический: гигиенические
гимрановое: гимрановым
гипотеза: гипотеза
глаз: глазами глазах
глубина: глубина
глубокий: глубокая глубокие глубоких
говорить: говорила говорили говорим говоря говорят
год: года лет
гораздо: гораздо
гречиха: гречихи
гриб: грибы
группа: группах группе группой группы
грызть: грызут
грызун: грызунов грызуны
гулять: гуляют
давать: давать дает дают
давно: давно
дальневосточный: дальневосточными
далёкий: далекие дальше
данные: данных
дать: данные
два: две двух
двадцать: двадцать
движение: движение
двойник: двойники
двустворчатый: двустворчатых
девочка: девочки
дедифференцировка: дедифференцировка
действительно: действительно
делать: делаем делали делать делают
делаться: делается делалось
делить: делить
делиться: делилась
дело: деле дело делом
денисовца: денисовец денисовца денисовцы
деньга: денег
департамент: департамента
дерево: дерева дерево дереву деревьев деревья деревьям деревьями деревьях
десять: десять
дешёвый: дешевых
дивергировать: дивергировали
дилетантский: дилетантский
дифирамб: дифирамб
дифференцировка: дифференцировки дифференцировку
длинный: длиннее
дмитрий: дмитрием
дно: дна
доверять: доверять
довольно: довольно
доказать: доказана доказано
докт: докт
долго: долго
должный: должен должны
доля: доля
дополнить: дополнить
дорога: дорогой
дорого: дорого
достаточно: достаточно
достигнуть: достигла
достоинство: достоинство
дохлый: дохлые
доходить: доходить
древесный: древесная древесные
древний: древних
древо: древо
дрозофила: дрозофил дрозофилы
друг: друг друга другом другу
другой: другая другие других другого другое другому
думать: думаете думали
дьявол: дьявола
евгений: евгением
европейский: европейской
единица: единица
единичный: единичными единичных
елена: еленой
ельцин: ельцин
естественнонаучный: естественнонаучных
живой: живое живых
животное: животные животным животными животных
жизнь: жизни жизнь
жираф: жирафом
жить: жила
жуков: жуков
жёсткий: жесткая
заболеть: заболела
зависеть: зависят
зависимость: зависимости
заговорить: заговорили
задавать: задавал задавала
задача: задач
задний: задним
закладываться: закладываются
заметный: заметного
замечательный: замечательным
занимать: занимают
заниматься: занимались занимаются
запретить: запретить
затем: затем
защитный: защитные
защищаться: защищаться
зебраданио: зебраданио
змея: змеи
знать: знаем знаю
значит: значит
значительный: значительной
зона: зоны
зонтик: зонтик
зоолог: зоологам зоологи зоологом
зоология: зоологии
зоомузей: зоомузея
зрение: зрения
зуб: зуба
идеальный: идеальной
идентичность: идентичность
идея: идея
идти: идет
иерархия: иерархия
известно: известно
известный: известными
изменение: изменений изменения
измениться: изменились
изначальный: изначальная
изолировать: изолированных изолированы
изучать: изучать изучают
илл: илл
иллюзия: иллюзия
именно: именно
иметь: имели
инженерный: инженерно
иной: иные
иностранец: иностранец
институт: института
интервью: интервью
интересно: интересно
интересный: интересная интересного интересный
интрогрессия: интрогрессию
инфекционный: инфекционные инфекционный инфекционным
искать: ищут
исключение: исключений
испытывать: испытывают
исследование: исследования исследованиям исследованиях
история: истории историй история
исчезновение: исчезновения
исчезнуть: исчез
итог: итоге
кабан: кабаном
каждый: каждого каждое каждой каждом каждый
казаться: кажется
каков: каково
какой: какие каким каких какого какое каком
кароша: кароши
картина: картина
картинка: картинки
кафедра: кафедры
качественный: качественный
кембрий: кембрии кембрий
кит: китами киты
китопарнокопытный: китопарнокопытные
класс: классов
классика: классики
классический: классическая классические классической
клетка: клетка клетками клетках клетки клеткой клеток
клеточка: клеточка
клеточный: клеточной клеточным клеточных
клон: клоны
книга: книги
количественный: количественной количественные количественный
количество: количества количество
коллега: коллеги
комбинаторный: комбинаторная
комбинация: комбинации
комментарий: комментариев
компонент: компоненту
компьютер: компьютер
кондрашов: кондрашова
конец: конец конца
конечность: конечности
конкретный: конкретного конкретные
конструкт: конструкт конструкты
концептуально: концептуально
коровин: коровина
косатка: косаткой
который: которая которое которой которые который которыми которых
крайность: крайности
критерий: критерием критерии
критический: критического
кролик: кролик кролика
кроме: кроме
крупный: крупные крупными
круто: круто
кто: кого
куколка: куколке
культивировать: культивировали
кунин: кунин куниным
кустик: кустик
куча: куча
ладный: ладно
лапка: лапка
летучий: летучей
либо: либо
лингвист: лингвистов
линия: линии
линн: линн
линнеевский: линнеевские
лицевой: лицевой
логачёв: логачёва
локиархея: локиархей
любимый: любимая любимые любимый любимых
любить: люблю
любой: любая
май: мая
маленький: мала
мало: мало
мальчик: мальчики
мама: мамы
маргулис: маргулис
мария: мария
маркин: маркина маркиной
март: марта
масса: масса
мастер: мастер
математический: математических
материал: материалом
материнский: материнский материнской
мгу: мгу
медведица: медведицы
медведь: медведи медведя
медицина: медицине
международный: международного
мембрана: мембрана мембраны
менее: менее
менять: меняют
меняться: меняется меняются
мера: меру
мерить: меряет
мероприятие: мероприятия
место: месте место местом
метаболизм: метаболизм
метаболит: метаболитов
метагеном: метагеномов метагеномы
метастаз: метастазов
метод: методами методах методы
механизм: механизм
мешать: мешает
микробиом: микробиом
мир: мир
мировоззренческий: мировоззренческого
митохондриальный: митохондриальных
митохондрия: митохондрии митохондрий
михаил: михаил михаилом михаилу
михневич: михневич
млекопитающее: млекопитающие млекопитающих
мнение: мнение мнения
многоклеточность: многоклеточность
многоклеточный: многоклеточные многоклеточных
мозг: мозг мозга
мой: мое моему мои моих
молекула: молекул
молекулярный: молекулярная молекулярно молекулярное молекулярной молекулярные молекулярный молекулярными молекулярных
моллюск: моллюска моллюсков
молодой: молодой молодые
момент: момент
мордобой: мордобоя
морской: морского
морфолог: морфологи морфологов
морфологически: морфологически
морфологический: морфологические морфологическими
морфология: морфологии морфологию морфология
мочь: мог могла могли могу могут можем можете
мужской: мужского
мутация: мутации мутаций
мы: нам
мысленный: мысленный
мышь: мышей мыши мышь
набор: набор набором
надежда: надежда надежды
надёжно: надежно
надёжность: надежности надежность
надёжный: надежны
наездник: наездники
назад: назад
наивный: наивная
найти: найденная найдут
накопиться: накопилось
накормить: накормить
наоборот: наоборот
например: например
нарисовать: нарисовали
насекомое: насекомых
наслать: нашли
настолько: настолько
наука: наук наука
находить: находят
находиться: находятся находящихся
начало: начала
начать: начали начать
начаться: началась началось
начинать: начинают
начинаться: начинаются
наш: нашем
неандерталец: неандертальцы
невероятно: невероятно
невроз: невроза
недавний: недавних
недавно: недавно
недостаточно: недостаточно
нейрон: нейрона нейронов нейроны
некоторый: некоторого некоторое некоторые
нематода: нематоды
неминуемо: неминуемо
немножечко: немножечко
немножко: немножко
ненадёжно: ненадежно
ненадёжный: ненадежна
необходимо: необходимо
неожиданный: неожиданный
непонятно: непонятно
неправда: неправда
неравномерно: неравномерно
неравный: неравный
несколько: несколько
несчастный: несчастная
нетривиальный: нетривиальные
неуверенность: неуверенность
нехорошо: нехорошо
нечего: нечего
неэффективный: неэффективный
нижний: нижней
низкий: низшими
никакой: никакие никаких
никто: никого
никуда: никуда
нобелевский: нобелевская
новый: новая новое новый новых
нормальный: нормальный нормальных
нужно: нужно
нужный: нужен нужна нужны
нулевой: нулевые
нынешний: нынешние
область: область
обмен: обмен обмена
обрабатывать: обрабатывали
образ: образом
обратить: обратила
обсуждаться: обсуждается
обучение: обучение
общеинженерный: общеинженерные
общество: общества
общий: общего общее общей общем общий общим
объединить: объединены
объект: объект
объективный: объективная
объявить: объявил
объяснить: объяснит
обычный: обычная обычной
огнёв: огнёв
один: одна одни одно одного одной одном
одинаковый: одинаковом
одноклеточный: одноклеточными одноклеточных
одномоментный: одномоментное
означать: означает
озёры: озерах
оказаться: окажутся оказались оказалось оказаться
оказываться: оказывается
океан: океане
окончательно: окончательно
окостеневать: окостеневает
окраска: окраска
октябрь: октября
они: ними
оно: оно
онтогенез: онтогенез онтогенеза
оперировать: оперировать
описать: описаны
описывать: описывать
определение: определение
определимый: определим
определять: определяет
определяться: определяется
опрокинуть: опрокинутая
опухоль: опухолей
опыт: опыты
орган: органа
организм: организма организме организмов
основать: основанная основанное основанные
особенность: особенности
особый: особых
особь: особей особи
оставить: оставили
остальной: остальное остальные
остаться: осталось
ось: оси ось
отбор: отбор
ответ: ответ
ответить: ответить
отвечать: отвечает отвечать
отдельно: отдельно
отдельный: отдельном отдельную отдельный отдельных
открывать: открывают
открытие: открытия
открыть: открыли
отличаться: отличается отличаются
относиться: относится относятся
оторваться: оторвались
отрывок: отрывок
отряд: отряд отряде отряды
отцовский: отцовский
оценивать: оценивать
оценить: оценить
оценка: оценки
очевидный: очевидна
очень: очень
очередной: очередным
пангеномный: пангеномной
папиллома: папилломы
пастуший: пастушья
пенина: пенин
первичный: первичным
первоначальный: первоначального
первый: первая первое первой первые первый первых
передний: передней
перелом: перелом
перемешивать: перемешивать
перемещаться: перемещаются
переносить: переносить
пересадить: пересадили
пересмотр: пересмотру
перестать: перестали
перестраиваться: перестраивается перестраиваются
переходный: переходные
песочный: песочные
печать: печать
пиджина: пиджины
пихать: пихали
планировать: планировать
плато: плато
плоский: плоская
плотность: плотность
плохо: плохо
плохой: плохие плохой
поведенческий: поведенческие
поверхность: поверхности
повторять: повторяет
погибать: погибают
подавлять: подавляющем
подбиратель: подбиратель
подвид: подвиды
поделить: поделили
подмешать: подмешать
подобный: подобного
подождать: подождать
подозревать: подозревали подозреваю
подсобрать: подсобрать
подход: подход подходе
подытоживать: подытоживает
пожалуй: пожалуй
позволять: позволяют
позвоночный: позвоночные
поиск: поисках
пока: пока
показать: показали
поколение: поколением
покопаться: покопаться
покрытие: покрытия
пол: пола
полвека: полвека
полезно: полезно
полезный: полезное
полноценный: полноценных
полный: полным
половинка: половинка
полтора: полтора
получаться: получается
получить: полученный
получиться: получилась получилось получится получиться
полчелюсть: полчелюсти
помимо: помимо
помойка: помойкой
понимание: понимание
понимать: понимаем понимали понимать понимаю понимают
понятие: понятие
понятно: понятно
понятный: понятны понятные
понять: поймете понять
попасть: попал попали
популяция: популяции популяций
пора: пор пора
порядок: порядке порядки
посадить: посадить
поскольку: поскольку
последний: последнее последние
последовательность: последовательностей последовательностям
посмотреть: посмотреть посмотрим
поставить: поставить
построение: построении построения
построить: построено построить
посчитать: посчитали
потеснить: потеснили
поток: поток потока
потомок: потомками потомки потомков
потомство: потомства
потратить: потратив
потрогать: потрогать
пофига: пофиг
похоже: похоже
похожий: похожи
почему: почему
почётный: почетным
поэтому: поэтому
появиться: появились появилось появился
появляться: появлялись
правда: правда
правило: правила
правильно: правильно
правильный: правильная правильное правильной
превращаться: превращается превращаются
превращение: превращением
предел: пределе
предковый: предковая
предок: предок
представимый: представим
представитель: представителей
представление: представлений
предшественник: предшественником
предыдущий: предыдущие предыдущих
прежде: прежде
президент: президентом
премия: премии
признавать: признают
признак: признакам признаки
прийтись: пришлось
приложение: приложение
примат: приматами приматов
применение: применения
пример: пример
примерно: примерно
принцип: принципе принципы
принять: примут
природа: природа природе
приукрашивать: приукрашивал
приходиться: приходится
причина: причинам
причём: причем
проблема: проблема
проверить: проверено
проверять: проверять
провоцировать: провоцируют
программа: программа
проделать: проделали
продолжать: продолжают
продолжение: продолжение
продукт: продуктов
продуцировать: продуцируют
проецировать: проецируем
проецироваться: проецируется
произвести: произвели
произносить: произносят
произойти: произошло
происходить: происходило происходит происходят
происхождение: происхождение происхождении
пройти: прошло
прокариот: прокариоты
пропадать: пропадает
прорастание: прорастание
простейшее: простейшие
просто: просто
простой: простейших проще
протеобактерия: протеобактерий
профессор: профессором
процент: процентов
процесс: процессе
прочее: прочего
прочитать: прочитанные
прыгать: прыгают
прямо: прямо
птица: птиц
путь: пути путь
пытаться: пыталась пытаться
пять: пять
работа: работа
работать: работает работать работают
равно: равно
разбросать: разбросаны
развиваться: развиваются
развитие: развитие развития
развитийный: развитийные
развиться: развиться
разговор: разговор разговорах разговоров
разделение: разделение разделения
разделиться: разделились
различать: различают
различаться: различаются
различие: различий различия
размножаться: размножаться
размываться: размываются
разнообразие: разнообразие разнообразия
разный: разная разному разные разный разных
разрешаться: разрешаются
разумный: разумная разумное
рак: рак рака раки раком
раковый: раковые раковых
ранний: раннее ранней ранним ранняя раньше
раскрутить: раскручены
растение: растений растения растениям растениями
расти: растет
расхождение: расхождения
раус: рауса
реакция: реакции
реальность: реальность
революция: революцию
регрессия: регрессия
регулировать: регулирует
регулятор: регулятор
регуляторный: регуляторную регуляторных
регуляция: регуляции регуляция
результат: результате
реконструкция: реконструкции реконструкция
речь: речь
решать: решать
решаться: решается решалась
решение: решение
рисование: рисовании
рисовать: рисовали рисовать
родиться: род
родоначальник: родоначальниками
родственник: родственниками родственники
роды: родов роды
россия: россии
рот: рта
ругаться: ругались ругаться
рука: руками
рукомахание: рукомахания
рябина: рябина рябину рябины
сажать: сажаете
сам: сами само самого самом
самец: самца
самка: самки самку
самостоятельный: самостоятельной
самый: самая самое самые самым
саркома: саркома саркомы
сбежать: сбежать
свободно: свободно
свободный: свободного свободный
свой: своего своей своем свои свой
сгущение: сгущение сгущений
сделать: сделали сделать
сей: сих
секвенировать: секвенировать
семейство: семейств семейства
семья: семьи
сентябрь: сентября
сергеевич: сергеевичу
серенький: серенькая
серия: серии
серновый: сернова
серый: серые
сеть: сетей сети
сигнал: сигнал
сидеть: сидит
сила: сил
сильно: сильно
симбиогенез: симбиогенеза
симбиогенетический: симбиогенетическое
симонович: симоновича
синтезировать: синтезировать
сиреневый: сиреневый
система: система
систематик: систематика
ситуация: ситуации ситуация
скажем: скажем
сказать: сказал сказано сказать
скидывать: скидывали
сколтех: сколтеха
сколько: сколько
скорость: скорости
скрещивание: скрещивание
скрещиваться: скрещиваться скрещиваются
слабо: слабо
следовать: следует
слишком: слишком
слово: словах слово
сложность: сложность
сложный: сложные сложный сложных
слон: слоны
служить: служить
случай: случае случаев случаи
случайно: случайно
случайный: случайным
сменять: сменяют
смешно: смешно
смотреть: см смотреть смотрим
смысл: смысле
сначала: сначала
собака: собак собака собаки
соблюдать: соблюдать
собрать: собрали собрать
собственно: собственно
событие: событиях
совершенно: совершенно
современный: современной современные
содержание: содержания
содержательно: содержательно
содержательный: содержательное содержательные
сожаление: сожалению
создание: создании
соображение: соображений
сообщать: сообщают
соответствовать: соответствовать
соответствующий: соответствующего
соревнование: соревнованием
сорт: сорта
соскребатель: соскребатель
состоять: состоит
сохранять: сохранять
соцветие: соцветии соцветия
спикер: спикеров
способ: способов способом
справляться: справляются
справочник: справочник
спрашивать: спрашивал спрашивают
спроецировать: спроецируем
спрятаться: спрячешься
сработать: сработал
сравнивать: сравнивать
сравнить: сравнили сравнить
сразу: сразу
становиться: становится
старый: старый
стать: стала стали стало
статья: статье статья статьях
стебель: стебля
степень: степени
сто: сто
столько: столько
сторона: стороны
страница: странице
странный: странные странный
стресс: стрессы
строить: строили
строиться: строятся
структура: структуру
студент: студент
сумка: сумка
существенный: существенное существенны
существо: существами
существовать: существует существуют
существующий: существующего
сформировать: сформировали
сформироваться: сформировались
схема: схем
схлопываться: схлопываются
сходство: сходства сходстве
схоластический: схоластического
сценарий: сценарии сценарий
считать: считать
счёт: счет счету
съесть: съел съесть
сюда: сюда
также: также
таки: таки
такой: такая такие таким таких такого такое таком такому
таксон: таксон таксона таксонами таксонов таксоны
таксономист: таксономисты
таксономический: таксономические
таксономия: таксономию таксономия
тасманийский: тасманийского
темерёва: темеревой
теоретический: теоретический
теория: теории
тетрациклин: тетрациклином
технический: технический техническое
тибет: тибете
тибетский: тибетский тибетском
тигр: тиграми тигров
тип: типа типам типов типы
ткань: тканей
толстый: толстый
топология: топологии
торгсин: торгсине
тот: та те теми тому
тотальный: тотальных
точка: точки
транскриптом: транскриптомы
транскриптомика: транскриптомикой
транскриптомов: транскриптомов
транскрипционный: транскрипционная
трв: трв
третий: третьих третью
тридцать: тридцать
триста: триста
трёп: треп
туда: туда
тысяча: тысяч
уверенность: уверенности
увидеть: увидим
угроза: угрозой
удав: удава
удивительно: удивительно
удивительный: удивительным
удобно: удобно
удобство: удобства
узел: узлах узлов узлы
узнавать: узнавали
узнать: узнаем
укроп: укроп укропа
умереть: умерла
универсальный: универсален
университет: университетах
уровень: уровень уровне уровни уровня
условие: условие
услышать: услышал
успешный: успешная успешным
устаканиться: устаканилась устаканилось устаканится
установить: установили
устойчивость: устойчивость
устойчивый: устойчива устойчиво
устроенный: устроен
устроить: устроено устроены
утратить: утраченного
уходить: уходили
участок: участке участок
учить: учат
учёт: учетом
фактически: фактически
факультет: факультетах
фаланга: фаланги
фантастический: фантастические
фертильный: фертильными
физиология: физиологии физиологию
филогенез: филогенез
филогенетика: филогенетики
филогенетическо: филогенетическо
филогения: филогенией филогении филогению филогения
форма: форма
формально: формально
формулироваться: формулируется
фото: фото
функциональный: функциональная функциональных
функционирование: функционирования
функционировать: функционируют
функция: функция
хаотически: хаотически
хаотический: хаотическое
хватать: хватает
химера: химерой
химия: химией
хищник: хищник
хозяин: хозяина
хороший: хорошая хорошему хороши хорошие
хотеть: хотели хотите хотят хочет
хотеться: хотелось
хотя: хотя
хроматин: хроматина
хромосома: хромосомы
хрящ: хрящ
худо: худо
цветковый: цветковых
цветок: цветка
цветочек: цветочки цветочков
целый: целый
центр: центра
цикл: цикл
цихлида: цихлиды
частность: частности
часть: части
часы: часы
человек: людей люди человек человека
челюсть: челюсти челюсть
черви: черви
честной: честные
число: числом
чисто: чисто
член: членом
членение: членения
членистоногий: членистоногие
что: чему
чудесный: чудесная чудесное чудесные чудесный
чёткий: четкая
шимпанзе: шимпанзе
широкий: шире широкие
штерн: штерн
штука: штук
эволюционный: эволюционная эволюционной эволюционные
эволюция: эволюции эволюция
экземпляр: экземпляра
эксперимент: эксперимент эксперименте экспериментов
экспонат: экспонаты
экспрессия: экспрессии
элемент: элементы
эмбриогенез: эмбриогенезе
эмбриология: эмбриология
эмбрион: эмбриона
эндемик: эндемик
энтузиаст: энтузиасты
эра: эре
этап: этапе
это: этим
этот: эта этих этому
эукариот: эукариот
являться: являемся является являются
язык: языке языки языков
языковой: языковой
ярко: ярко
ясно: ясно
ящерица: ящерицами
ёж: ежа
