автоматически: автоматически
автоматический: автоматической
акацук: акацуки
алексей: алексей
американский: американские
аналогичный: аналогичной
аполлон: аполлон аполлона
аппарат: аппарат аппарата аппаратов
апрель: апреля
ароматический: ароматические
астероид: астероид астероиде
астронавт: астронавт
астроновость: астроновости
астроном: астрономов астрономом астрономы
астроёлочка: астроёлочка
бабочка: бабочка
бар: баром
бассейн: бассейн бассейна бассейне
безопасный: безопасный
бенна: бенну
бернард: бернард
благодаря: благодаря
близкий: ближайшая ближайшие
близость: близости
богиня: богиня
боде: боде
большой: большой
буря: бури
быстрорастущий: быстрорастущий
важный: важны
великий: великий
величина: величина величины
венера: венеру
вершина: вершины
ветеран: ветеран
вещество: веществом
взаимодействие: взаимодействие
вид: виды
видимый: видимой
видный: виден
вильгельм: вильгельмом
влияние: влияние
внезапно: внезапно
внеземной: внеземной
вновь: вновь
внутренний: внутреннюю
внутри: внутри
возвращать: возвращаемой
возможность: возможности
возобновить: возобновил
вокруг: вокруг
восстановить: восстановить
впервые: впервые
время: время
вселенная: вселенная
всматриваться: всматриваться
всё: всё
второе: второе
второй: второй
вывести: выведен
выдающийся: выдающиеся
выделяться: выделяется
вызвать: вызвал
высота: высотой
выступать: выступающий
выход: выход
выявить: выявить
вэньчан: вэньчан
газ: газа
газовый: газовые
газопылевой: газопылевого газопылевой
галактика: галактика галактике галактики
галактический: галактическое
гантель: гантель
геометрия: геометрии
германия: германия
гигантский: гигантском
гидра: гидры
гироскоп: гироскоп гироскопа гироскопов гироскопом гироскопы
глаз: глаз глаза глазами глазом глазу
глубина: глубин глубина
глубокий: глубокого
год: года году лет
годовщина: годовщины
голова: голова голове голову головы
горный: горных
горячий: горячая
градус: градусов
грива: грива гривы
грунт: грунт грунта
группа: группа группе
дальний: дальнего
датчик: датчиков
дать: дал
два: двух
действовать: действующей
демонстрировать: демонстрирует демонстрируют
демонтаж: демонтажем
день: дня
детальный: детальные
деятельность: деятельности
джеймс: джеймс джеймса
диаметр: диаметр
диапазон: диапазона диапазоне
длительный: длительное
довольно: довольно
должный: должен
доставить: доставить доставлен
доставлять: доставляли
достаточно: достаточно
др: др
древний: древнем
европейский: европейский
едва: едва
забор: забор
замена: заменой
заменить: заменены
занятой: занятых
запад: западе
запланировать: запланировано
запуск: запуска
запустить: запустил запущен
затем: затем
зато: зато
зафиксировать: зафиксированные
захандрить: захандрил
звезда: звезд звезда
звездообразование: звездообразования
звёздный: звездная
земля: земли землю
зигзаг: зигзаг
змея: змеи
зонд: зондом
зрение: зрения
известный: известнейших известной
излучение: излучения
излюбить: излюбленной
изображение: изображение изображении изображения
изучение: изучением
изучить: изучить
именовать: именуемой
иметь: имеет
имя: имени
инженер: инженерам
институт: институтом
инструмент: инструмента инструментам
инфракрасный: инфракрасном инфракрасные
использование: использованием использования
использовать: использована использует
испытывать: испытывал
исследование: исследований
история: истории
итог: итоге
июнь: июня
калибровка: калибровку
квадратный: квадратных
квазар: квазар
квинтет: квинтет
кг: кг
кеплер: кеплера
китай: китай китая
китайский: китайская китайской
китайско: китайско
км: км
кнр: кнр
кольцо: кольцо
комета: комета
конский: конская конской конскую
конструкция: конструкцией
координата: координаты
корабль: корабля
космический: космический космическим космических космического космической
космодром: космодрома
космос: космос космоса
который: которой которые который которых
край: краю края
красный: красного красное
кратер: кратер кратера
кудрить: кудря
легендарный: легендарного
лететь: летит
луна: луну луны
лунный: лунного лунной лунную лунные лунный
луч: лучах
магнетар: магнетара
май: мая
майк: майк
макет: макет
макс: макса
максимально: максимально
маленький: меньше
малый: малая
массимино: массимино
материал: материала
мгновенный: мгновенные
международный: международной
межзвёздный: межзвездного межзвездным
мелкомасштабный: мелкомасштабные
менее: менее
мессье: мессье
место: месте место
месяц: месяцы
мир: мир
миссия: миссии миссия
млечный: млечный
модуль: модуль модулях
молекулярный: молекулярной
момент: момент
монголия: монголию
мочь: могут
мпк: мпк
мск: мск
мы: нам
наблюдать: наблюдает наблюдать
наблюдение: наблюдений наблюдения наблюдениям
наведение: наведение наведения
название: название
называть: называемые
наличие: наличия
напоминать: напоминающее
наслать: нашли
наследие: наследие
настоящий: настоящему
научный: научные научным научных
находиться: находится находятся
нацелиться: нацелится
национальный: национальным
начинать: начинает
наш: наш
небесный: небесной
небо: неба небе
неверный: неверные
невозможный: невозможными
нейтронный: нейтронная
некоторый: некоторые
немецкий: немецким
необычный: необычной
непохожий: непохожая
нептун: нептуна
новогодний: новогодний
новый: новая новое новой новые новый новых
номер: номера
ноябрь: ноябре
нужно: нужно
нынешний: нынешний
обеспечить: обеспечит
обладать: обладает
облако: облака облако
область: областей области
обнаружить: обнаружена
оборот: оборота
оборудование: оборудование
образ: образом
образец: образцов образцы
образоваться: образовалась
обратно: обратно
обратный: обратной
обсерватория: обсерватории обсерватория
обслуживание: обслуживанию обслуживания
общество: общества
объединить: объединенные
объект: объектов
объектив: объективах
один: одного
оказывать: оказывают
около: около
окружающий: окружающие
омар: омара
омега: омега
определять: определять
оптик: оптику
оптимистичный: оптимистичные
оптический: оптические оптической
орбита: орбите орбиту
орбитальный: орбитальная орбитальной
ориентация: ориентации ориентацию
орион: ориона
осветить: освещенном
освещать: освещает
основание: основании
основной: основной
особенность: особенность
оставаться: остается
остальной: остальное
остаток: остаток
остаться: осталось останется
остров: острове
ответственный: ответственная
открытый: открытое
отличительный: отличительная
отметить: отметил
отправка: отправка отправки
отсюда: отсюда
отчётливо: отчетливо
охватывать: охватывают
очень: очень
панорама: панораму
пау: пау
пекин: пекине
первый: первые первым
перевести: переведен
передать: передал
перейти: перейдет перешел
перемычка: перемычкой
пересекать: пересекающей
переход: переход
персея: персея
планк: планка
плотный: плотных
площадь: площадью
поверхностный: поверхностная
поверхность: поверхность
подключить: подключены
подробный: подробнейшим
подсчитать: подсчитали
позволить: позволит
позволять: позволяет позволяющего
поиск: поиска
пока: пока
показание: показания
показать: показана
поле: поле
полициклический: полициклические
полмиллиона: полмиллиона
полномасштабный: полномасштабный
полноценный: полноценное
получать: получать
получить: полученная полученное полученные
полюс: полюс
помогать: помогают
помощь: помощью
попытаться: попытается
пора: пор
порода: пород
порядок: порядка
посадка: посадки посадку
посадочный: посадочный
посередине: посередине
поскольку: поскольку
постоянно: постоянно
поход: поход
почва: почвы
празднование: празднования
прародитель: прародитель
предназначить: предназначена
представить: представлены
прежде: прежде
прекрасно: прекрасно
прервать: прервал
прибор: приборов приборы
привет: привет
прилунение: прилунения
примерно: примерно
примечательный: примечательной
приполярный: приполярном
приступить: приступит
присутствовать: присутствуют
причина: причиной
проблема: проблемы
проводить: проводить
программа: программы
продлить: продлить
продолжаться: продолжающейся
продолжить: продолжит
проект: проект
пройти: пройдет
пропасть: пропавшие
пространство: пространстве
проходить: проходившем
прошлое: прошлого
прошлый: прошлом
прощать: прощай
пульсар: пульсара пульсары
путь: путь
пылев: пылевой
пылевидный: пылевидные
пятно: пятна
пятый: пятой
работа: работе работу
работать: работает работать
рабочий: рабочих
размер: размеры
разместить: размещены
ракета: ракету ракеты
рамка: рамках
ранее: ранее
распасться: распадется
расположить: расположена расположенной
рассеяться: рассеялись
расстояние: расстояние расстоянии
реализация: реализации
реголит: реголит
режим: режим режиме
резерв: резерв
результат: результатом результаты
рекорд: рекорд
рентген: рентгене
рентгеновский: рентгеновский рентгеновских рентгеновского
роботизированный: роботизированный
самый: самые
сбой: сбой
сбор: сбора
сверхновый: сверхновой
светиться: светится
световой: световых
свой: своей своих
сгусток: сгустков
сделать: сделали сделан сделать
северный: северном
сей: сих
селенографический: селенографические
семинар: семинаре
сентябрь: сентября
середина: середину
силикат: силикаты
сильный: сильное
система: система системы
систематический: систематическим
сичан: сичан
скопление: скопление
скорость: скорости
следующий: следующим
служебный: служебный
смещение: смещение смещения
смотреть: см
снимка: снимок
снимок: снимке снимки
снова: снова
собрать: собрать
событие: события
советский: советские
совместный: совместный
созвездие: созвездии
солнечный: солнечной
солнце: солнца
сомбреро: сомбреро
сообщить: сообщило
соответственно: соответственно
состав: состав
состояние: состоянии
состоять: состоит состоящей
сотня: сотни
сотрудничество: сотрудничества
сохранение: сохранение
специфический: специфических
спиральный: спиральная
способный: способен
спустя: спустя
спутник: спутника спутнике спутники
становиться: становясь
станция: станцией
старт: старта
стать: стал станет стать
стефан: стефана
столб: столб
сторона: стороне стороны
структура: структур структурой структуры
существование: существования
сфера: сферы
схема: схемы
счёт: счет
съёмка: съемки
также: также
такой: таким
телескоп: телескоп телескопа телескопом
темпель: темпелем
тестовый: тестовом
технический: техническому
тип: тип
тот: той
точность: точность
точный: точное
транзиентный: транзиентные
требовать: требует
три: трех
трубка: трубок
туманность: туманности туманность
тусклый: тусклые
тысяча: тысяч
тёплый: теплый
углеводород: углеводороды
угловой: угловые
ударный: ударном ударный
удаться: удалось
узкий: узком
узконаправленный: узконаправленного
ультрафиолетовый: ультрафиолетового
уменьшить: уменьшит
уран: уран
успешно: успешно
установить: установлено
устройство: устройства
уэбба: уэбб уэбба
физика: физики
физический: физических
фокусироваться: фокусируется
фото: фото
фотодиссоциация: фотодиссоциации
фотон: фотоны
франция: франция
функционирование: функционирование
хаббл: хаббл
хаббль: хаббле
хаббнуть: хаббла
хайнань: хайнань
характерный: характерной
химический: химический
ход: ходе
хороший: хорошем
цель: целью
ценный: ценного
центавро: центавра
центр: центром
чандра: чандры
чанчжэн: чанчжэн
чанъэ: чанъэ
челнок: челнока
четвёртый: четвертой
шаровой: шаровое
шесть: шесть
широкоугольный: широкоугольного широкоугольный
эволюция: эволюции
эйнштейн: эйнштейн эйнштейна
эйткен: эйткен
экзолуна: экзолуны
экспедиция: экспедицией
эпоха: эпоху
этап: этапом
это: этим
юго: юго
южный: южном южный
юпитер: юпитер
являться: является
ядро: ядро
язев: язев
январь: января
яркий: яркий яркое
яркость: яркость
