агентство: агентства
аккреции: аккреции
аккреционный: аккреционном аккреционный
активность: активности активность
активный: активной активные активным активными активных
алексей: алексей
алисса: алисса
альберт: альбертом
амай: амая
анализ: анализом
аппарат: аппарат
астероид: астероид
астроновость: астроновости
астроном: астрономам астрономов астрономы
астрономический: астрономический
астрофизик: астрофизики астрофизиков
астроёлочка: астроёлочка
база: базу
белый: белого белый
благодаря: благодаря
ближний: ближнего
богатый: богатый
больший: большие больших
бушаус: бушаус
быстровращающийся: быстровращающихся
быть: будут
вверху: вверху
венера: венеру
вероятно: вероятно
вертикальный: вертикальные
верхний: верхней
вес: вес
вести: ведет
вещество: вещества
взаимодействие: взаимодействий
взаимоотношение: взаимоотношения
взгляд: взгляд
вид: виде
видимый: видимых
видный: видна
включать: включающих
включая: включая
внизу: внизу
внимание: внимание
внутренний: внутреннем внутреннюю
внутри: внутри
воздействие: воздействие воздействием
возможность: возможности возможность возможностями
возмущение: возмущений
возникать: возникают
возрастание: возрастания
вокруг: вокруг
волк: волка
волна: волны
вопрос: вопросы
восстановить: восстановленный
впервые: впервые
вращаться: вращается вращающиеся
вращение: вращения
временный: временный
время: временем времени время
вселенная: вселенная вселенной вселенную
всплеск: всплеск всплесков
вспышка: вспышек вспышкам вспышки
встречаться: встречаться
вторичный: вторичной
выброс: выбросы
выдающийся: выдающиеся
вызывать: вызывая
выпуск: выпуске
выраженный: выраженными
высвобождать: высвобождая
высокий: высокой
высокочастотный: высокочастотного
высота: высоте
выявить: выявив выявили выявить
выявление: выявление
выяснить: выяснили
газ: газ газа
галактика: галактик галактика галактикам галактиках галактике галактики галактику
галактический: галактическим галактических
гелиевый: гелиевого
генерировать: генерирует
гигант: гигантов
гикеан: гикеан
глаз: глазами
глубина: глубинах
глубокий: глубже
говард: говард
год: года лет
голубой: голубыми
гораздо: гораздо
горизонт: горизонта
город: города
горячий: горячий
гравитационный: гравитационного гравитационной гравитационному гравитационных
гравитация: гравитации
градация: градациях
граница: граница
график: график графиках
графика: графике
группа: группа
дальнейший: дальнейших
далёкий: далекая
данные: данных
данный: данном
дать: дадут данные
двойной: двойной двойных
действие: действием
делиться: делятся
дело: дело
демонстрировать: демонстрирует
день: день
деталь: детали
детальный: детального детальное
джеймс: джеймс джеймса
диаметр: диаметр диаметром
диапазон: диапазона диапазоне
динамика: динамику
диск: диск диске
длина: длиной длину
длительный: длительного длительное длительных
длиться: длящиеся
добавлять: добавляет
дополнительный: дополнительных
дорожка: дорожками
достигать: достигает
другой: другие
дыра: дыр дыра дырами дырой дыру дыры
евклид: евклид евклида
европейский: европейского
журнал: журнале
зависимость: зависимость
зад: заде
задача: задачу
заметить: заметить
замкнутый: замкнутого
запечатлеть: запечатлел
запустить: запущен
заранее: заранее
зарядить: заряженный
затем: затем
зафиксировать: зафиксировать
захватывать: захватывать
заштриховать: заштрихованная
звезда: звезд звезда звездами звезду звезды
звездообразование: звездообразования
звёздный: звездной звездные
зелёный: зеленая
идеально: идеально
идеальный: идеальное идеальным
идентифицировать: идентифицирован
идти: идет
извержение: извержения
известно: известно
известный: известна известная известной известный известных
излучающий: излучающие
излучение: излучению излучения
изменение: изменения
изначально: изначально
изображение: изображение изображений изображения изображениях
изобразить: изображена
изучать: изучая
изучение: изучении изучения
изучить: изучить
иллюзия: иллюзию
иллюстрация: иллюстрации
именно: именно
иметь: имеем
имя: имени
индийский: индийского
инструмент: инструмент инструмента
интерес: интерес
интересный: интересным
информация: информация
инфракрасный: инфракрасного
ио: ио
исключить: исключено
искривляться: искривляется
использовать: использовали использовать используя
испускать: испускает
исследование: исследование исследовании исследований исследования
исследователь: исследователей исследователи
история: истории
источник: источник источника источников источником
июль: июля
каждый: каждым
камера: камеру камеры
кандидат: кандидатами кандидатов
карлик: карлик карлика
карликовый: карликовые карликовых
карта: карты
квадрат: квадраты
квазар: квазаров
квинтет: квинтет
кеплер: кеплера
китта: китт
класс: классу
кластер: кластеры
ключевой: ключевую
км: км
колебание: колебания
количество: количество количеством
коллаборация: коллаборация
коллекция: коллекцию
кольцевой: кольцевые
кольцо: кольца кольцо кольцом
команда: команда команды
компактный: компактное компактных
компонент: компонент компонента
конец: конца
короткий: короткие коротких
космический: космический космическим космических космического космическое
космос: космос космоса
который: которая котором которые который которых
красноватый: красноватыми
красный: красная красной красным
кроме: кроме
кроуфорд: кроуфорд
круг: круга
крупный: крупнейший крупнейшую крупных
кудрить: кудря
линза: линз линзы
линзирование: линзированию
линзировать: линзирующей
линия: линией линии линия
лишь: лишь
лия: лия
луч: лучей
люси: люси
магнитный: магнитного магнитных
малое: малым
маломассивный: маломассивных
марсианский: марсианский
масса: масса массу массы
массивный: массивного массивную массивный массивных
масштабный: масштабную
материал: материал
материя: материи
мгновенно: мгновенно
мгц: мгц
международный: международная
мейол: мейола
мелкий: мелкие
менее: менее
меняться: меняется менялась
мерцание: мерцания
место: местом
месяц: месяца
метровый: метровом
механизм: механизма
миллиард: миллиардов миллиарды
миллисекундный: миллисекундного миллисекундными
минимальный: минимальное минимальный
мир: мире миром
миссия: миссии
мкм: мкм
млечный: млечного млечный
мнение: мнению
множество: множества
модель: модели модель
модельный: модельную
модернизированный: модернизированный
мозаика: мозаике
молодой: молодыми
мониторинг: мониторинга
море: моря
мочь: мог могут
мощный: мощнейшего мощный
мс: мс
наблюдать: наблюдаемые
наблюдение: наблюдение наблюдений наблюдения
набор: набор
надеяться: надеются
называться: называются
наиболее: наиболее
найти: найденных найти
наклон: наклона
намагнитить: намагниченные
например: например
наслать: нашли
настоящий: настоящее настоящей
находиться: находящихся
находка: находка находку
национальный: национального национальной
наш: наше нашей
небесный: небесной
небольшой: небольшими небольших
недалеко: недалеко
незначительный: незначительных
нейтронный: нейтронную нейтронные нейтронных
некоторый: некоторые
необычный: необычное необычные
непохожий: непохожая
непрерывный: непрерывного
несколько: нескольких несколько
неуловимый: неуловимыми
нижний: нижней
николас: николаса
новогодний: новогодний
новость: новостей
новый: новое новую новые новый новым новых
номер: номера
ныне: ныне
обзор: обзор обзора
обладать: обладает
область: областей области область областью областями
обнаружение: обнаружения
обнаружить: обнаруженная обнаруженных обнаружены обнаружив обнаружили обнаружить
обозначать: обозначают
обозначение: обозначение
обозначить: обозначена обозначены
образ: образом
образование: образование образования
образоваться: образуется образуются
обсерватория: обсерватории
обусловить: обусловлено
обширный: обширную
общий: общая общей
объединение: объединения
объект: объект объекта объектов объекты
объектив: объективах
объясняться: объясняются
ограниченный: ограниченными
огромный: огромное
один: одной
однако: однако
одновременно: одновременно
ожидать: ожидала
ожидаться: ожидается ожидалось
оказаться: оказавшихся оказалась оказаться
около: около
окружающий: окружающее окружающий
они: ними
определённый: определенные
опубликовать: опубликована опубликованной опубликовано
орбита: орбите орбиты
орбитальный: орбитальный
ослепительно: ослепительно
основа: основе
основный: основного
особенность: особенности
особый: особый
оставаться: остаются
остаток: остатки
отвечать: отвечают
отдалить: отдаленной
отдельный: отдельных
открывать: открывает
открытие: открытие открытием открытии открытия открытиям
открыто: открыто
открытый: открытые
открыть: открыта
отличие: отличие
отличный: отличным
отметить: отмечены
относительно: относительно
относительность: относительности
относиться: относится
отправиться: отправился
оцениваться: оценивается
оценить: оценили
падать: падает
панель: панели
пара: пары
параметр: параметры
первый: первые первых
передать: передал
передовой: передовая
пересоединение: пересоединения
переход: перехода
период: период периода периодами периодов периодом периоды
периодический: периодические
пик: пик
питаться: питаются
плазма: плазму
план: планах
планета: планеты
плотность: плотности
подобный: подобного подобные подобных
подозревать: подозревают
подробный: подробной
подходить: подходит
подходящий: подходящая подходящий
позволить: позволило позволит
позволять: позволяют
поиск: поиск поисков
показать: показали показан показана показано показаны
покой: покоя
поле: поля
полоса: полос
получать: получаемым
получить: получил получила получили
полярный: полярных
помогать: помогает
помощь: помощью
понимать: понимают
пончик: пончик
понять: понять
портрет: портреты
порядок: порядка порядке
поскольку: поскольку
постоянно: постоянно
поток: потоки
поэтому: поэтому
практически: практически
превращаться: превращается
превышать: превышает
предварительный: предварительные
предел: пределах
предоставлять: предоставляет
предполагать: предполагают
предполагаться: предполагалось
предположительно: предположительно
предсказать: предсказанное
представитель: представители
представить: представлена представлены
представлять: представляет представляют
предшественник: предшественниками
предыдущий: предыдущих
преимущественно: преимущественно
препринт: препринтов
прерываться: прерываясь
приблизительно: приблизительно
прибор: приборов
прибыть: прибыл
привлечь: привлекло
приливный: приливное
примерно: примерно
природа: природу
пристально: пристально
приходить: приходит
проведение: проведения
проводить: проводить
продолжаться: продолжающиеся
продолжительность: продолжительностью
продолжительный: продолжительные
проект: проекта
произойти: произошло
происходить: происходят происходящие
прокладывать: прокладывая
пролетать: пролетая
промежуток: промежутки
промежуточный: промежуточной промежуточные
проникнуть: проникнуть
пропасть: пропавшие
проследить: проследить
простой: проще
процесс: процесса процессы
прошлый: прошлом
пузыриться: пузырящаяся
пульсар: пульсар пульсара пульсарами пульсаров пульсары
пуна: пуна
пунктирный: пунктирная пунктирные
пустота: пустоты
путешествие: путешествие
путь: пути путь
путём: путем
пылевой: пылевыми
пыль: пыли
пэгать: пэган
пять: пяти
работа: работу
работать: работающие работающий
радиоастрономия: радиоастрономии
радиоволна: радиоволн
радиоизлучение: радиоизлучения
радиопульсар: радиопульсаров
радиотелескоп: радиотелескоп
различный: различных
размер: размерами
разный: разной
разрушение: разрушение
ральф: ральф
рамка: рамках
ранее: ранее
ранний: ранней ранних раннюю
раскручиваться: раскручивается
расположить: расположена расположенной расположенных
расстояние: расстоянии расстояния
расходиться: расходятся
расширение: расширения
редкий: редкие редкими редкое
результат: результатам результате результаты
рекорд: рекорд
реликт: реликтами
рентгеновский: рентгеновских
речь: речь
роль: роль
рукав: рукава рукавами
рыба: рыбах
сайт: сайте
сам: сама самого самой самом
самый: самое самую
сверхмассивный: сверхмассивная сверхмассивной сверхмассивных
сверхновый: сверхновая
свет: свет
световой: световая световых
свечение: свечение
свидетельствовать: свидетельствует
свой: своего
свыше: свыше
сделать: сделали сделанном
себя: собой
север: северу
сегодняшний: сегодняшний
сейферт: сейферта
секунда: секунд
сенсация: сенсацией
сервер: сервере
сердце: сердце
серия: серия
серый: серого серой
сжимать: сжимать
сигнал: сигналом
сила: силы
синий: синим синими
система: систем система системах системы
сияние: сияния
сканировать: сканируя
скопление: скоплении скоплений скопления скоплениях
скорость: скорости
скрываться: скрывающейся
слабый: слабые
слева: слева
следить: следим
сложный: сложную
случай: случае
случайный: случайным
смотреть: см
смочь: смог
снимок: снимке
снятой: снятых
собрать: собрали собрать
собственный: собственной
событие: событий события
совершить: совершила
совпадать: совпадают
современный: современных
содержать: содержащих
созвездие: созвездии
создавать: создавая
создание: созданием
создать: создали созданных
солнечный: солнечной солнечными
солнце: солнца
сообщить: сообщено
соответствовать: соответствующей
сосредоточить: сосредоточены
составить: составил
составлять: составляет
состояние: состоянием состоянию
состоять: состоит
спектр: спектр спектры
спектральный: спектральная спектральных
спектроскопический: спектроскопические
спектроскопия: спектроскопии спектроскопия
специалист: специалистов
спиральный: спиральные спиральными
сплошной: сплошная
способный: способная
справа: справа
спутник: спутника спутники
сравнение: сравнении
сравнивать: сравнивают
среди: среди
сталкиваться: сталкиваются
становиться: становится
старт: старта
старый: старые
стать: стала стало
статья: статье статьи статья
сто: ста
столь: столь
страница: страницу
стрелец: стрелец
структура: структуры
судьба: судьба
сфера: сферы
сформироваться: сформировавшихся
считать: считать
считаться: считается считаются
счёт: счет
сыграть: сыграть
тайна: тайны
также: также
такой: таким таких
телескоп: телескоп телескопа телескопе телескопом
тело: тел
теория: теории
течение: течение
тип: типа
толстяк: толстяк
тот: тех той
точка: точка точками
треть: трети
трёхмерный: трехмерной
турбулентный: турбулентные
тусклый: тусклые
тускнеть: тускнеет
тысяча: тысяч
тёмный: темной
убедиться: убедились
увеличение: увеличении
увидеть: увидеть
угол: углом
удаление: удалении
удаться: удалось
удивительный: удивительное
узконаправленный: узконаправленные
указывать: указывают
уменьшить: уменьшить
уникальный: уникальные
уран: уран
уровень: уровень уровнем
ускоренный: ускоренных
установить: установлен
установленный: установленный
учёный: ученые ученым
уэбба: уэбб уэбба
факт: фактом
фархад: фархад
физик: физикам
фоновый: фонового
форма: форме
формирование: формирование формирования
формировать: формирующего
фотограф: фотограф
фотометрический: фотометрические
фотометрия: фотометрию фотометрия
фундаментальный: фундаментальную
функционирование: функционирования
хаббл: хаббл
хаббнуть: хаббла
характеристика: характеристик характеристики
ход: ходе
хотя: хотя
художник: художника
хустэк: хустэк
цвет: цветом
цель: целью
центр: центра центрах центре
центральный: центральной центральную
чандра: чандры
час: часа часов
частица: частиц
частота: частот частота
часть: часть
человечество: человечеству
четырёхметровый: четырехметровом
чёрный: черная черной черную черные черными черных
шаров: шаровых
шаровой: шаровом шаровые
шесть: шести
широкий: широком
шум: шум
эволюция: эволюции эволюцию
эйнштейн: эйнштейна эйнштейном
экзолуна: экзолуны
эксцентриситет: эксцентриситет
эксцентрический: эксцентрических
электрически: электрически
электромагнитный: электромагнитной
энергия: энергии энергию
этап: этапах
этот: эта этих
южный: южном
юпитер: юпитер
юсуф: юсуф
явление: явление явления
являться: является
ядро: ядра ядро ядром
язев: язев
яркий: яркие яркое ярче
ярко: ярко
яркость: яркости яркостью
