аберрация: аберрации
абзац: абзаце
автор: авторов авторы
адрес: адресу
активный: активных
акцент: акцентом
алексей: алексей
американский: американского
анализ: анализ анализа
анджей: анджея
апертура: апертурой
арсенал: арсеналом
аспирантка: аспирантка
астроном: астронома астроному астрономы
астрономический: астрономическим
астрофизик: астрофизика астрофизики астрофизику
атакама: атакама
барионный: барионная барионного барионной
блестящий: блестящему
близкий: ближайшим близки
бмо: бмо
богдан: богдану
большинство: большинство
большой: большого большое большом
британия: британии
британский: британском
важно: важно
вакуумный: вакуумных
варшавский: варшавским варшавского варшавской варшавском
вейцмана: вейцмана
величина: величины
вера: вера
вероятность: вероятность
вести: ведут
весь: всем всему
весьма: весьма
вещество: вещества
взаимодействовать: взаимодействуют
взрыв: взрыва взрывов
вид: виде
видимый: видимой видимую
вимп: вимпов вимпы
вклад: вклад вкладом
включая: включая
внесолнечный: внесолнечных
внести: внесла
вновь: вновь
внутри: внутри
вовсе: вовсе
возможность: возможности возможность
возмущение: возмущения
возникновение: возникновения
возникнуть: возникли возникших
волна: волн
впервые: впервые
вплоть: вплоть
вполне: вполне
впоследствии: впоследствии
временно: временно
время: времени время
вряд: вряд
вселенная: вселенная вселенной
входить: входят
вывод: вывода выводу
вызывать: вызывавших
выполнение: выполнении
выполнить: выполненный
выпускник: выпускнику
вырасти: вырастет
высокий: высокого
выступать: выступать
вычисление: вычисления
выявить: выявили выявить выявленных
выявление: выявления
галактика: галактике галактики галактику
галактический: галактического
гало: гало
генриетта: генриетта генриетты
геометрия: геометрии
гибель: гибелью
гипотеза: гипотезы
гипотетический: гипотетические гипотетических
главный: главная главной главным
говорить: говоря
год: года году годы лет
годовой: годовой
голова: голову
горячий: горячей
гравитационнный: гравитационнными
гравитационный: гравитационного гравитационное гравитационный
гравитация: гравитации
гравитировать: гравитирующим гравитирующими
графический: графическую
давать: дает
дальнейший: дальнейшее
дальнодействующий: дальнодействующей
данные: данных
дать: даны
два: двух
двадцатилетний: двадцатилетнего двадцатилетних
двадцать: двадцать
действовать: действующей
дело: деле дело
десятилетие: десятилетия
десять: десять
детальный: детальный
детектор: детекторами
деформация: деформации деформаций
диапазон: диапазон диапазоне
дискуссия: дискуссий
диссертация: диссертации
дистанция: дистанция
добавка: добавки
долгий: долгое
должное: должное
должный: должны
доля: доля
доминировать: доминирующим
допустимый: допустимых
достаточно: достаточно
достаточный: достаточным
достаться: досталась
др: др
друг: друг другу
другой: другие
дуга: дуги
дыра: дыр дыра дыры
единственный: единственным
журнал: журнале
заинтересоваться: заинтересовался
заключительный: заключительном
заметно: заметно
замолвить: замолвите
зарегистрировать: зарегистрированные
звезда: звезд звездой звезды
звёздный: звездного звездной звездном звездных
земля: землей
знать: знаем
значительный: значительную
идти: идет
известно: известно
известный: известному известных
изменение: изменение
измерение: измерений
изображение: изображение изображения
израиль: израиля
израильский: израильском
изрядный: изрядной
изучение: изучение изучении
илл: илл
именно: именно
имя: имени
иначе: иначе
инициатор: инициатором
институт: института
инфлатон: инфлатон
инфлатонный: инфлатонного
информация: информацию
инфракрасный: инфракрасном
искажать: искажает
исключать: исключают
исключительно: исключительно
использовать: использовали использовать
исследование: исследования
источник: источником
исчерпать: исчерпавших
итог: итогам итоге итоги
какой: каких
камера: камерой
кампанас: кампанас
кандидат: кандидатов кандидаты
карлик: карлики
карликовый: карликовой карликовую
качество: качестве
квантовый: квантовых
кембриджский: кембриджского
классификация: классификацию
ковентри: ковентри
коллапс: коллапс
коллега: коллег коллеги
кольцо: кольца
комментарий: комментария
компактный: компактным
компонент: компонентом
конкретный: конкретные
консерват: консерваты
концепция: концепция
копия: копии
коричневый: коричневые
короткодействующий: короткодействующих
космический: космической космическом
космологический: космологическим космологических космологической
космология: космологии космологию
который: которая которой котором которые который которых
кпк: кпк
краткость: краткости
кроме: кроме
крупный: крупного
ласа: лас
левин: левин
лежать: лежащих
либо: либо
лишить: лишен
локальный: локальные
любой: любом любые
лёгкий: легких
магелланов: магелланова магелланово магеллановом магеллановых
маловероятный: маловероятно
малое: малого
малый: малые
мария: мария
масса: масс масса массами массе массой массы
массивный: массивного массивных
масштаб: масштабам
материальный: материальных
материя: материей материи материю материя
международный: международным
менее: менее
метрика: метрики
метровый: метровой
микролинзирование: микролинзирование микролинзирования
миллиард: миллиардов
минимум: минимум
мироздание: мироздания
млечный: млечного
многократно: многократно
многолетний: многолетний
модель: модель моделью
мозаичный: мозаичной
мониторинг: мониторинг
мочь: могли могут
мруз: мруз
мруза: мруза
наблюдаться: наблюдаться
наблюдение: наблюдение наблюдений наблюдения наблюдениях
назад: назад
назвать: назван
называть: называемые называемых
найти: найти
наличие: наличие
например: например
насколько: насколько
настоящий: настоящему
начало: начала начале
начальный: начальных
наш: наше нашей
невидимый: невидимые
невозможно: невозможно
недавно: недавно
нейтрино: нейтрино
нейтронный: нейтронные
некоторый: некоторые
немалый: немалый
ненайденный: ненайденные
нерелятивистский: нерелятивистской
несколько: нескольких несколько
нескучный: нескучная
несмотря: несмотря
нетривиальный: нетривиальным
никак: никак
новый: новые
норвежский: норвежскому
носитель: носителей
оба: обоих
облако: облака облаке облако облаков
обнародовать: обнародованные
обнаружить: обнаружено обнаружены обнаружить
обнулять: обнуляют
образоваться: образовавшиеся
обратиться: обратились
обсерватория: обсерватории
общий: общей
объект: объект объектами объектом
объяснить: объяснил
объясняться: объясняться
обычный: обычного
обязательно: обязательно
огромный: огромных
один: одного одной одну
однако: однако
ожидать: ожидать
оказаться: оказаться
около: около
определить: определена
определяться: определяется
определённый: определенных
оптический: оптические оптических
опубликовать: опубликовала опубликовали
ослабнуть: ослабла
оснастить: оснастили
основание: основанием
основать: основанные
особый: особым
остаться: оставшиеся
осуществляться: осуществляется
отбор: отбора
отдать: отдадим
отдел: отдела
отклонение: отклонения
отклонять: отклоняет
открытие: открытия открытиями
открытый: открытой
открыть: открыли
отличие: отличие
оценка: оценки
очень: очень
пальма: пальма
пачинский: пачинского пачинскому
первенство: первенства
первичный: первичные первичных
первый: первого
перейти: перейдем
переменный: переменных
пзс: пзс
планета: планет
плотность: плотности
плюс: плюс
погрешность: погрешностью
подобный: подобных
подтверждение: подтверждение
подчеркнуть: подчеркнуть
позволять: позволяют
поздний: позже
поиск: поиск поиска
пока: пока
показать: показали
показывать: показывает показывают
полагать: полагало
поле: полей поля
получить: полученное
польша: польша польши
помимо: помимо
помощь: помощью
понимать: понимают
поныне: поныне
поперечник: поперечник
популяция: популяции
порядок: порядка порядку
последний: последние
последовательность: последовательности
последующий: последующих
послезвёздный: послезвездные послезвездных
посредством: посредством
поток: потока
практика: практике
практически: практически
превышать: превышает превышать
предложить: предложил
предмет: предмет предметом
предсказывать: предсказывают
представить: представлен
претерпеть: претерпевших
пржемек: пржемек пржемека
приблизительно: приблизительно
прибор: приборов
привести: привел
приз: призом
признанный: признанная
прийти: пришла
применяться: применялся
пример: примеры
примерно: примерно
принстон: принстона
природа: природа
прислать: пришли
присутствие: присутствие присутствием
присутствовать: присутствуют
приход: приходы
проверка: проверки
проверяться: проверялись
провести: проведен
проводиться: проводились
продолжать: продолжает
продолжительность: продолжительности
проект: проект проекта проекту
пройти: прошли
промежуточный: промежуточной
пространство: пространства пространстве
профессор: профессора профессору
процент: процентов
проявить: проявить
публикация: публикации
пустыня: пустыне
путь: пути
пять: пять
пятьдесят: пятидесяти
пёс: пса
пётр: петру
равный: равна
различить: различить
размножать: размножает
разработать: разработанный
разрешение: разрешения
разумеется: разумеется
рамка: рамках
ранний: ранней ранние
расположить: расположена расположенной расположенным расположенными
рассматриваться: рассматриваться
рассмотреть: рассмотрела
расстояние: расстояние
растянуться: растянулись
расширить: расширить
раунд: раунда раундов
реально: реально
реальность: реальности
результат: результат результате результаты
реликтовый: реликтовые реликтовых
ресурс: ресурсов
рефсдалу: рефсдалу
реховот: реховоте
речь: речь
род: рода
рождение: рождение
руководство: руководством
ряд: ряду
сам: сами самого
самостоятельный: самостоятельная
самый: самые самых
сателлит: сателлитом
сверхмассивный: сверхмассивной
сверхплотный: сверхплотных
свет: свет света
светило: светила
световой: светового световых
свой: свое своего своей своим
своуп: своуп
связанный: связанные
связать: связано
сгущение: сгущений
сделать: сделать
сегмент: сегмента
секунда: секунду
семнадцать: семнадцатью
сигнал: сигналов сигналы
сила: сил
сильно: сильно
сильный: сильные
скажем: скажем
скопление: скоплении
скорее: скорее
слабый: слабых
следующий: следующих
слишком: слишком
слияние: слияний
слово: слово
служить: служит
случай: случае
случиться: случится
смехотворный: смехотворное
смотреть: см
собранный: собранных
собственный: собственный
событие: событий события
совместить: совмещенных
современный: современная современного
согласно: согласно
согласоваться: согласуется
созвездие: созвездии
создавать: создавая создает
солнечный: солнечной солнечных
солнце: солнца
сообщество: сообществом
состав: состав составе
составлять: составлять
состоять: состоит состояла
сотый: сотой
сохранить: сохранили
спектр: спектр
специалист: специалистов
специально: специально
спутник: спутника
стабильность: стабильность
стабильный: стабильных
стандартный: стандартная стандартной
статистический: статистический
стать: стал стало
статья: статье статьи
сто: сто
столкновение: столкновениями
структура: структуре структуры
судить: судя
суммарный: суммарная
существование: существование существовании существования
существовать: существуют
считать: считали
сюра: сюру
также: также
таковой: таковое таковые
такой: такие таких
телескоп: телескоп телескопа телескопе телескопом
тема: тема
теория: теории теорий
термин: термином
термояд: термояд
термоядерный: термоядерное
топливо: топливо
тот: те тех
трата: трату
третий: третьего
три: трех
тусклый: тусклые
тысяча: тысячу
тяготение: тяготения
тёмный: темная темной темную
увеличение: увеличение
увеличивать: увеличивает
увеличить: увеличенные
увенчаться: увенчался
удалить: удалено
удальский: удальского
удалённый: удаленную
удаться: удалось
университет: университета университетом
уорикский: уорикского
условие: условий условиях
усомниться: усомниться
успешно: успешно
установить: установлена
установленный: установленный
участник: участники
учесть: учесть
учёный: ученые
физика: физики
физический: физическая
фильтр: фильтры
финансовый: финансовых
флуктуация: флуктуаций
фоновый: фоновой
фотометрический: фотометрических
фотон: фотонов
характерный: характерное
хилла: хилл
ход: ходе
холодный: холодной холодный
цель: цель
центр: центр центра центры
частица: частиц частицах
часть: часть
человеческий: человеческих
честь: честь
четвёртый: четвертого
чилийский: чилийской
чиповой: чиповой
что: чему
чёрный: черная черной черные черных
чётко: четко
широкий: широкий
эволюция: эволюции
эйнштейновский: эйнштейновские
энергия: энергией энергии энергия
эпоха: эпохи
это: этим
этот: эта этих
этюд: этюды
эффект: эффект эффекта эффекты
южный: южной
яркость: яркости яркость яркостью
