автоматический: автоматическая
агентство: агентства
активно: активно
активный: активное активные
акция: акции
алай: алая
алексей: алексей алексею алексея
альтернатива: альтернативы
амс: амс
анализатор: анализатор
антихвост: антихвост
аппарат: аппарат аппарата
аппаратура: аппаратуры
апрель: апреле апреля
астероид: астероиде астероидов
астронавтика: астронавтики
астроновость: астроновости
астроном: астрономов астрономы
астрофотограф: астрофотографу
атака: атакой
атлас: атласа
бар: бара
батарея: батарей
белый: белого белый
бенна: бенну
блеск: блеска
близкий: близкую
близко: близко
богатство: богатстве
большинство: большинство
борт: борту
брильянт: брильянтами
буря: бури
бутылка: бутылке
быть: будут
вблизи: вблизи
ве: ве
венера: венеру
весь: весь всем
весьма: весьма
ветер: ветра
вечерний: вечернем
вещество: вещества вещество
взгляд: взгляд
взрыв: взрывы
вид: виде видов
видимый: видимой
видный: виден видна
включать: включает включающая
влияние: влияние влиянию
влиять: влияет
внешний: внешних
внимание: внимание
внутренний: внутренние внутренними внутреннюю
внутри: внутри
возле: возле
возможный: возможным
возникать: возникает возникающего
вокруг: вокруг
волопас: волопаса
вооружение: вооружении
вояджер: вояджер
вращательный: вращательную
вращаться: вращается
время: времени время
вселенная: вселенной
вспышка: вспышка вспышками вспышкой вспышку
встречаться: встречаться
второй: второго второй
выбор: выбора
выбрать: выбраны
выбросить: выброшенных
выделяться: выделяется
выдержка: выдержки
вызывать: вызывает
выразить: выражена
высокий: высокого
газ: газа
газовый: газового
галактика: галактик галактика галактике галактики
галактический: галактического галактическое
геометрически: геометрически
гигант: гигантов
гигантский: гигантского
гигапиксель: гигапикселей
глаз: глаза глазом
глубина: глубину
год: год года лет
голова: голова
гораздо: гораздо
горячий: горячей
гравитационный: гравитационному гравитационных
градус: градуса
грандиозный: грандиозным
группа: группой
далёкий: далеких
данные: данным данных
данный: данный
дать: данные
два: две двух
движение: движение
двойной: двойной двойные двойных
девять: девять
действие: действие
делать: делать
деталь: детали
джеймс: джеймса
диапазон: диапазонах диапазоне
динкинеш: динкинеш
диск: диск диска диском
длительный: длительное
довольно: довольно
должный: должно
дополнительно: дополнительно
достаточно: достаточно
достаточный: достаточного
достигать: достигают
доступ: доступ
др: др
древний: древнейший
другой: другим других
дыра: дыре
евклид: евклид евклида
европа: европа европе европы
европейский: европейского
жизнь: жизни
журнал: журнале
завершать: завершает
загадка: загадку
закат: заката
заключаться: заключается
заметить: заметить
заметный: заметными
запечатлеть: запечатлена запечатлены запечатлеть
запланировать: запланированных
заполнить: заполненные
заполонить: заполонили
запуск: запуск
запустить: запущен
затухать: затухают
зафиксировать: зафиксирована зафиксировать
звезда: звезд звезда звезды
звездообразование: звездообразования
звёздный: звездного
земля: земле землей земли земля
значимый: значимым
значительный: значительное
зонд: зонд зонда
зондирование: зондирования
идеальный: идеальное
известный: известна известный известных
излучение: излучение излучения
измерять: измерять
изображение: изображение изображения
изучение: изучении изучения
изучить: изучит изучить
иметься: имеется
имхотёпа: имхотепа
имя: имена
инструмент: инструмент инструментов
интересный: интересные
информация: информацию
ио: ио
исследователь: исследователей
исследовать: исследовать исследует
итог: итоге
июль: июле
кадр: кадр кадров
калибровка: калибровку
камень: камней
камера: камеры
карлик: карлик карлика
карликовый: карликовая карликовой
карта: карты
картографический: картографический
кассинь: кассини
каталог: каталог
квадратный: квадратных
квазар: квазар квазаров
класс: класса
классифицировать: классифицированной
колдуэлла: колдуэлл
количество: количества
кольцеобразный: кольцеобразные
кольцо: кольца кольцо
команда: командой
комета: комета кометы
компания: компанией
конгресс: конгресса
конец: концами
конечный: конечном
конский: конская
концентрация: концентрации концентрация
корабль: корабля
корона: короне
корональный: корональные
короткий: короткий коротким
космический: космический космическим космических космического
космология: космология
космос: космос
который: которая которого которые который которых
кривая: кривая
крупный: крупная крупных
кудрить: кудря
кусочек: кусочка
кэв: кэв
лагранж: лагранжа
ледяной: ледяного ледяной
либо: либо
линзирование: линзированию
лишь: лишь
лунный: лунное
любитель: любителей
магелланов: магелланово магеллановом
магнитный: магнитного магнитных
магнитометр: магнитометр
маленький: меньше
малый: малое малой малом
манёвр: маневров
марс: марс марса
марсианский: марсианский
март: марта марту
масса: масс массы
материя: материи
медиа: медиа
международный: международного международной
межпланетный: межпланетная межпланетных
мелкий: мельчайших
менее: менее
место: место
милан: милане
мир: миром
миссия: миссии миссий миссиями
млечный: млечного млечном
мнение: мнению
многий: многих
многоволновый: многоволновая
многое: многом
многообещающий: многообещающих
множество: множество
мозаика: мозаика мозаики
молодой: молодые молодыми
момент: момент
наблюдать: наблюдает
наблюдение: наблюдений наблюдения наблюдениям наблюдениях
название: название
накопление: накопления
наличие: наличие
направить: направлен направленного
направиться: направится
нарушать: нарушающие
насколько: насколько
наслать: нашли
научный: научная научное научной научный
находиться: находится находиться находящееся
начинаться: начинается
начинка: начинка
наш: нашего нашей нашем
небесный: небесной
небо: неба небе
небольшой: небольшого
невозможно: невозможно
невооружённый: невооруженным
недавний: недавнего
неделя: недели недель
немногочисленность: немногочисленность
необычайно: необычайно
необычный: необычна необычное
непосредственно: непосредственно
непохожий: непохожая
неправильный: неправильная
несколько: нескольких
нижний: нижней
новосибирск: новосибирска
новосибирский: новосибирскому
новый: новая новое новой новый новых
номер: номера
ночь: ночь
ноябрь: ноября
обещать: обещают
обзор: обзора
облако: облаке облако
область: областей области область
облик: облик
обнаружить: обнаружен обнаружена
обозначать: обозначают
обозначение: обозначением
обработать: обработать
обработка: обработка
обсерватория: обсерваторий
общий: общая
объект: объект объекта объектов
обычный: обычных
огромный: огромная
один: одним одного
однако: однако
ожидать: ожидали
оказывать: оказывают
океан: океан океана
около: около
окружить: окруженной
октябрь: октября
оповещение: оповещения
определить: определили определит
оптический: оптическом оптическому
опубликовать: опубликована опубликованного опубликованным опубликованных
орбита: орбиты
ориентация: ориентацию
основный: основная
особенность: особенности особенность
оставаться: остаются
осуществить: осуществленный
ответственный: ответственная
отличие: отличие
относительно: относительно
отправляться: отправляется
охватить: охватить
очень: очень
панель: панели
панцирь: панциря
пенсильвания: пенсильвания
первый: первая первого первую первые первый
перенос: переносу
пересекать: пересекает
переход: переход
перигелий: перигелия
период: периодом
персея: персея
петля: петли
пингвин: пингвин
пионер: пионер
плазменный: плазменный
плоскость: плоскости
площадь: площадь
поверхностный: поверхностной
поверхность: поверхности поверхность поверхностью
повреждать: повреждая
повышенный: повышенная повышенное
подверженный: подвержены
подлёдный: подледный
подобный: подобные подобных
подошва: подошве
подробность: подробностях
подтвердить: подтверждена
подчёркивать: подчеркивают
позволить: позволит позволят
поиск: поисках
пока: пока
покров: покров
поле: полей
полмиллиона: полмиллиона
полностью: полностью
получать: получать
получить: полученные получила получить
поляк: поляков
поляков: полякова полякову
полёт: полет
помимо: помимо
помощь: помощью
пончик: пончик
попадать: попадает
портрет: портреты
поскольку: поскольку
послание: послание
поток: потоки
поэтому: поэтому
появляться: появляются
правило: правило
практически: практически
превышать: превышает
предел: пределами
предоставить: предоставлены
предполагать: предполагает
представитель: представители
представить: представили
представление: представление
представлять: представляет
преобладать: преобладают
препятствие: препятствий
приближение: приближении
прибор: прибор
прибыть: прибудет прибыл
привлекать: привлекают
признак: признаков
пример: пример примеров
принимать: принимая
прислать: прислал
проблема: проблемы
провести: проведенные
продемонстрировать: продемонстрировать
проект: проекта проектом
производить: производить
происходить: происходят
пролетать: пролетая
промежуток: промежуток
проникновение: проникновения
простираться: простираются
простой: проще
противоположный: противоположен
профессиональный: профессиональных
прохождение: прохождения
путь: пути
пылевой: пылевого
пыль: пыли
пятый: пятый
работа: работу
рабочий: рабочем
радар: радар
развернуть: развернутом
размер: размеров
разрешение: разрешения
рамка: рамках
расположение: расположения
расположить: расположенная расположенной
распределение: распределение
расстояние: расстоянии
расширение: расширение расширения
ребро: ребра
редкий: редкая редкого
результат: результате
рекорд: рекорд
рентгеновский: рентгеновского рентгеновское рентгеновской рентгеновском
рукав: рукавами рукавов
руководство: руководством
рыба: рыбах
сад: сад
сам: сами
самый: самая самых
световой: световых
свечение: свечения
свидетельствовать: свидетельствует
свой: своей
себя: собой
северный: северной
седьмой: седьмой
секунда: секунд
сеть: сети
сила: силу
сильный: сильны
симметрия: симметрию
синтез: синтез
система: система системах системе системой системы
скопление: скопление скопления скоплениями
скорость: скорость
слабо: слабо
слабый: слабую
сложнеий: сложнеие
смотреть: см
снимок: снимке снимки снимков
снять: снять
собирать: собирали
собрать: собрал собрана
событие: событий события
современный: современная
содержать: содержит
созвездие: созвездии
создавать: создаваемого
создать: созданных
солнечный: солнечного солнечной солнечные солнечных
солнце: солнца солнце солнцу
солёность: соленость
сообщество: сообщество
сообщить: сообщили
соседний: соседней
состав: состав
состояние: состояние состоянии
состоять: состоит
сохранять: сохранять
социальный: социальные
спектрограф: спектрограф
спектрометр: спектрометр
специалист: специалистами специалисты
спиральный: спиральная спиральными спиральных
способный: способен
способствовать: способствуют
спровоцировать: спровоцировать
спутник: спутника спутнике спутники спутнику
сравнимый: сравнимым
сразу: сразу
среди: среди
становиться: становится
станция: станция
стать: стал
статья: статье статья
столкновение: столкновении
сторона: сторону
страница: страница
структура: структуру
судьба: судьба
тайна: тайны
также: также
такой: таких
текущий: текущий
телескоп: телескоп телескопа телескопов телескопом
тело: тел
температура: температуре
тепловизор: тепловизор
термоядерный: термоядерный
тестовый: тестовый
течение: течение
толстяк: толстяк
толщина: толщину
точка: точке точки
трансляция: трансляции
три: трех
трио: трио
трёхмерный: трехмерного
туманность: туманность
тусклый: тусклые
тёмный: темной
увеличить: увеличенные
увидеть: увидеть
удаться: удалось
ультрафиолетовый: ультрафиолетовом ультрафиолетовый
умеренный: умеренной
университет: университета
уникальный: уникальный уникальных
условие: условиях
успеть: успели
участник: участниками
учёный: ученых
уэбба: уэбб уэбба
форма: форме форму
формироваться: формируются
фото: фото
фотография: фотографии
хаббл: хаббл
хаббнуть: хаббла
характеристика: характеристики
хаябуса: хаябуса
хвост: хвоста хвостам хвостов
хеопс: хеопс
художественный: художественное
цель: цель
центр: центре
центральный: центральной
цзыцзиньшань: цзыцзиньшань
частица: частиц
часто: часто
часть: часть
человек: человек
чрезвычайно: чрезвычайно
чувствительный: чувствительные
чёрный: черной черные
шаровой: шаровое
штат: штата
эволюция: эволюцию
экзосфера: экзосферы
экранирование: экранирование
эксперимент: эксперимента
эксперт: экспертов
энергия: энергии энергию
этот: эта
южный: южного
юпитер: юпитера
явление: явление
ядерный: ядерные
ядро: ядра ядро
яйцо: яйцом
яркий: яркая яркие ярких яркой ярок
ярко: ярко
яркость: яркости
