ага: ага
александр: александра
альтернатива: альтернатива альтернативы
андрей: андрей
анекдот: анекдот
астрономия: астрономии
астрофизический: астрофизическом
база: базе
безнадёжность: безнадежность
беседа: беседа
бить: бьет бьющих
благоприятный: благоприятен
блазар: блазар блазара блазарами блазаров
близкий: близкими близок
близко: близко
близлежащий: близлежащий
блондинка: блондинку
боковой: боковое боковых
больший: большая большие больших большую
большой: большое
борис: борис борисов борисом
борода: борода
борт: борту
брать: бери брать
быстро: быстро
быть: будем будут
важно: важно
вариант: вариант вариантов
вбок: вбок
вверх: вверх
ведущий: ведущим
везде: везде
вектор: вектор
величина: величина величину величины
верно: верно
вероятность: вероятность
версия: версию
вертикаль: вертикали
весь: весь
ветвь: ветвь
ветер: ветер
вещь: вещь
взаимодействие: взаимодействия
взрыв: взрыв
взять: взяли взять
видеоверсия: видеоверсия
видеть: видел видеть видим видят
видимо: видимо
видно: видно
висячий: висячие
влево: влево
влияние: влияние
вместе: вместе
вне: вне
внезапно: внезапно
внеземной: внеземной
возиться: возилось
возможный: возможный
войда: войд
вокруг: вокруг
вообще: вообще
вопрос: вопрос вопросы
восхождение: восхождение
вплоть: вплоть
вполне: вполне
вправо: вправо
вращение: вращения
вредить: вредит
время: временем времени время
вроде: вроде
врубиться: врубился
вселенная: вселенной
всплыть: всплыть
вспыхивать: вспыхивает
всё: всё
вторичный: вторичный
второй: вторых
входить: входит
выборка: выборки выборку
выделить: выделить
выдуваться: выдувается
вызывать: вызывая
выпадать: выпадает
выражать: выражаемую
высокий: высокий высоким высоких высокое высокой
высотный: высотный
выше: выше
газета: газеты
галактика: галактик галактике галактики
галактический: галактические галактический галактическое
гало: гало
гамма: гамма
гарантия: гарантия
гектар: гектар гектары
гипотеза: гипотезы
главный: главным
глядеть: глядишь
говорить: говорим говорить
говориться: говорится
год: годы
гораздо: гораздо
горизонталь: горизонтали
градиент: градиент
градус: градуса
грядущий: грядущие
гс: гс
гэв: гэв гэва
гэвной: гэвной
гэвный: гэвный
давать: дает
далее: далее
далеко: далеко
дальнейший: дальнейшего
далёкий: далеких дальше
данные: данными данных
данный: данного данном данный
дать: данные даст дать
два: две
действительно: действительно
делать: делать
дело: деле
день: день
деньга: денег
десятикратный: десятикратную
десятка: десятки
десятый: десятая десятых
детектор: детектор
джет: джет джета джетом джеты
диапазон: диапазон диапазоне
динозавр: динозавра
добрый: добрый
довольно: довольно
долгота: долготой
должный: должен должно должны
доля: доли
дополнительный: дополнительные
допустить: допустим
достаточно: достаточно
достигнуть: достичь
достоверность: достоверность достоверностью
доступ: доступе
друг: другом
другой: другими других другое другому
думать: думаю
дыра: дыр дыра
единственный: единственный
ждать: ждать
железный: железное
зависеть: зависит
зависимость: зависимости
заворачивать: заворачивает
заговаривать: заговаривают
задавать: задавал
задать: задал
задача: задач
задействовать: задействованы
задержка: задержка задержки задержку
заинтересовать: заинтересовать
закончить: закончены
замагнитить: замагниченные
запланировать: запланировать
заполнить: заполнено
заполнять: заполняющее
запускать: запускать
запустить: запустить
зарядить: заряженных
засечь: засечь
зеркало: зеркала
знать: знаем знает знаю
значимость: значимость значимостью
значимый: значимое
значит: значит
зрение: зрения
игорь: игорем игорь
идея: идеи идей идея
идти: идет идут
излучать: излучает
излучение: излучения
измениться: изменился
измерение: измерения измерениям
измеримый: измеримая измеримую
измерить: измерить
изобретать: изобретать
именно: именно
иметь: имеет имеют
импульс: импульс
иначе: иначе
институт: института институтом
инструмент: инструментов
интервью: интервью
интересный: интересна интересный
инфляция: инфляции
инфракрасный: инфракрасном инфракрасным
искать: искали искать ищем
использовать: использовали
испускать: испускает
исследование: исследований исследования
истинный: истинного
источник: источник источника источниками источниках источники источников источнику
исхитряться: исхитряются
ияи: ияи
какой: какие каких какого какое
кандидат: кандидат кандидатов
карло: карло
карта: карта
каталог: каталога каталоге
качать: качай
квадратный: квадратный
квазар: квазаров
квант: квант кванты
квантовый: квантов
кварк: кварки
кидать: кидай
киловольт: киловольты
килоэлектронвольт: килоэлектронвольт
китаец: китайцев китайцы
клякса: кляксы
колебаться: колеблются
коллаборация: коллаборацией
коллега: коллегами
комментарий: комментария
комптон: комптон
конвертироваться: конвертируются
конец: конце концов концы
координата: координат
копать: копаем копать
космический: космическим космических космической
космологический: космологическом
который: которая которое котором которому которую которые который которых
край: крае
крайний: крайней
крик: крик
кроме: кроме
круг: круг круге
круглый: круглыми
кругом: кругом
кубический: кубическом
кузнецов: кузнецовым
кусенко: кусенко
куча: куча
лацертид: лацертидами лацертиды
легко: легко
лежать: лежит
летать: летают
лететь: летит летят
линия: линиям
любой: любом
магнитный: магнитного магнитное магнитном магнитные магнитных
макс: макса
максим: максим
маленький: мала маленькая маленький меньше
мало: мало
масштаб: масштабе
материя: материя
медленно: медленно
межгалактический: межгалактические межгалактического межгалактическое межгалактическом
мейнстрим: мейнстрима
менее: менее
менять: менять
меняться: менялась
мера: мере
метод: метод методами методов методом
метр: метр
механизм: механизмы
минута: минут
мир: мир миру
михаил: михаилом
модель: модели
модифицировать: модифицировать
монт: монте
мочь: могло могут можем
мощный: мощный
мпк: мпк
мы: нам
мэв: мэвы
наблюдать: наблюдать
набрать: набрал
наверняка: наверняка
навскидку: навскидку
надеяться: надеюсь
найти: найдем
наногаусс: наногаусс
напоминать: напоминает
направить: направлен
направление: направление направлении
например: например
напросто: напросто
наслать: нашли
натолкнуть: натолкнуло
наука: наука
научный: научным
находить: находишь
начальный: начальный
начать: начали
начинать: начинаешь
наш: наша нашего нашей
нащупать: нащупать
нгс: нгс
небо: небе небес
небольшой: небольшой
неважный: неважной
недалёкий: недалекими
неидентифицировать: неидентифицированные
нейтринный: нейтринной
нейтрино: нейтрино
некий: некий
некоторый: некоторых
немного: немного
немножко: немножко
немой: нем
неоднозначный: неоднозначные
неоднородный: неоднородным
неопределённость: неопределенности
непонятно: непонятно
непонятный: непонятна
неприятный: неприятная
нерон: неронов
несколько: несколько
нескучный: нескучная
несмотря: несмотря
нечто: нечто
ниже: ниже
низкий: низким
никак: никак
никакой: никакие никаких никакой
ничтожно: ничтожно
ничтожный: ничтожное
новый: новая новом
нормальный: нормальный
нужно: нужно
нужный: нужного
нуклон: нуклоны
область: области
обмануть: обмануть
обнаружить: обнаружили
образ: образ образа образов образы
обрезание: обрезания
обрести: обрели
обсерватория: обсерватории обсерваторий обсерватория
общепринятый: общепринятой
общество: общества
общий: общем
объединяться: объединялись
объект: объект объекта объектами объектов объекты
ограничение: ограничение ограничениям
ограничиваться: ограничиваться
огромный: огромная огромном огромный
один: одна одну
одинаково: одинаково
однозначный: однозначный
ожидать: ожидать
оказаться: оказались оказалось
около: около
оно: оно
определение: определении
опровергнуть: опровергли
опровержение: опровержении
оптимально: оптимально
оптический: оптическим оптического оптическом
опубликовать: опубликуем
орбитальный: орбитальные
ориентация: ориентации
особо: особо
оставаться: остаются
остаться: осталось
отбирать: отбирать
отбросить: отбросили
отклонение: отклонения
отклонять: отклоняет
открытие: открытий
открыто: открыто
открытый: открытом открытые
открыть: открыли открыт
откуда: откуда
относительно: относительно
отобрать: отобрали
отсюда: отсюда
оттуда: оттуда
отыскать: отыскать
официальный: официальном
оцениваться: оценивается
оценка: оценка оценки
очень: очень
ошибка: ошибка ошибки
павлинский: павлинским
память: памяти
пара: пара пару пары
параметр: параметры
первый: первая первый первых
перебросить: перебросивший
передний: переднем
перерассеиваться: перерассеиваются
переход: переходы
перспектива: перспективы
плазма: плазмы
планироваться: планируются
планк: планка
плоскость: плоскости
плотность: плотности
плохой: плохое плохой хуже
площадь: площадь
повлиять: повлиять
повод: поводу
повозиться: повозиться
поворачиваться: поворачивается
поглотить: поглощены
подбирать: подбирая
подробно: подробно
подсказать: подсказать
подталкивать: подталкивает
подходящий: подходящие подходящий
пожалуйста: пожалуйста
позитрон: позитрон
позитронный: позитронную
поиск: поиска поисках
пойти: пойдет
пока: пока
показать: показали показано
поколение: поколении
поле: поле полей полем поля полях
полениться: поленились
полно: полно
полностью: полностью
полный: полная
половина: половина половину
положение: положения
получаться: получается
получить: получив получить
получиться: получится
полчаса: полчаса
поляризация: поляризации
поляризовать: поляризованное
помнить: помнит помню
помощь: помощью
понятно: понятно
попадать: попадает попадают
попросту: попросту
попутный: попутный попутных
попытаться: попытались
порог: порог порогом
породить: породивший
порфирион: порфирион
порядок: порядки порядков
поскольку: поскольку
посмотреть: посмотреть
построить: построенный
посчитать: посчитал
похоже: похоже
почему: почему
поэтому: поэтому
появиться: появилась появилось появиться
предел: пределами
препринт: препринт
прибор: прибора
придумать: придумаешь придумали
прийти: пришла
прийтись: придется
прикидка: прикидка
прилететь: прилетевших прилетела прилетели прилетело
приличный: приличная
примерно: примерно
принадлежать: принадлежит
принцип: принципе
прислать: пришли
приходить: приходят
причина: причина
причём: причем
проблема: проблему
проводить: проводить
проект: проект
происходить: происходит
происхождение: происхождения
промежуточный: промежуточный
пронзить: пронзил
пропустить: пропустили
простейшее: простейшие
просто: просто
простой: простой
пространство: пространстве пространство
протон: протонов
профиль: профиль
прямо: прямо
прямой: прямое
пускай: пускай
путь: путь
пучок: пучком
пётр: пётр
работа: работа
работать: работает работают
равно: равно
радиоизлучение: радиоизлучение
разбираться: разбираться
развернуться: развернется
развитие: развития
разговаривать: разговариваем
разговор: разговор разговоры
размытый: размыт размытые размытый
разность: разность
разный: разному разные разных
разрешение: разрешение разрешением разрешения
ран: ран
ранний: ранней
рано: рано
расплывание: расплывание
расползание: расползания
расползаться: расползаться
распределение: распределение
рассеяние: рассеяния
рассеянный: рассеянные
расследовать: расследовать
раствор: раствора
расти: расти
расщепляться: расщеплялись
рг: рг
реагировать: реагирует реагируют
реально: реально
реальный: реальные реальный
регистрация: регистрации
регистрировать: регистрирует
редактор: редактором
результат: результат результате результатов результаты
реликтовый: реликтового реликтовое реликтовых
рентген: рентген
рентгеновский: рентгеновские рентгеновский
рецепт: рецепт
рис: рис
ровно: ровно
родить: родить
рождать: рождая
рождение: рождение
российский: российским
рубаков: рубакова
сам: самого самой самом
самообман: самообмана
самый: самое самую самые самый самым самых
сантиметр: сантиметре
свежий: свежие
сверхвысокий: сверхвысоких
сверху: сверху
свет: светом
светить: светит светят
свой: своим
связать: связан
сдвиг: сдвиг
сдвигать: сдвигает
сделать: сделаем сделать сделают
сеть: сети
сигнал: сигнал
сильно: сильно
сильный: сильный
систематик: систематика
систематический: систематическая
скажем: скажем
сказать: сказал сказать
склонение: склонение
скопление: скопление
скорее: скорее
слабо: слабо
слабый: слабые
слева: слева
слегка: слегка
след: след
слишком: слишком
сложно: сложно
сложный: сложный
случай: случае
сместить: смещен смещенный смещены
смещение: смещение смещений смещения
смеяться: смеется
смотреть: см смотрим смотрит смотрите смотрят
смысл: смысла
снизу: снизу
совершенно: совершенно
совпадать: совпадает
сожаление: сожалению
соответствовать: соответствующий
состав: состав
состоять: состоящая
сотрудник: сотрудником
спектр: спектр
специально: специально
способ: способов
сравнивать: сравнивал
сравнимый: сравнимый
сразу: сразу
среди: среди
стадия: стадии
стандартный: стандартной
статистика: статистика статистики статистику
статистический: статистическая статистические статистической статистическую
стать: стали
статься: статься
статья: статью
столь: столь
сторона: сторону
странный: странный
струить: струи
суммарный: суммарная
суперпартнёр: суперпартнеры
суперсимметрия: суперсимметрия
существовать: существуют
сформировать: сформированной
счесть: сочли
съехать: съехавшим съехал съехали
также: также
такой: такие такими таких такого такое
текущий: текущее
телескоп: телескоп телескопа телескопов телескопом телескопы
тема: теме темой тему
теория: теории
тераэлектронвольт: тераэлектронвольта
территория: территории
тест: тесты
тиняк: тиняков
тип: типа
ткачёв: ткачев ткачёв ткачёвым
ток: ток
толкать: толкают
толчок: толчок
тот: те
точечный: точечного
точка: точку
точность: точности точность
точный: точной точным
трв: трв
три: трех
троицкий: троицкий
тщательно: тщательно
тэв: тэв
тэвный: тэвных
тянуться: тянущаяся
тёмный: темная
убедительный: убедительный
увеличивать: увеличивать
увеличить: увеличенную увеличенный
увидеть: увидели увиден увидеть увидим
угловой: угловая углового угловое угловой угловые угловых
угол: угла углу
удаваться: удается
удаться: удалось
удлинять: удлиняя
узкий: узким
узнать: узнать
улететь: улететь
ультравысокий: ультравысокой
ум: ум
уровень: уровня
успевать: успевают
успех: успехи
усреднить: усредненный
установка: установку
устранить: устранить
утверждать: утверждать
участвовать: участвовали
учесть: учли
фазовый: фазовые
физика: физика физики
филамент: филамент
фифть: фифти
флуктуация: флуктуации флуктуацию
фон: фон фона фоном
фоновый: фоновыми
фотон: фотон фотона фотонах фотоне фотонов фотоны
хватить: хватит
хороший: лучшая хорошая хороший
хотя: хотя
частица: частиц частица частицу частицы
частота: частотах
человек: людей люди
черенковский: черенковские черенковских
число: числа числами
чистый: чистая
чувствительный: чувствителен чувствительней
чудовищный: чудовищной
чёрный: черная черных
чёрт: чёрт
чёткий: четкая четких четкое
шанс: шансы
широкий: широком
широта: широта
штерн: штерн штерном
штука: штук
эв: эв
эксперимент: эксперимент эксперименты
электродинамика: электродинамике
электромагнитный: электромагнитные электромагнитный
электрон: электрон электроны
элементарный: элементарная
энергия: энергии энергий энергия
это: этим
этот: эта этих
эффект: эффект эффекта
эффективный: эффективная
ядерный: ядерный ядерных
ядро: ядер
яркий: ярких
