автор: автора
айсберг: айсберга
аккорд: аккорд
альпина: альпина
амбициозный: амбициозную
ан: ан
анализ: анализ
аналогичный: аналогичный аналогичных
аналогия: аналогии аналогия
аналоговый: аналоговую
англ: англ
антонио: антонио
арка: арки арок
аста: аст
банан: бананов
безошибочно: безошибочно
белок: белкам
бернс: бернс
бесполезный: бесполезны
бессемянный: бессемянные
бессубъектный: бессубъектен
бетховен: бетховен бетховена
биолог: биологов
биологизаторский: биологизаторским
биологический: биологических
биология: биологии биологию биология
большинство: большинстве большинству
большой: большой
борьба: борьбы
браться: берутся брались
броненосец: броненосцы
ван: ван
варвара: варвары
варка: варки
введение: введение
верный: верным
верхушка: верхушка
весь: всей
вещь: вещей
взгляд: взгляды
взять: взять
видимый: видимому
визуальный: визуального
вкладывать: вкладывал
вкус: вкуса вкусу
влияние: влиянием
вместе: вместе
вмещать: вмещает
внимание: внимание
внутри: внутри
возможно: возможно
возможность: возможность
возразить: возразит
воля: воли
вооружение: вооружение
воспроизведение: воспроизведение
воспроизвести: воспроизвести
воспроизводить: воспроизводит
воспроизводиться: воспроизводятся
впечатление: впечатление
вплоть: вплоть
вполне: вполне
вредный: вредны
время: времена времени время
вселенная: вселенной
вследствие: вследствие
встречать: встречает
встречаться: встречаются
вступать: вступают
всякий: всяком
всё: всё
входящий: входящего
выбирать: выбирает
вывести: выведенные
выделение: выделении
выживаемость: выживаемость
выживание: выживание выживания
вынуждать: вынуждает
выражение: выражения
вырвать: вырвать
высказать: высказал
высокий: высокую
выход: выхода
вычленение: вычленением
выше: выше
газзанига: газзанига газзаниги
гандикап: гандикапа
гвоздик: гвоздике
ген: ген гена генам генами генов гены
генерировать: генерирует
генетический: генетические
генный: генный
генофонд: генофонде
гибрид: гибридами
гипотеза: гипотезу
глава: главе
главное: главного
говорить: говорит говоря
год: год года году лет
голова: голове
голубеть: голубей
готовый: готов
губительный: губительна
гуманитарий: гуманитариев гуманитарии
гуманитарный: гуманитарные
дамасио: дамасио
данность: данность
дарвин: дарвин дарвина
дарвинист: дарвиниста
дарвиновский: дарвиновская
дарвиновый: дарвиновы
дать: данные
два: две
деваться: девается
девятый: девятой
действие: действии
действительно: действительно
декоративный: декоративное декоративных
делать: делаем
дело: деле дело
день: дни
держать: держать
десятов: десятовой
дикий: дикой
днк: днк
доводить: доводящей
доказательство: доказательством
докинз: докинзом
докинза: докинз докинза
долгий: долгого
должный: должно
домашний: домашней домашнем
допускать: допускал
допустить: допустить
достаточно: достаточно
достаточный: достаточной
досуг: досуга
друг: друг другом
другой: другие другое другому
евгений: евгением
европейский: европейские европейской европейскую
единица: единиц единица единицей единицы
елиферов: елиферовой
елифёров: елифёрова
естественный: естественного естественному естественные естественный естественным
животноводство: животноводство
животное: животные животным животных
жизнеспособный: жизнеспособной
жизнь: жизни жизнь
жёсткий: жесткая
забыть: забыть
задача: задачи
закрепиться: закрепилось
занимать: занимает
занятый: заняты
запись: записи
запоминаться: запоминается
заслуживать: заслуживает
заставлять: заставляет
затрагивать: затрагивает
затруднение: затруднения
захватить: захватившие
захотеть: захотели
захотеться: захочется
зачарованность: зачарованность
звукозапись: звукозаписи
значение: значение
золотой: золотой
зрение: зрения
зуб: зуб
идея: идее идеи идею
идти: идет идут
избыточно: избыточно
известно: известно
известный: известен
изменение: изменение
изображение: изображение
изобретение: изобретения
иллюзия: иллюзии иллюзию иллюзия
иллюзорный: иллюзорно
именно: именно
иметь: имеем имеет имеют
иметься: имеются
имитация: имитацией
империя: империю
имя: имени
иначе: иначе
интервью: интервью
интересный: интересной
интернет: интернет интернете
исключение: исключением
исключительно: исключительно
искусственный: искусственного искусственном искусственный
использовать: использован использовать
испытывать: испытывает
исступление: исступления
историк: историк
исходный: исходная
итог: итоге
каждый: каждая каждому каждый
казаться: казалось
каков: каково
какой: какое
карикатурный: карикатурные
качество: качестве
книга: книге книги
кнопка: кнопку
коллега: коллегам
комбинация: комбинация
комментарий: комментариев
комплекс: комплекс
компьютерный: компьютерная
конец: конце концов
конкретный: конкретных
конкуренция: конкуренцией конкуренции конкуренцию
конкурировать: конкурируют
который: которое которому которые который которым
крайний: крайней
красота: красоту
крестьянин: крестьяне
критика: критика
кролик: кролика
крупный: крупная крупной крупные
кудрявость: кудрявость
культура: культур культура культуре культурой культуру культуры
культурный: культурное культурных
кунин: куниным
легко: легко
лекция: лекциях
летучий: летучей
лишь: лишь
ложный: ложна
людвиг: людвиг
магнитофон: магнитофонов
майкл: майкла
мария: мария
маркер: маркерами
маскировать: маскирует
массовый: массовое
математический: математической
махровый: махровой
маяковский: маяковского
мелкий: мелкая мелкие
мелодия: мелодии мелодия
мем: мем мема мемами мемов мемом мему мемы
мемофонд: мемофонд
мера: мере
мериться: меряясь
место: места место
минимум: минимум
мир: мира
многовековый: многовекового
множество: множества
модный: модные
мозг: мозга
мопс: мопса
морда: морде
мочь: могли могут можем
музыка: музыка музыке музыки музыку
музыкальный: музыкальное
мысль: мысль
мыший: мышью
наблюдать: наблюдать
нагель: нагель
наглядный: наглядным
нажимать: нажимающего
название: названия
назвать: назвать
назойливость: назойливостью
называть: называемое называть
наличие: наличие
написание: написания
напомнить: напомним
например: напр например
нарост: наростах
население: населения
настолько: настолько
настоящий: настоящий
натолкнуть: натолкнуло
наука: наук наука науках науки
находить: находить
находиться: находится
наш: нашей нашем наши
невозможно: невозможно
недавний: недавнего
недавно: недавно
недоступный: недоступного
незамеченный: незамеченным
нейробиолог: нейробиологов
нейробиология: нейробиологии нейробиология
нейронаука: нейронаука
некий: некая
некорпускулярность: некорпускулярности
некоторый: некоторые
немало: немало
немалый: немалых
неокантианство: неокантианства
непарнокопытный: непарнокопытные
несомненно: несомненно
неточный: неточной
неудобный: неудобный
низкий: низкой
никакой: никакая
никуда: никуда
ниоткуда: ниоткуда
новый: нового новое новые
нога: ногой
нона: нон
нота: нот ноты
нравиться: нравится
ныне: ныне
образ: образом
образец: образец
обратить: обратили
обратно: обратно
обстоять: обстоит
обусловливаться: обусловливается
обучение: обучению
общественный: общественные общественных
общество: общества общество
объяснение: объяснение объяснения объяснениям
объяснить: объяснить
объяснять: объяснять
обычно: обычно
один: одного одной
однако: однако
означать: означает
оказаться: оказалось
оно: оно
операция: операций
описать: описать
описывать: описываемому
опознавать: опознаваемый
определить: определен
определённый: определенного
опыт: опыт опыта
организм: организмы
основание: основаниях
основательный: основательные
основный: основная
особый: особой
осознанный: осознанных
осознать: осознает
осуществляться: осуществляется
отбирать: отбирающего отбирающий отбирая
отбор: отбор отбора отборе отбором отбору
отвергать: отвергает
открытие: открытия
отмахиваться: отмахиваться
отменять: отменяет
отношение: отношения
отнюдь: отнюдь
оторвать: оторвать
отрицать: отрицал
отсутствие: отсутствие
очевидный: очевидно очевидным
очередь: очередь
пава: пава
павлин: павлина
параллель: параллели
пер: пер
перевернуть: перевернуло
переворот: переворот
передаваться: передаваясь
перефразировать: перефразируя
переходить: переходим переходя
печать: печать
плод: плоды
повлиять: повлиять
подобно: подобно
подобный: подобные
подражание: подражания
подразумевать: подразумевает
подхватывать: подхватывают
подчёркивать: подчеркивая
позволить: позволить
позиция: позиции
позывной: позывного
поинтересоваться: поинтересовался
пока: пока
полезный: полезного полезны
полностью: полностью
полова: половой
половой: половом
получить: полученные
польза: пользы
помощь: помощью
понадобиться: понадобилась
понятие: понятие понятия
попросту: попросту
попытка: попытки попыткой
пора: пор
порода: породы
породистый: породистые
порождение: порождение
порой: порой
порядок: порядок
последний: последнее последние последний последних
постоянно: постоянно
постройка: постройка
похлёбка: похлебки
почему: почему
поэтому: поэтому
появляться: появляются
предполагать: предполагает
предположить: предположил
предпочтение: предпочтения
представление: представление
пресволочный: пресволочнейшая
пресловутый: пресловутый
престиж: престижем
претензия: претензия
прибегать: прибегаю
привести: приведенной приведенные привести
привлекательность: привлекательностью
привлекательный: привлекательными привлекательных
привлекать: привлекающие
придать: придать
прижиться: прижилась
призвать: призванную
признак: признаки
применимость: применимости
применительно: применительно
пример: пример примера примерами примеров примером примеры
приносить: приносит
принцип: принципа
природа: природе природу
присутствовать: присутствует
притом: притом
причём: причем
приём: приему
пробирка: пробирке
проблема: проблема проблеме проблему проблемы
программа: программа
программист: программист
произведение: произведения
произойти: произошло
происходить: происходит
происхождение: происхождение
пройти: прошло
просто: просто
простота: простоты
противопоставлять: противопоставляя
процесс: процесс процесса процессу
прочитать: прочитал прочитать
психологический: психологической
птица: птиц птицы
пудель: пудели пуделя
путём: путем
пытаться: пытаются
пышный: пышный пышных
рабочий: рабочие
радиостанция: радиостанции
развитие: развития
разделение: разделение разделения
разделить: разделил
различать: различать
различимый: различимая
размножаться: размножаются
разный: разные
разобраться: разобраться
разрушать: разрушает
разумеется: разумеется
распространение: распространение
распространяться: распространяется распространяются
рассматривать: рассматривали
рассуждение: рассуждения
растение: растений растения
растениеводство: растениеводство
реальность: реальности
реальный: реального
ред: ред
редуцировать: редуцируют
режим: режиме
репликатор: репликаторы
репликация: репликации
реплицировать: реплицировать
речь: речь
решение: решение
римский: римские римскую
рис: рис
ричард: ричард ричарда
рнк: рнк
родиться: род
рождение: рождения
рыбка: рыбки
сам: сама сами само самом саму
самец: самцам самцов
самка: самки самок
самовосприятие: самовосприятии
самокопирование: самокопированием
самокопироваться: самокопирующийся
самый: самые самый самых
свобода: свобода
свой: свое своей своему своим своих
свойство: свойства
сгенерировать: сгенерировал
себя: собой
серьёзный: серьезна
сигнал: сигнала
симфония: симфонии симфония
сколько: сколько
словесный: словесному
словечко: словечки
слово: слово словом
сложный: сложный
служить: служат служить
случай: случае случаев случаях
случайно: случайно
слушать: слушать
смотреть: см смотреть
смысл: смысле
снимать: снимает
собака: собак
соблазнительность: соблазнительности
собственно: собственно
совершить: совершить
современный: современного
соединить: соединил
создать: созданная
сомнение: сомнения
сообщать: сообщает
сооружение: сооружения
соответствовать: соответствует
сортовый: сортовые
составлять: составляют
состояние: состоянии
состоять: состоит состоящий
сочинение: сочинения
сочинять: сочиняет
сочувствие: сочувствия
сперматозоид: сперматозоидов
спешить: спешат
способ: способы
сравнительно: сравнительно
среди: среди
ссср: ссср
старый: старых
статья: статьях
стоить: стоит
столь: столь
странный: странный
студент: студентам
субъект: субъект субъекта
субъектность: субъектности субъектность
существенно: существенно
существование: существование существовании существования
существовать: существовала существует
сфера: сфере
сформировать: сформировавший
также: также
такой: такие таким такими такое
такт: такт
творчество: творчество
тело: тела
теория: теорией теории теорию теория
термин: термина
течение: течение
томас: томас
тот: тех тому
точка: точки
точно: точно
точность: точностью
требовать: требовало требует требуют
труд: труда
уверенный: уверен
угодный: угодно
удачный: удачными
удобство: удобства
узнаться: узнается
укоротить: укороченной
умение: уменье
упоминать: упоминает
упразднить: упразднить
упростить: упростило
уровень: уровня
усилие: усилий
усилить: усилили
услышать: услышал услышанной услышать
утверждать: утверждает
участок: участок
учёный: ученый
фактически: фактически
феномен: феномен
феноменология: феноменологии
фетишизировать: фетишизированное
фикшн: фикшн
философ: философ
философия: философии философия
фиолетовый: фиолетового
фловерхорн: фловерхорн
фольклор: фольклора
фомин: фоминой
фото: фото
фраза: фраза
характерный: характерный
хвост: хвост хвостов
ход: ход
хороший: хорошего
хотя: хотя
хромосома: хромосомы
цитата: цитаты
цифровой: цифровой цифровую
чарлза: чарлза
чарлзти: чарлз
часть: часть
человек: люди человек человека человеком человеку
человеческий: человеческий
чистый: чистый
читать: читают
чувство: чувства чувство
чужой: чужой
широкий: широком
школьник: школьники школьнику
штуковина: штуковина
эволюционный: эволюционная эволюционной
эволюция: эволюции эволюцию эволюция
эгоистичный: эгоистичного эгоистичный
экономика: экономики
элемент: элемент элементов элементы
элитарный: элитарного
эпоха: эпоху
этот: эта этих этому
явление: явление явлений
являться: являемся является
яйцеклетка: яйцеклеток
якименко: якименко
