автор: автор
айдахскай: айдахская
алгоритм: алгоритмы
алюминий: алюминий алюминия
апрель: апреля
аргон: аргон
аргоннский: аргоннская аргоннской
аргонный: аргонна
аргоновый: аргоновая
африканский: африканского
ацетонитриловый: ацетонитрилового
бабнига: бабниг
бабочка: бабочек
бактерия: бактерии бактерий
белинск: белински
белла: белл
белок: белком
белый: белый
биология: биологии
биоразнообразие: биоразнообразия
больший: большим
борис: борисов
быстро: быстро
важный: важную важных
велосиметрия: велосиметрии
верхний: верхней
весь: всему
веха: веху
вид: виде видов
визуализация: визуализации визуализация
викторианский: викторианской
внутренний: внутренняя
воздействие: воздействию
волос: волос волоса
восстановление: восстановления
вселенная: вселенная вселенной
всё: всё
второе: второе
выбрасываться: выбрасывается
выбрать: выбрать
выглядеть: выглядит
выделение: выделения
выполнить: выполнена
выполняться: выполнялось
высокий: высокого
высокоэнергетичный: высокоэнергетичных
вычисление: вычислениях
газ: газа
геометрия: геометрии
гидроксид: гидроксида
гильный: гильен
глаз: глазом
говорить: говорит
год: года году
голосование: голосование
гравитационный: гравитационная гравитационную
гэри: гэри
давление: давления
дальний: дальнем
данные: данных
два: двух
двенадцать: двенадцать
двигатель: двигателей двигатели
демонстрировать: демонстрирует демонстрирующих
день: дней
джозеф: джозеф
диаметр: диаметра
дизельный: дизельные
дикий: дикого дикой
диковина: диковины
динамика: динамика динамику
долголетие: долголетия
донна: донна
дорогостоящий: дорогостоящих
другой: других
дружелюбный: дружелюбных
дружественный: дружественная
дьёрдь: дьёрдь
едва: едва
жестокость: жестокость
жидкость: жидкости
журавлик: журавлика
жёлтый: желтой
забота: заботу
завоевать: завоевала
заглядывать: заглядывая
зажечь: зажженная
зажигаться: зажигается
запад: западу
затем: затем
затмение: затмения
зеленоватый: зеленоватой
зелёный: зеленым
землепользование: землепользования
зуб: зубы
зубной: зубная зубной
излучение: излучения
изображение: изображение изображению изображения
изучать: изучающие изучая
изучение: изучения
имхотёпа: имхотепа
индий: индий
индия: индия
инкапсулирование: инкапсулировании
инкапсуляция: инкапсуляции
иной: иным
инопланетный: инопланетный
инслить: инсли
испарение: испарения
использовать: используемого
исследование: исследование исследований исследования
исследовательский: исследовательский
источник: источнике
истребитель: истребитель
исходный: исходное
калин: калин
камень: камней
канал: канал
капля: капель каплях
картинка: картинке
километр: километрах километров
кластер: кластеры
клетка: клеток
колбить: колби
коллайдер: коллайдера
комета: комета
комнатный: комнатной
комплекс: комплексов
конец: конце
конкурс: конкурс конкурса конкурсы
конструкция: конструкцию
контрастный: контрастной
конфликт: конфликтов
конфокальный: конфокального
концентрический: концентрических
координироваться: координируется
космологический: космологические космологическое
который: который
красный: красным
красота: красота
кристалл: кристаллов кристаллы
кристаллоподобный: кристаллоподобного
круг: круг кругов
крупномасштабный: крупномасштабное крупномасштабные
крупный: крупных
крыло: крыльев
кусок: куска
лаборатория: лаборатории лаборатория
лев: льва львы
леди: леди
лежать: лежащую
лишь: лишь
локон: локонов
макинтайра: макинтайр
максена: максены
максим: максим
максимизация: максимизации
маленький: маленькие меньше
материя: материи материя
мгц: мгц
мегана: меган
медленный: медленного
место: мест место
микроскоп: микроскопа
микросрез: микросрез
микрофлюидный: микрофлюидных
микрофотография: микрофотографий микрофотография
министерство: министерства
мир: миры
мкм: мкм
млекопитающее: млекопитающих
мм: мм
многократный: многократному
многоступенчатый: многоступенчатой
мода: моды
моделирование: моделирование
молекула: молекулы
молочай: молочая
монарх: монархов
мощность: мощности
мухоз: мухоза
наблюдать: наблюдаемый
навроцк: навроцки
нагревание: нагревании
название: названием
называть: называемой
нанокомпозит: нанокомпозиты
наноразмерный: наноразмерных
напоминать: напоминающее напоминающей
насекомое: насекомые насекомых
насименто: насименто
насыщенный: насыщенного
наука: науке
научный: научного научных
национальный: национальная национальное национальной национальный
начальный: начальный
небольшой: небольшое
невооружённый: невооруженным
необходимый: необходимые
несколько: несколько
нескучный: нескучная
неукротимый: неукротимая
нечто: нечто
нижний: нижней
низкий: низкой
ничто: ничем
новый: новые
нужда: нужд
обеспечить: обеспечить
обитание: обитания
область: области
обозначать: обозначаемых
обработка: обработке
образование: образованию образования
образоваться: образуется
общество: общество
объединяться: объединяются
объявить: объявило
одюбоновский: одюбоновское
около: около
окружающий: окружающей
оксид: оксид
оптимизировать: оптимизировать
оптический: оптической
оригами: оригами
основа: основе
основать: основанные основанный
особый: особым
осьминог: осьминоги
отверстие: отверстие
отвоеваться: отвоевавшийся
открытый: открытое
отображать: отображающее
отобрать: отобраны
отражать: отражает
охлаждение: охлаждением охлаждения
очертить: очерченный
пасть: пасть
пацифист: пацифисты
пейзаж: пейзаж
первый: первое
перекрещиваться: перекрещивающихся
плазма: плазма
победитель: победителей
повышенный: повышенные
поглощать: поглощая
подвергнуться: подвергся
поддерживать: поддерживать
подобный: подобную подобных
подошва: подошве
позволить: позволило
позволять: позволяет
показатель: показатели
показать: показали
показываться: показывается
поколение: поколения
полимер: полимеры
полимерный: полимерные
половина: половины
положительно: положительно
полуволновой: полуволновом
полусотня: полусотни
получение: получения
получить: получены
пользовательский: пользовательской
пометить: помеченной помеченных
помогать: помогает помогают
помощь: помощью
понять: понять
порошок: порошок
порт: порт
порядок: порядка
посвятить: посвященные
последний: последние
последующий: последующим
построить: построите построишь
поступить: поступило
потрясать: потрясающая
появление: появлению
предъявлять: предъявляющих
преобладать: преобладающим
привести: привели
приводить: приводит
прилететь: прилетят
применить: применены
примечательный: примечательный
природа: природы
прислать: прислала
проводить: проводит
проводиться: проводятся
проводник: проводник
продвинуть: продвинутая
промышленный: промышленных
прорыв: прорывов
простейшее: простейшего
прохождение: прохождения
процедура: процедуре
прочий: прочие
путём: путем
пучок: пучка
пять: пять
работа: работ работа работу
радиочастотный: радиочастотного радиочастотной
развитие: развитием
разглядеть: разглядеть
размах: размах
разнообразие: разнообразием
разный: разными
разработка: разработки
разрешение: разрешения
ракета: ракеты
распадаться: распадающаяся
расположить: расположенный расположены
распыление: распыления
раствор: раствора
расти: растущих
реагировать: реагируют
резонатор: резонатора резонаторе
результат: результате результаты
реконструировать: реконструированное реконструируемому
рентгенография: рентгенографии
решетчатый: решетчатым
рицци: рицци
розоватый: розоватых
роль: роль
рост: рост
сад: сад
сам: самой
сверхпроводящий: сверхпроводящего
свинец: свинец свинца
своеобразный: своеобразную
связанный: связанных
связать: связано
сгорание: сгорания
сеанс: сеансов
серный: серных
сиксберт: сиксберт
сила: силах
силва: силва
силуэт: силуэт
сильвио: сильвио
символ: символ
симуляция: симуляции симуляция
синий: синим
синтез: синтез
синтетический: синтетической
синхротронный: синхротронного
система: систем системе
сканирование: сканирование
сканировать: сканирующего
скрещиваться: скрещивающиеся
слева: слева
сложный: сложную
смотреть: см
смягчение: смягчению
снимок: снимки
событие: событие
совместный: совместном
создание: создание созданию
создать: создано
солнечный: солнечная солнечного солнечной солнечных
сообщество: сообщества
сорок: сорока
составлять: составляет
сохранение: сохранении сохранения
способствовать: способствовать
справа: справа
спустя: спустя
среда: среде среды
средний: среднему
старый: старейший
сто: сто
строение: строением
строительство: строительства
структура: структуры
суперкомпьютер: суперкомпьютеров
существование: существование
счастие: счастья
сша: сша
сыграть: сыграть
также: также
такой: таких
температура: температур температуре
технологический: технологических
топливный: топливных
топливо: топлива топливо
тот: тому
точка: точки
традиционный: традиционный
требование: требования
третий: третье третьего
три: трех
триллион: триллионов
тёмный: темная темное темной
увеличить: увеличенное
увидеть: увидели
угол: углом
узор: узоров
университет: университетом
уолстон: уолстон
управление: управления
усиливаться: усиливается
ускоритель: ускоритель ускорителях
ускорительный: ускорительной
условно: условно
установка: установкой установок
устройство: устройств
учёный: ученые ученым
фазовый: фазово
фигурка: фигурки
физика: физики
финалист: финалистов
флуоресцентный: флуоресцентным
форсунка: форсунка форсунки
фотогалерея: фотогалерея
фотография: фотографии
фотоконкурс: фотоконкурсы
фотон: фотонов
фотоэлектрический: фотоэлектрических
фундаментальный: фундаментальные
хаомина: хаомин
характеризоваться: характеризуется
хеопс: хеопс
хороший: лучшие
цвет: цветом
цвета: цветами
центр: центр центра центров
центральный: центральный
цура: цуру
час: часов
частица: частиц
частота: частоте частотой
часть: часть
человеческий: человеческого
чикаго: чикаго
чикагский: чикагским
чудо: чудеса
ширина: ширина шириной
шокировать: шокирующая
эв: эв
экологический: экологические
эксплуатация: эксплуатации
экстремальный: экстремальных
электронный: электронного
элемент: элементы
эмаль: эмали эмаль
энергетика: энергетика энергетики
энергия: энергию
энергоэффективность: энергоэффективности
эстетика: эстетику
этап: этап
этот: эта этих
эффективный: эффективных
эшли: эшли
юань: юань
являться: являющейся
японский: японский
