август: августа
авдеев: авдеев
австралопитек: австралопитека
автор: автор авторы
агентство: агентство
азот: азот азота
аккреции: аккреции
активно: активно
активность: активности
алай: алая
алексей: алексей
алый: алый
американский: американского
амхарский: амхарского
анализ: анализа
аппарат: аппарата аппаратов
апрель: апреля
аррокот: аррокот
астероид: астероид астероида астероидов астероиды
астрокосмический: астрокосмического
астроновость: астроновости
астроном: астроном астронома астрономам астрономами астрономов астрономы
астрономический: астрономической
астрономия: астрономии астрономия
астрофизик: астрофизикам
атмосфера: атмосферы
атмосферный: атмосферных
атом: атомов
атомарный: атомарного атомарном
батуми: батуми
благодаря: благодаря
ближний: ближнего ближнем ближний
близкий: близкого
близко: близко
больший: большим
большой: большого
борис: борис бориса
буря: бурь
быстрый: быстрее
вверху: вверху
век: веков
вероятность: вероятности
верхний: верхней верхних
вести: ведет
весь: всей всем
ветер: ветра
ветеран: ветеран
вещество: вещества
взаимодействие: взаимодействии
взаимодействовать: взаимодействующих
взгляд: взгляд
взрыв: взрыва
взять: взяты
вид: виде
видео: видео
видеть: видел видели видеть видят
видимый: видимом
видный: видна
владиквказ: владиквказ
владимир: владимир владимира
внимательный: внимательном
возбудить: возбужденных
возбуждение: возбуждение
воздействие: воздействие воздействию
возможно: возможно
возникать: возникает
возраст: возраст возрасте
вокруг: вокруг
волгоград: волгоград
волна: волн волна
вопрос: вопрос
восток: востока
впечатление: впечатление
время: временем времени
вселенная: вселенная вселенной
вспышка: вспышек
встретить: встретит
выброс: выброс
выдающийся: выдающегося
высвечивание: высвечивания
высокий: высокой
высококачественный: высококачественные
высота: высоты
выход: выход
выясниться: выяснилось
вячеслав: вячеслав
газ: газа газов
газовый: газовых
гаиша: гаиш
галактика: галактик галактика галактики галактику
галактический: галактического галактическое
геомагнитный: геомагнитного
гигантский: гигантская гигантской
глубокий: глубоких
говорить: говорить говорят
год: года годах году лет
годдард: годдард
голова: голова
гораздо: гораздо
государственный: государственного
гравитационный: гравитационная гравитационное
градус: градусов
группа: группа
давать: дают
дальний: дальнего
далёкий: далекая дальше
данный: данном
дата: даты
дать: данной данные
два: две двух
двойной: двойной двойным
двухнедельный: двухнедельные
действительно: действительно
делать: делает
джеймс: джеймс джеймса
джон: джона
диаметр: диаметр
диапазон: диапазонах диапазоне
диковина: диковины
динкинеш: динкинеш динкинеша
директор: директора
длина: длинами длинах
добраться: добрался
должный: должна
дональдджохансон: дональдджохансон
доносить: доносит
дополнительно: дополнительно
достигнуть: достигнет
доступный: доступных
др: др
древний: древнейший
дыра: дыр дыра дыру дыры
евгений: евгения
евклид: евклид евклида
европа: европы
европейский: европейское
единый: единым
зависимость: зависимость
заключаться: заключаются
заключить: заключила
заметить: заметить
заметно: заметно
замечательный: замечательную
замечать: замечаем
занудство: занудства
запечатлеть: запечатлена
запустить: запущенным
затравочный: затравочная затравочную
захватывать: захватывающими
заявить: заявить
звезда: звезда
звёздный: звездную
зелёный: зеленая зеленый зеленым
земля: земле земли
земной: земной земных
значит: значит
зонд: зонд
зрение: зрения
идти: идет
известный: известны
излучать: излучать излучают
излучающий: излучающего
излучение: излучение излучением излучения
измерение: измерения
изначально: изначально
изображение: изображение изображений изображения изображениями
изумительный: изумительный
изучать: изучаемая
изучение: изучении
изучить: изучены изучит
ик: ик
ики: ики
именно: именно
иметь: имеет
имя: имени
иначе: иначе
институт: института
инструмент: инструментов
интенсивно: интенсивно
интенсивный: интенсивными
инфракрасный: инфракрасного инфракрасном инфракрасный
ио: ио
ионизированный: ионизированные ионизированных
иркутский: иркутского
исследование: исследования
исследователь: исследователей
исследовать: исследовать
источник: источник
исэф: исэф
июль: июля
кавказ: кавказа
камера: камеры
камилла: камилла
канал: канала
канд: канд
карликовый: карликовая
карта: карту
картинка: картинок
каталожный: каталожным
квадратный: квадратных
квазар: квазар
кислород: кислород кислорода
клеопатра: клеопатра
км: км
койперо: койпера
колебание: колебания
количество: количества
коллапс: коллапса
команда: команда
комета: комета
комментарий: комментарий
компонент: компоненты
конец: конец
конкретный: конкретные
конский: конская
контактный: контактно контактным
корн: корне
корональный: корональный
корша: корша
косвенно: косвенно
космический: космический космических космического космическое
космологический: космологическое
космос: космос космоса
который: которая которого которое которой котором которую которые который
край: край
красный: красная красном красную красным
крупный: крупное
крым: крыма
кудрить: кудря
лаборатория: лаборатории
лебедев: лебедева
левк: левк
лемпо: лемпо
летний: летнего
либо: либо
линза: линза
линия: линии линия
лишь: лишь
лия: лия
лю: лю
люси: люси
лёгкий: легче
магнитный: магнитное магнитных
магнитосфера: магнитосфера магнитосферу магнитосферы
максимальный: максимального
малый: меньших
марс: марса
март: марта
масса: масс масса массой массы
массивный: массивного
мат: мат
материя: материи
матрица: матрицей
мгу: мгу
мегапиксель: мегапикселей
международный: международная
менетие: менетием
мера: мере
место: месте
метастабильный: метастабильных
метровый: метрового
миллиард: миллиарда
миллион: миллионы
мимо: мимо
минерв: минерва
миновать: минуя
мир: мир миром
миссия: миссии
мнение: мнению
молекула: молекул молекулы
молекулярный: молекулярном
молодой: молодой моложе
момент: момент моменты
мочь: могут
мощность: мощность
мощный: мощной
наблюдатель: наблюдателей наблюдатель
наблюдательный: наблюдательная
наблюдать: наблюдаемой
наблюдаться: наблюдались наблюдаются
наблюдение: наблюдения
название: название
назвать: названный
называть: называемой называть
наиболее: наиболее
наименование: наименование
найти: нашедшего
направление: направлении направлению
например: например
наслать: нашли
наука: наук наука
научий: науч
научиться: научился
научный: научный
находиться: находился находится находятся находящийся
находка: находка
начало: начале
начинать: начинают
небесный: небесные
небо: неба небо
небольшой: небольшие
недалёкий: недалеком
незаметный: незаметен
некоторый: некоторому
необычный: необычном
непосредственно: непосредственно
неправильный: неправильная
нижний: нижней
низкий: низких низкой
никто: никто
нм: нм
новость: новости
новый: новые новыми
номер: номером
носить: носит
ночной: ночное
ночь: ночь
ноябрь: ноября
нынешний: нынешнего
облако: облака облако облаков облаком
область: область
обнаруживать: обнаруживать
обнаруживаться: обнаруживается
обнаружить: обнаружить
обозначение: обозначение
образование: образование образованием
обращаться: обращался
обсерватория: обсерватории
обусловить: обусловлено
обширный: обширных
объединить: объединенные объединив
объект: объект объектов объектом объекты
объектив: объективах
объяснение: объяснение
объяснять: объясняющей
ограничение: ограничение
один: одну
ожидаться: ожидается ожидался
означать: означает
оказаться: оказалась оказалось
около: около
окончательно: окончательно
окраситься: окрасилось
окрестность: окрестностей окрестности
определение: определения
оптический: оптическом
опубликовать: опубликовало опубликованы
орбита: орбитами орбите
ориентировать: ориентированное
орусый: орус
основа: основе
основной: основные
основный: основное
ответить: ответил
отдельный: отдельный отдельных
открыть: открыт
отличать: отличает
отличительный: отличительным
отправиться: отправилось
отснять: отснимет
оттенок: оттенок
оценка: оценкам
ошибочно: ошибочно
паблик: паблика
падать: падающего
палеоантрополог: палеоантрополога
палитра: палитре
патрокл: патрокл
первичный: первичные
первоначальный: первоначальное
первый: первые первый первых
перевод: переводе
перегретый: перегретого
передать: переданные
переставать: перестает
переупростить: переупрощены
пермский: пермский
персея: персея
пик: пик
пику: пику
писать: писали
плазма: плазмы
планета: планете планеты
планироваться: планируется
подвинуться: подвинься
поделиться: поделилась
поджидать: поджидал
подозревать: подозревали
подсжатие: подсжатию
позволять: позволяет
поздний: позднее позже
позиция: позиции
пока: пока
показать: показали
показаться: показаться
показывать: показывают
покидать: покидая
поле: поле
полимел: полимела
получать: получают
получение: получении
получить: полученные получено получив получившего
получиться: получились
полярный: полярное полярных
помочь: помогут
помощь: помощью
понять: понять
попадать: попадает
поперечник: поперечник
популярно: популярно
порядок: порядка
посетить: посетит
послужить: послужило
поэтому: поэтому
появиться: появиться
появление: появление
пояс: пояса
пояснить: пояснил
практически: практически
предварительный: предварительного
предвестник: предвестник
предел: предел
предположение: предположениях
предсказывать: предсказывать
преимущество: преимущество
прекрасный: прекрасная
препринт: препринтов
прибыть: прибыл
привести: привело
приглядеться: приглядеться
признак: признакам признаки признаком
прийти: пришел
примерно: примерно
природа: природу
присутствие: присутствии
приток: приток
приходить: приходили
причина: причиной
проблема: проблема
продемонстрировать: продемонстрировали
продолжать: продолжает
произойти: произошел
происходить: происходило происходит
пройти: прошло
пролетать: пролетая
пролететь: пролетел
пролёт: пролет
просто: просто
простой: прост
противоположно: противоположно
профессиональный: профессиональных
процесс: процессе
прочий: прочие
прошлый: прошлом
прямой: прямого
публиковаться: публиковались
пульсар: пульсары
пятно: пятен
пять: пять
пётр: петра
работа: работа работы
работать: работать работающего
равный: равных
радовать: радовать
размер: размеру
разница: разница
ран: ран
ранее: ранее
ранний: ранней ранний
распадаться: распадающаяся
располагаться: располагается
расположить: расположенная
рассматриваться: рассматривался
расстояние: расстоянии расстояния
расти: растущей
расширение: расширения
реагировать: реагирует
реакция: реакции
реализация: реализации
реалистичный: реалистичное реалистичный
регион: регионов
регулярно: регулярно
режим: режимы
результат: результате
рекорд: рекорд
рентген: рентгене
рентгеновский: рентгеновского рентгеновское рентгеновской рентгеновском
рефлектор: рефлектора
речь: речь
решение: решение
ринат: рината
роман: романа
рост: рост роста
рукав: рукавов
рыба: рыбах
рядовой: рядовой
сайт: сайт
салимов: салимова
сам: сама самой самом
самсонов: самсонова
самый: самую самые самыми
сближение: сближения
свежий: свежем
сверхмассивный: сверхмассивной сверхмассивных
сверхновый: сверхновой
свет: свет
световой: световых
свечение: свечение
свой: свое своего свои своих
сдавать: сдает
сделать: сделан
северный: северного северное северных
сентябрь: сентября
сервер: сервере
сергей: сергей сергея
си: си
сибирь: сибири
сигнал: сигнал
сильно: сильно
система: система системе системой системы
сияние: сияние сияний сияния
скелет: скелет
склейновый: склейнова
скопление: скопление скопления
скорее: скорее
скорость: скорости скорость
слабый: слабый
слева: слева
следующий: следующей
слипнуться: слипшихся
слияние: слияния
слово: словам
слой: слоях
смещение: смещении
смолин: смолина
смотреть: см
снизу: снизу
снимка: снимок
снимок: снимке снимки
собственный: собственное
событие: событие
современный: современные
создать: создаст
солнечный: солнечного солнечной солнечных
солнце: солнца солнце
сообщение: сообщению сообщения
сопровождаться: сопровождалось
составлять: составлял
состояние: состоянии состоянию состояниях
состоять: состоит
состояться: состоится
сотр: сотр
сотрудник: сотрудник
соцсеть: соцсетях
спектр: спектра
спектрометр: спектрометра
спиральный: спиральная спиральных
спрятаться: спрятавшуюся
спустя: спустя
спутник: спутник спутника спутнике спутником
сравнимый: сравнима
сразу: сразу
среди: среди
ст: ст
стадия: стадии стадию
становиться: становятся
стать: стали станет станут
степень: степенью
стоить: стоит
столкновение: столкновения
столь: столь
сторона: сторону
страна: странами
суметь: сумела
сурдина: сурдин
сутковый: суткового
существование: существования
сфокусировать: сфокусированных
сформироваться: сформироваться
считаться: считается считаются
также: также
такой: такие такими таком
телескоп: телескоп телескопа телескопом
тело: тел тело
теория: теории
толстяк: толстяк
тот: ту
траектория: траектории траекторию
транснептуновый: транснептуновый
трв: трв
третий: третья
треть: трети
трио: трио
тройной: тройной тройные
троянский: троянские
трёхмерный: трехмерную
тула: туле
туманность: туманность
тюмень: тюмень
тёмный: темной темных
тёплый: теплый
убедиться: убедились
уверенно: уверенно
удалённый: удаленную
ударный: ударная
удивительный: удивительной
указывать: указывает
улавливать: улавливаемый
улица: улица
ультим: ультима
ультрафиолет: ультрафиолет
университет: университета
уникальный: уникальный
упускать: упускают
урал: урала
усиливать: усиливает
усиливаться: усиливаются
усилить: усилило
уточнить: уточнить
утром: утром
участвовать: участвует
участок: участка участков
уэбб: уэббом
уэбба: уэбб уэбба
фактор: фактора
физ: физ
физический: физического
фиолетовый: фиолетовый
формироваться: формируются
фото: фото
фотография: фотографии фотография
фотометр: фотометра
фотон: фотоны
хаббл: хаббл
хаббнуть: хаббла
характерный: характерные
хастак: хастак
хватить: хватит
хопкинс: хопкинса
хотя: хотя
цвет: цвет цвете
целый: целая
цель: цели целью
центр: центра
цикл: цикла
чандра: чандра чандры
частица: частиц
часть: части часть частью
чей: чей
честь: честь
четырехкратно: четырехкратно
чувствительность: чувствительность
чудесный: чудесный
чёрный: черная черной черную черные черных
шапка: шапку
шаровой: шаровое
шесть: шесть
широкий: широкое широком
широкоугольный: широкоугольной
широта: широтах
шкловский: шкловского
штерн: штерн штерна
эволюционировать: эволюционируют
эврибат: эврибат
эдвин: эдвина
эддингтоновский: эддингтоновский
экспедиция: экспедиции
энергия: энергии
энтузиаст: энтузиастов
этап: этапе
этот: эта
эфиопия: эфиопии
эффективность: эффективности
юг: юге
южный: южного
юпитер: юпитера
явление: явления
являться: является
язев: язев язева
язык: языка
яркий: яркие яркое
яркость: яркости
ясно: ясно
ясный: ясное
