абиогенный: абиогенные абиогенных
абсолютно: абсолютно
автокаталитический: автокаталитические
адаптировать: адаптированных
академия: академии
акт: акт
активность: активности активностями
александр: александр
американский: американской
аминокислота: аминокислот аминокислоты
аналогия: аналогии
английский: английском
андрей: андреем
антропный: антропном антропному антропный антропным
апеллировать: апеллировать
аппарат: аппаратом
аспект: аспект аспектах аспекте
астрономический: астрономические
астрофизик: астрофизика
атом: атом
бактерия: бактерии
банальный: банальному
белка: белки
белковый: белковые
белок: белка белкам белков
беседа: беседой
бесконечность: бесконечности
бесконечный: бесконечного бесконечное бесконечную
беспокойство: беспокойство
бессмысленный: бессмысленный
биолог: биолог биолога
биологический: биологического биологическую
биология: биологии биология
биохимический: биохимическом
благоприятный: благоприятных
близко: близко
больший: большая большим большую
большой: большого большое большой велика
борис: борис бориса
буква: букв буквами
буквально: буквально
быстро: быстро
быть: будем будут будь суть
важность: важности важность
важный: важна важнейший важное важные
вакуум: вакуума
вакцина: вакцины
вариант: варианта вариантов
ваш: вашу
вброс: вброс
ведать: ведая
ведущий: ведущим
величина: величиной величину величины
венера: венеры
верно: верно
вернуться: вернемся вернуться
вероятно: вероятно
вероятность: вероятности вероятность вероятностями
вероятный: вероятным
весомый: весомой
вести: ведет вести
весь: всей
весьма: весьма
вечный: вечной
вещь: вещь
взаимодействие: взаимодействий
вид: видов
видеоверсия: видеоверсию
видеть: видим
видимо: видимо
википедия: википедия
вирус: вирусов вирусы
включать: включает включающая
вместо: вместо
вне: вне
внутри: внутри
внутрь: внутрь
возможно: возможно
возможность: возможности возможность
возникать: возникает возникали возникало возникать возникают возникающие
возникновение: возникновение возникновении возникновению возникновения
возникнуть: возникла возникли возникло возникнуть возникшего
возрастать: возрастает
вопрос: вопрос
воспроизведение: воспроизведения
воспроизвести: воспроизвел воспроизвести
воспроизводство: воспроизводства
восстановить: восстановить
вперёд: вперед
впечатление: впечатление
вполне: вполне
время: временем время
вроде: вроде
вряд: вряд
вселенная: вселенная вселенной вселенные вселенных
всемирно: всемирно
вспомнить: вспомнить
встреча: встречи
встречаться: встречаются
вступать: вступает
всякий: всякие всякого всяком
всё: всё
вторичный: вторичных
вулкан: вулканов
вы: вами
выглядеть: выглядеть выглядит
выдвигать: выдвигаю
выдвинуть: выдвинут выдвинутой
выживание: выживанию
выживать: выживать
вымирание: вымирание вымирания
выполнять: выполняет
выражаться: выражаясь
высокий: высокой
выше: выше
галактика: галактике
гармонировать: гармонирует
гельфанд: гельфандом
ген: ген
генетический: генетический генетического генетической генетическую
геном: геном генома геномом
геотермальный: геотермальные
гибель: гибели
гигантский: гигантской
гипер: гипер
главное: главного
говорить: говорили говорите говорю говоря
говориться: говорится
год: год года лет
гораздо: гораздо
горячий: горячих
господь: господи
гость: гостя
грант: грант
греческий: греческое
давать: давайте давал давала давали давать давая дают
давно: давно
далее: далее
далеко: далеко
дальнейший: дальнейшем
далёкий: дальше
данный: данное
дарвиновский: дарвиновская дарвиновского дарвиновском
дать: давший дать
два: двум двух
двигаться: движущимися
действительно: действительно
действовать: действовать
делать: делает делать делают
деликатно: деликатно
делиться: делиться делятся
дело: дела деле дело делу
день: день
деньга: денег
десятка: десятки
дешёвый: дешевая дешевый
дизайн: дизайна дизайном
дико: дико
дискуссия: дискуссия
длина: длине
длинный: длинная длинные
днк: днк
добавить: добавить
добиться: добиться
довольно: довольно
должный: должен должны
дополнительный: дополнительных
допускать: допускающими
допустить: допустим
достаточно: достаточно
доходить: доходя
дочерний: дочерним
другой: другая другие других другого
думать: думаем думать думаю
евгений: евгением евгений
естественно: естественно
естественный: естественного естественной естественный естественных
желательно: желательно
живой: живыми
животное: животного
жизнь: жизни жизнь
жить: живут
журнал: журнале
зайти: зайдет
заключаться: заключается заключаются заключающийся
закодировать: закодированной
закон: законы
закономерность: закономерность
закономерный: закономерен закономерны закономерный
закончить: закончим
закончиться: закончится
закрывать: закрывать
заложить: заложена
заметить: заметить
замечать: замечает
замешать: замешана
замыкание: замыкание
заниматься: занимается
занять: занять
запустить: запустить
заранее: заранее
зарождение: зарождения
затем: затем
зацепка: зацепки
здравоохранение: здравоохранения
земля: земли
зерно: зерно
знать: знаем знал знали знаю
значимый: значимую
значит: значит
зрение: зрения
играть: играет играла играли играют
идеализированный: идеализированной
идея: идее идеей идеи идей
идиотизм: идиотизм
идти: идет шла
известный: известный
изменчивость: изменчивость
изменчивый: изменчивыми
измерение: измерениях
изначальный: изначальной
изображение: изображение
изучать: изучать
именно: именно
иметь: имеет имеют
иметься: имеется имеются
иначе: иначе
инкубатор: инкубаторами
институт: институтов
интеллект: интеллекта
интервью: интервью
интересный: интересен интересная интересные
интересоваться: интересоваться
интерпретация: интерпретацией
интуитивно: интуитивно
инфлатон: инфлатона
инфляционный: инфляционной
инфляция: инфляции инфляция
информация: информации информацию
исключительно: исключительно
искусственный: искусственного
искусство: искусств
использовать: используя
исследование: исследований исследования
истина: истины
история: истории
источник: источниках
итак: итак
к: ко
каждый: каждой каждую каждый
казаться: кажется казалось
каков: каково
какой: какие каким какими каких какого какое каком какую
камера: камерах
канал: канале
капитуляция: капитуляции
капля: капля
картина: картину
карьера: карьеры
катализатор: катализатор катализаторов катализаторы
катализирийся: катализируюся
катализировать: катализируемый катализирует
каталитический: каталитическая каталитическим
катастрофа: катастрофы
квантовый: квантовая квантовой квантовые
кислота: кислоты
кишечник: кишечника
классический: классические
клетка: клетка клетках клетке клетки
книга: книга
кодировать: кодирует
количественный: количественную
количество: количества количеством
колонизация: колонизация
колыбель: колыбель колыбелью
комментарий: комментария
комплекс: комплекс комплексы
компонент: компонент компонента компонентов
конец: конце
конкретный: конкретный
константа: констант константы
конструктивный: конструктивная конструктивный
конструкция: конструкция
контекст: контексте
контролировать: контролировать
концентрировать: концентрировать
концепция: концепцией концепция
копия: копию
короткий: коротких
космологический: космологическая космологической
космология: космологией
который: которая которого которое которой которую которые который которых
край: крае
крайний: крайней
круг: круг
крупный: крупные
крыться: кроется кроются
кстати: кстати
кто: кого
кулярный: кулярных
кунин: кунин кунина куниным
курица: курицы
курс: курсе
лаборатория: лаборатории лабораториям лабораториях
лауреат: лауреат
легко: легко
лес: лес
лигаза: лигазы
линде: линде
лишь: лишь
лишённый: лишенных
ложный: ложного
любить: любить люблю
любой: любая любой
макромол: макромол
максимально: максимально
маленький: маленькие меньше
мало: мало
малый: малой
мальск: мальски
манфред: манфред
марков: марков маркова
марс: марса
масса: массы
математический: математическая математические
материал: материал материала материалов
материя: материи
матрица: матрицах матрицу матрицы
машина: машина машины
машинка: машинка
машинный: машинного
мембрана: мембран
мембранный: мембранные
менее: менее
мера: мере
место: место
метеорит: метеоритах
механизм: механизмов механизмы
механика: механика механики
миллиард: миллиарды
мир: мира мире
мировоззренческий: мировоззренческая
многие: многие
многий: многим многими многих
многоклеточный: многоклеточные многоклеточный
многомировой: многомировой
многоуровневый: многоуровневое
множественный: множественные
множество: множество
модель: модели модель
мой: мое мою
молекула: молекул молекула молекуле молекулу молекулы
молекулярный: молекулярным молекулярных
молния: молний
мочь: мог могли могу могут можем
мулкиджанян: мулкиджаняна мулкиджаняном
мультивселенная: мультивселенная
мультивёрса: мультиверса
мы: нам
наблюдать: наблюдаем
наверное: наверное
наверняка: наверняка
наводить: наводить
надеяться: надеюсь
надувание: надуванием
назад: назад
назвать: назовем
называть: называемого
называться: называется называются
найти: найти
накинуть: накинуть
накопление: накопление
наличие: наличии
намеренно: намеренно
намного: намного
намётка: наметки
наоборот: наоборот
направить: направленный
направление: направление направлении
например: например
нарушение: нарушение нарушения
насколько: насколько
наследственность: наследственности наследственность
наследственный: наследственными
настоящий: настоящие
настроить: настроенная настроено настроены
наука: наук наука
научный: научным
находиться: находится
национальный: национальной
начало: начала начале начало началом
начальный: начальных
начать: начнем
начинать: начинает
наш: наша наше нашего нашей наши
нащупать: нащупать
невероятность: невероятности
невероятный: невероятное невероятные
невозможно: невозможно
невообразимый: невообразимой
негенетический: негенетическом
недостаток: недостаток
недоступный: недоступные
некий: неких некую
некого: некому
некоторый: некоторой некотором некоторые некоторый некоторых
немного: немного
немножко: немножко
необходимость: необходимости
необходимый: необходим необходима
необъятный: необъятна
неплохо: неплохо
неплохой: неплохая
непрерывность: непрерывности
непросто: непросто
несколько: нескольким несколькими нескольких несколько
нестабильный: нестабильных
нести: несет
нетривиальный: нетривиальные
неферментативный: неферментативная
нечто: нечто
неэффективно: неэффективно
неявно: неявно
ниже: ниже
низкий: низкая
низкоэнтропийный: низкоэнтропийные
никакой: никаких никакого
никитин: никитин никитина никитиным
никто: никто
ниша: ниши
нобелевский: нобелевской
новый: новое новом новые новых
носитель: носителях
нужно: нужно
нужный: нужен нужна
нуклеиновый: нуклеиновые
нуклеотид: нуклеотидов нуклеотиды
нуль: нуля
нынешний: нынешней нынешних
обитаемый: обитаемых
обладать: обладать обладают
облегчать: облегчающей облегчающих
обозначить: обозначила
обосновать: обосновано
образ: образом
образование: образование образований образованию
образоваться: образоваться
обращаться: обращаться
обстоять: обстоят
обсуждать: обсуждали обсуждаю
обучаться: обучаются обучающиеся
обучение: обучение обучения
обходиться: обходиться
общий: общее общие общий общих общую
объект: объектов
объяснение: объяснение объяснений объяснения
объяснить: объяснить
ограничить: ограничен ограничены
ограничиться: ограничиться
огромный: огромна огромное огромные
один: одна одной одном
одноклеточный: одноклеточной одноклеточных
означать: означало
оказаться: оказались оказался
окрестность: окрестностях
оно: оно
оперировать: оперировать
описание: описание
определение: определений
определяться: определяются
определённый: определенном определенную определенным определенных
опробовать: опробовано
опубликовать: опубликована
организация: организации
организм: организм организмам организмы
осваивать: осваивать
основа: основе основы
основать: основана
основное: основном
основной: основной
особенно: особенно
оставаться: остается
осуществлять: осуществлять
отбор: отбор отбора
ответ: ответ ответы
ответственно: ответственно
отвечать: отвечают
отдельно: отдельно
откровение: откровений
отличаться: отличаются
отличие: отличие
относительно: относительно
относиться: относится относиться относящийся
отношение: отношение отношении
отобрать: отобрать
отсутствие: отсутствии
оттолкнуть: оттолкнет оттолкнуть
оценка: оценка оценке оценку
очевидный: очевидно очевидное
очень: очень
очередь: очередь
ошибаться: ошибаться
ошибиться: ошибиться
ошибка: ошибки ошибок
пара: пару пары
парадокс: парадокс парадоксом
пена: пену
пептид: пептидами пептидов пептиды
пептидный: пептидных
первый: первую первые первый первым первых
передавать: передающими
передний: переднем
переставать: перестают
переход: переход переходы
персистенция: персистенцию
перспективный: перспективное
писать: писал
план: плане
планета: планет
планетный: планетная
плетень: плетень
плодить: плодит
плотность: плотностью
поведать: поведал
повезти: повезло
повествование: повествования
повышать: повышающее
повышение: повышению
поговорить: поговорить
поддерживаться: поддерживалась
поддержка: поддержка
подобный: подобное
подозревать: подозреваю
подумать: подумать
подход: подход
подходить: подходила
позволять: позволяет позволяющие позволяя
поздний: позже
позиция: позиция
пойти: пошла
пока: пока
показаться: показалось
показывать: показывает
поколение: поколения
поле: поля
полимер: полимер полимеры
полимераза: полимеразу полимеразы
полный: полный
получаться: получается
получить: получена получив получить
получиться: получится
помимо: помимо
помогать: помогали помогают помогающих
помощь: помощь помощью
понемногу: понемногу
понимание: пониманию понимания
понимать: понимаете понимаю понимая
пониматься: понимается
понятие: понятие
понятный: понятный
понять: понял понять
попадание: попадании
попасть: попала
попробовать: попробовать
попросту: попросту
попытаться: попытаться
попытка: попытки попыток
пора: пор порах
порог: порог пороге порогом
пороговый: пороговую
порочный: порочный
порядок: порядке порядков
поскольку: поскольку
последний: последнее последним
последовательность: последовательность
посмотреть: посмотреть
поспособствовать: поспособствуют
поставить: поставить
почему: почему
поэтому: поэтому
появиться: появилась появились появился появиться
появление: появлении
появляться: появляется
правдоподобный: правдоподобное
правило: правило
правильно: правильно
практически: практически
практический: практического
превышать: превышает
предел: предела пределами
предложить: предложенной
предположение: предположения предположениям предположениях
представить: представить
представление: представление
представлять: представляем представлять
представляться: представляется
предшествовать: предшествующей предшествующих
прежде: прежде
преимущество: преимущество
премия: премии
преодолеть: преодолеть
приближаться: приближающихся
привести: приведи приведу
привлекать: привлекать
привлечение: привлечении
привлечь: привлечь
приводить: приводит приводят приводящие
пригодность: пригодности
придумать: придумали
прийтись: пришлось
приличный: приличный
применение: применением применения
пример: пример примеры
примерно: примерно
примитив: примитив
примитивный: примитивном примитивную
принцип: принцип принципе принципом принципу
природа: природе
притягивать: притягивать
причём: причем
проблема: проблема проблеме проблемой проблему проблемы
проводиться: проводятся
продвижение: продвижение продвижения
продвинуть: продвинула продвинутым
продолжать: продолжаем
произойти: произойдет произойти произошло
происходить: происходил происходило происходит происходят происходящего
происхождение: происхождение происхождении происхождению происхождения
пройти: пройден
прокариот: прокариот
проникнуть: проник
проработать: проработанным
просить: прошу
просто: просто
простой: простой простом простым простыми простых
простор: просторах просторы
пространство: пространства
протеин: протеинов
протекать: протекать
протобиологический: протобиологическим
протоклетка: протоклеткам протоклетками протоклетках протоклетки протоклеток
проточный: проточные проточных
процесс: процесс процесса процессах процессе процессов процессы
прощение: прощения
прояснить: прояснить
пузырь: пузырей
пузырёк: пузырьками пузырьки
путать: путать
путь: пути
пытаться: пытаться пытаются
работать: работает работать работают
равно: равно
разговор: разговор
раздел: раздел
размножаться: размножаться
размножение: размножения
разнообразие: разнообразия
разный: разное разному разные разными разных
разработать: разработал
разрушаться: разрушаются
разряд: разрядах
разумный: разумное
ранний: ранней раньше
распад: распад
распространение: распространении
распространить: распространена распространены
расслоение: расслоение
рассуждать: рассуждаю
рассчитывать: рассчитываем
растение: растения
расти: расти растут растущая
рациональный: рациональное рациональные
реакция: реакции
реалистичный: реалистичной реалистичных
реально: реально
реальность: реальности реальность
реальный: реальном реальному реальным
редактор: редактора
редкий: редкие
режим: режим
результат: результата результате результатом
рекорд: рекорде
репликаз: репликазы
репликат: репликатов
репликативный: репликативные репликативным
репликатор: репликатор репликатора репликаторам репликаторами репликаторов репликаторы
репликация: репликации репликацию репликация
реплицировать: реплицирующую
ресурс: ресурсы
речь: речь
решающий: решающие
решиться: решился
рибозимый: рибозим рибозимы
рибосома: рибосома рибосомах рибосомы
рнк: рнк
родиться: родились
рождение: рождении
роль: роли роль
рукотворный: рукотворный
ряд: ряд
салфетка: салфетке
сам: сама сами самого самом саму
самокатализ: самокатализу
самореплицироваться: самореплицирующейся
самый: самое самый самым самыми самых
сбалансировать: сбалансирована
сборка: сборке сборки
свернуться: свернуться
сводиться: сводится
свой: свое своей своим
свойство: свойствами
связать: связана
связный: связный
связывать: связывала
связь: связей
сдвинуть: сдвинуть
сделать: сделала сделанная сделаны сделать сделаю
себя: собой
сегодня: сегодня
сегодняшний: сегодняшнего
сей: сих
селекция: селекции селекция
сердце: сердце
серия: серии серию серия
серьёзный: серьезную
сеть: сети
сидеть: сидели
сильно: сильно
симметрия: симметрии
синтез: синтеза
синтезировать: синтезировала синтезируемых
синтезироваться: синтезировались синтезируются
система: систем система системами системах системе систему системы
ситуация: ситуацию
скажем: скажем
сказать: сказали сказать
скалярный: скалярного
сконструировать: сконструировать
слева: слева
следовать: следует
следующий: следующие следующим
слишком: слишком
слово: слова слово словом
сложиться: сложиться
сложно: сложно
сложность: сложностей сложности сложность сложностью
сложный: сложна сложная сложнее сложнейшую сложное сложной сложные сложный сложным сложных
служить: служили служит служить
случай: случае случай
случайно: случайно
случайность: случайностью
случайный: случайной случайном
слышать: слышал слышали
смотреть: см смотрите
смочь: сможет
смысл: смысле
снижение: снижение
снова: снова
собрать: собрать
собраться: собраться
собственно: собственно
событие: события
совершенно: совершенно
совершенный: совершенная совершенный
совместно: совместно
современный: современную
содержать: содержат содержащей
соединение: соединения
соединять: соединяет соединяла соединять соединяющими
сожрать: сожравший сожран
создать: создать
сомнение: сомнения
сообщаться: сообщается
соответственно: соответственно
соотношение: соотношение
сопровождать: сопровождающие
сосредоточиться: сосредоточимся
составлять: составляет
состоять: состоит состояли состоящая
сотня: сотен сотни сотню
сотрудник: сотрудником
сохранение: сохранение сохранением
сочетаться: сочетается
спасибо: спасибо
специально: специально
специальный: специальных
спонтанно: спонтанно
спонтанный: спонтанного спонтанное спонтанном
спорить: спорил спорить
способ: способами
способный: способна способные
способствовать: способствующий
справа: справа
справедливость: справедливость
сравнение: сравнении
сравнительно: сравнительно
сразу: сразу
ссылаться: ссылаетесь
стабилизация: стабилизации
стабильность: стабильность стабильностью
стабильный: стабильнее стабильные стабильными
стадия: стадии стадиях
становиться: становится
стараться: стараться стараюсь
стартовать: стартовала стартовать стартует
стать: став стал
статья: статье статью статья
стоить: стоит
столкнуться: столкнулись
столь: столь
сторона: сторону стороны
странно: странно
страшно: страшно
строго: строго
строить: строить
структура: структур структура структуры
стыд: стыда
субстрат: субстрат
суметь: сумел
супер: супер
суть: сути
существенный: существенную
существо: существа существами
существование: существование существовании
существовать: существовало существовать существует существуют
существующий: существующих
сущность: сущности
схема: схеме
схожий: схожих
считать: считать считаю
считывание: считывания
счёт: счет
сша: сша
съесть: съел
таинственный: таинственное
также: также
таки: таки
таковой: такового
такой: такая такие таким такими таких такое такому
тема: тема тему
теоретически: теоретически
теория: теорией теории теорию теория
термин: термин
терминология: терминологии
тесно: тесно
тип: типа
тонко: тонко
тот: та те теми тех той
точка: точка
точно: точно
точность: точностью
точный: точная точной точным
трансляция: трансляции
транспортный: транспортной
трв: трв
требовать: требуют требующем
требоваться: требуется
тревожный: тревожно
три: трех
троицкий: троицкого
трудно: трудно
трудность: трудности трудность
тупик: тупик
тысяча: тысячу
тёмный: темный
убежище: убежище
уверенный: уверен
угодный: угодно
удаваться: удается
удаться: удалось
удачно: удачно
удачный: удачными
указание: указаний
указывать: указывает
упование: упование упования
уповать: уповают
уровень: уровень уровне уровней уровни
ускользнуть: ускользнуть
условие: условиях
усложнение: усложнению усложнения
усложняться: усложняющимся
успех: успехи
устанавливаться: устанавливается
установить: установить
уточнить: уточнить
участие: участием
учитывать: учитывать
учёный: учеными
факт: факта
фактор: фактор факторы
фантастически: фантастически
феномен: феномен
фермент: фермент ферменты
ферментативный: ферментативная
физик: физик
физика: физики физику
физический: физического физической
флуктуация: флуктуации
форма: формы
фосфолипидный: фосфолипидные фосфолипидными
фундаментальный: фундаментальная фундаментальной
функционировать: функционируют
функция: функции
химик: химик
химический: химические химический химических
ход: ходе
хозяин: хозяином
хороший: хорошем хорошему хороший
хотеть: хотел хочу
хотеться: хотелось хочется
хотя: хотя
хью: хью
цикл: цикл
цитировать: цитируете
частица: частиц
часто: часто
часть: частями частях
человек: люди
человечество: человечеству
черезвычайно: черезвычайно
честной: честными
четыре: четырех четырьмя
число: числе
чисто: чисто
член: членом
чрезвычайно: чрезвычайно
чрезмерный: чрезмерное
что: чему
чудо: чуда
чудовищный: чудовищными
шаг: шаг шагов
штерн: штерн штерна штерном
шум: шума
эверетт: эвереттом
эволюционировать: эволюционирующие эволюционирующих
эволюция: эволюцией эволюции эволюцию эволюция
эзотерика: эзотерику
эйген: эйген эйгена
экзопланета: экзопланет
экологический: экологические экологических
экосистема: экосистема
экспансия: экспансии
эксперимент: эксперименте экспериментов эксперименты
экспериментально: экспериментально
эксперт: экспертами
элементарный: элементарный
эндосимбиоз: эндосимбиоза
эндосимбионт: эндосимбионтом
энергия: энергией энергии энергию энергия
энзима: энзимы
энтропия: энтропии
эт: эт
этап: этапы
это: этим
этот: эта этих
эукариот: эукариот эукариоты
эффективный: эффективной эффективные эффективный эффективных
явление: явление явления явлениях
являть: являет
являться: является являются являющихся
явно: явно
язык: языке языком
яйцо: яйца
