аарон: аарон
август: августа
автоматический: автоматического
агентство: агентства
адаптивный: адаптивной
администратор: администратором
акацук: акацуки
аккреционный: аккреционному аккреционный
активный: активного
алексей: алексей
алтай: алтае
американка: американка
американский: американском
анна: анна
апертура: апертурой
апрель: апреля
ароматический: ароматические
астероид: астероидов
астроновость: астроновости
астроном: астрономам астрономы
астрофизик: астрофизика
атлантиса: атлантис
атмосфера: атмосферы
афганистан: афганистане
белецкий: белецкого
блазар: блазаре
ближний: ближнего ближнем
близкий: ближайших
близлежащий: близлежащих
блок: блоков
боде: боде
боевой: боевых
больший: наибольшей
большой: большое большой большому
борис: борис
брайан: брайана
браться: берутся
будущий: будущая будущих
буря: бури
бывать: бывает
быстрый: быстром
быть: будут
важно: важно
вайлак: вайлаки
вакат: ваката
вафля: вафля вафлями
вверить: вверенном
вдали: вдали
венера: венере
вера: веры
вероятный: вероятное
вертолетик: вертолетик
вес: весом
весна: весной
весьма: весьма
ветер: ветра ветром
вечерний: вечернее
взаимодействие: взаимодействие
взрыв: взрыва
вид: вид видом
видеть: видели
видимый: видимом
видный: виден видны
включать: включает
влияние: влиянием
вмс: вмс
внимательно: внимательно
внимательный: внимательном
внутренний: внутренней
водород: водорода
воздействие: воздействия
возможно: возможно
возможность: возможностью
возникать: возникающих
возникнуть: возникнуть
возраст: возраст
вокруг: вокруг
волна: волн волны
вопреки: вопреки
восточный: восточном
восход: восхода
вполне: вполне
вращаться: вращаться вращающаяся вращающейся
вращение: вращения
время: времени время
вселенная: вселенную
всерьёз: всерьез
всматриваться: всматривается
всплеск: всплеском
вспышка: вспышек вспышка вспышке вспышку
встречаться: встречающиеся
всё: всё
второй: вторая второй
вулкан: вулкан
выброс: выбросы
выглядеть: выглядит
выдуваться: выдувается
вызов: вызов
выйти: вышел
высказываться: высказывались
высокий: высокой высокую
высокоэнергичный: высокоэнергичных
выталкивать: выталкивает
газ: газ газа
галактика: галактик галактика галактике галактики галактикой
галактический: галактический галактическим галактического
галлей: галлея
гелиевый: гелиевая
героизм: героизм
герой: героя
гигапиксель: гигапикселя
гид: гидом
гидирование: гидирования
гидротехник: гидротехник
гипотеза: гипотезу
гитарист: гитариста
главное: главное
год: года году лет
годичный: годичном
голубой: голубой
гораздо: гораздо
горизонт: горизонте
город: городом
городской: городская городской
гравитационный: гравитационное гравитационных
группа: групп группы
далёкий: далекой
данные: данных
данный: данном данный
датчик: датчиков датчиком
дать: дали данные
девушка: девушка
действовать: действующий
декабрь: декабре
делать: делать
дело: деле дело
день: дни
десять: десяти
детектор: детекторов
джеймс: джеймс
джош: джош
диагональ: диагонали
диаметр: диаметром
диапазон: диапазона диапазоне
диплом: диплома
диск: диск диски диску
диссертация: диссертации
длина: длина длине
длительный: длительного длительной
длиться: длится
дневный: дневными
долгий: долгое
долго: долго
долгосрочный: долгосрочная
должный: должна
достигать: достигает достигать
др: др
думать: думали
дуэт: дуэт
дыра: дыр дыра дырами дыры
единственный: единственная
ежедневно: ежедневно
железо: железа
женщина: женщина
завеса: завесу
закат: закат заката закатом
закономерность: закономерность
заметить: заметили заметить
запад: запад
западный: западном
запуск: запуск
зарегистрировать: зарегистрировали
заря: зари
засветка: засветка засветки
затянуться: затянувшиеся
захватить: захватит
заход: захода
защитить: защитила
звание: звание
звезда: звезд звезда звезды
звездообразование: звездообразование звездообразования
звёздный: звездных
зелёный: зеленый
земля: земли
зеркало: зеркалом
знать: знать
зодиакальный: зодиакального зодиакальной зодиакальные зодиакальный зодиакальным
зоркость: зоркости
зрение: зрения
идея: идею
известный: известного известной
излучение: излучением излучения
измерение: измерения
изображение: изображение изображения
изучение: изучения
изучить: изучили
именно: именно
иметь: имеем имеют
имя: имени имя
индейский: индейского
инженер: инженер инженеры
инструктор: инструктором
интеграция: интеграции
интегрировать: интегрирована
интенсивно: интенсивно
интервью: интервью
интересный: интересным
инфракрасный: инфракрасного инфракрасном
ирак: ираке
искать: ищите
исключить: исключено
использование: использованием
использоваться: используются
испытывать: испытывает
исследование: исследование исследований
исследователь: исследователи
истинный: истинного истинным
история: истории
источник: источник источников
итого: итого
кадр: кадр
каждый: каждая каждую каждые каждый
камера: камера камеры
кассад: кассада
кеннеди: кеннеди
кикина: кикина кикиной
класс: классе
коить: коити
кольцо: кольцо
команда: команда
командир: командиром
комета: комет комета кометы
коммандер: коммандер
комментарий: комментариев
компактный: компактными
компаньон: компаньона
компенсация: компенсации
компьютерный: компьютерные компьютерных
конец: конец конца конце
корабль: корабле корабль корабля
коренной: коренная
корпус: корпуса
космический: космический космического космической
космонавт: космонавт космонавтов
космос: космос
который: которое которые
кпк: кпк
красивый: красивое
красноватый: красноватые
красный: красный
кроме: кроме
крупный: крупного
кстати: кстати
кудрить: кудря
курс: курсы
летать: летала
лететь: летела летящая
летний: летний летняя
лето: летом
лишь: лишь
ложный: ложный ложным
луна: лун луна луне
луч: лучей
любой: любой
любопытный: любопытную
магнетар: магнетара
май: мая
малый: меньшая меньшей
манна: манн
марс: марсе марсом
марсианский: марсианский
март: марта
мартовский: мартовского
марук: маруков
масса: массе массы
массив: массив
мастер: мастер
матрица: матриц матрице
матричный: матричных
мегапарсек: мегапарсека
мегапиксель: мегапикселей мегапикселя
мегапиксельный: мегапиксельных
медведица: медведицы
международный: международной
менеджер: менеджер
месяц: месяца месяцев
метровый: метровым
мечтать: мечтает
миллиард: миллиардами
минута: минут
мир: мир
миссия: миссией миссии
мкм: мкм
мкс: мкс
млечный: млечного млечному млечный
мнение: мнению
многий: многих
многократный: многократном
многочисленный: многочисленные
моделирование: моделированию моделирования
мозаика: мозаика мозаики
молекулярный: молекулярного
молодой: молодых
молочный: молочным
момент: момент
морской: морской
мочь: могут
мпк: мпк
мужество: мужество
мчс: мчс
мэя: мэя
наблюдать: наблюдаемая наблюдаемое наблюдаемые наблюдать
наблюдаться: наблюдаются
наблюдение: наблюдений наблюдения
награждение: награждением
название: названием
называть: называют
называться: называется
наиболее: наиболее
найти: найти
направление: направлением
например: например
настолько: настолько
настоящий: настоящий
настроить: настроена
находиться: находится
начало: начала начало
наш: нашей
небо: неба небе небо небу
небосклон: небосклоне
невиданный: невиданное
негласный: негласное
неделя: недель
незадолго: незадолго
немой: нем
необычайно: необычайно
необычный: необычная
нептун: нептуна нептуне
несколько: несколько
неудивительный: неудивительно
никакой: никакие
николь: николь
нить: нити
новолуние: новолуния
новосибирск: новосибирске
новосибирский: новосибирскому
новый: новое новые новый новым
носитель: носителе
ночь: ночь
ноябрь: ноября
нужда: нужд
нужно: нужно
оба: обоих
обеспечивать: обеспечивает
обзор: обзоре
обзорный: обзорный
обладать: обладает
облако: облака облако
область: области
обнаружить: обнаружили
оборудование: оборудования
образец: образец
обращаться: обращающихся
обращение: обращения
обсерватория: обсерватории обсерватория
обуславливать: обуславливает
обусловить: обусловленная обусловлены
обучение: обучению
обширный: обширного
общий: общим
объединить: объединенные объединенным
объединиться: объединились
объяснение: объяснение
обычно: обычно
обычный: обычным
огромный: огромная огромным
один: одном
однако: однако
ожидание: ожидании
ожидать: ожидает
ожидаться: ожидается ожидаются
означать: означает
оказаться: оказавшись оказалось
около: около
окончить: окончила
окрестность: окрестностях
октябрь: октября
онап: онапу
опасение: опасения
операция: операций
оптика: оптики
оптический: оптического оптическое
орбита: орбите
осень: осенью
ослабнуть: ослабла
оснастить: оснащен
основа: основам основой
основное: основном
основной: основной
осуществление: осуществлении
отбор: отбор
отдельный: отдельным
откуда: откуда
отличить: отличить
отменяться: отменяется
относительно: относительно
отношение: отношениях
отражённый: отраженный
отряд: отряд отряде
оттенок: оттенка оттенок
отток: отток
офицер: офицер
охладить: охлажден
охлаждение: охлаждения
охота: охота
оценить: оценить
очень: очень
очередь: очередь
пара: паре
пау: пау
первоначальный: первоначальным
первый: первой первую первые
перекрёстный: перекрестных
перепутать: перепутать
пересекаться: пересекается
периодически: периодически
периодический: периодических
пехота: пехоты
пилот: пилот
пилотировать: пилотируемого
пирамидальный: пирамидальной
пк: пк
плавание: плаванию
планетарий: планетарию
племя: племени
плодовитый: плодовитая
площадь: площадь
побережье: побережья
побывать: побывать
повредить: повредить
повсеместно: повсеместно
подкачать: подкачали
подключить: подключена
подозревать: подозревая
подписать: подписанного
подсветить: подсвеченные
подтверждать: подтверждает
подчёркивать: подчеркивающий
позволить: позволило позволит
позиционирование: позиционирования
показывать: показывает
поле: полем
полиатлоно: полиатлону
полициклический: полициклические
полковник: полковник
полнолуние: полнолуния
полный: полной полных
получение: получение
получить: получил получила
полушарие: полушарии полушария полушариях
полёт: полет полета полетов
помеха: помехой
помешать: помешает
помимо: помимо
помощь: помощи помощью
поперечник: поперечнике
порядок: порядка порядок
посещение: посещения
последующий: последующих
посмотреть: посмотрите
потребовать: потребовал
поэтому: поэтому
появиться: появились
появляться: появляется появлялись
прародитель: прародитель
превзойти: превзойдет
предел: пределами
предмет: предметом
предполагать: предполагают
предположить: предположили
предубеждение: предубеждениям
прежде: прежде
преимущество: преимущество
привет: привет
приводниться: приводнился
приготовить: приготовили
признаться: призналась
пример: примером
примерно: примерно
примечательный: примечателен
принципиально: принципиально
природа: природы
природный: природное
присвоить: присвоено
пристальный: пристальнее
приходиться: приходится
причём: причем
пробивать: пробивать
провал: провалами провалов провалы
проверить: проверить
проверка: проверки
провести: проведенного провел провели
проводить: проводили
проводник: проводником
программа: программе программы
продолжаться: продолжалась
происходить: происходят
пройти: прошла
промежуточный: промежуточной
проникнуть: проникнуть
пропустить: пропущены
проследить: проследить
просто: просто
протекать: протекает протекают
протопланетный: протопланетные
проходить: проходящей проходящем
процесс: процесс процессе
прощать: прощай
проявить: проявленные
пузырчатый: пузырчатые
путь: пути путь
пчела: пчела
пылевой: пылевые
пыль: пыли
пыльца: пыльцы
пытаться: пытайтесь
пятно: пятна
пятый: пятого
пять: пяти пятью
работа: работе работы
работать: работает работала работать
равноденствие: равноденствий равноденствия
радиоведущий: радиоведущей
радиоэфир: радиоэфира
размер: размерами размеру
разрешение: разрешением
район: районе
ракета: ракете
рамка: рамках
ранее: ранее
распознавание: распознавания
расположить: расположенное расположенных
рассвет: рассвет рассветом
рассмотрение: рассмотрении
расстояние: расстоянии
рафтинг: рафтингу
реальный: реальном
регулярный: регулярными
режим: режиме
результат: результат результатом
рекордный: рекордная рекордные
рентгеновский: рентгеновских рентгеновского
решение: решением
родиться: родилась
рождаться: рождаются
розоватый: розоватого
роскосмос: роскосмоса роскосмосом
российский: российском
россия: россии
рубин: рубин
ручной: ручной
сам: самом
самый: самое
сборка: сборки
сверхветер: сверхветер
сверхмассивный: сверхмассивной сверхмассивные
сверхновый: сверхновая сверхновой сверхновых
свет: свет света светом
световой: световые световых
свечение: свечение
свой: своего своей своим
свыше: свыше
сделать: сделаны
северный: северном
сегмент: сегменте сегментов
сентябрь: сентября
сентябрьский: сентябрьского
сигара: сигара сигаре
сильно: сильно
симуляция: симуляции симуляций
система: систем системе систему системы
сквозь: сквозь
скопление: скоплений
скорость: скорость
скрывать: скрывает
слияние: слияния
слово: словам
сложность: сложности
служить: служить
случай: случае
смотреть: см
смочь: сможет
снимка: снимок
снимок: снимка снимки
снятой: снятые
сняться: сняться
собирать: собирать
событие: событие события
совместительство: совместительству
согласно: согласно
соглашение: соглашения
содержать: содержащие
созвездие: созвездия
создать: создав
солнечный: солнечной солнечный
солнце: солнца
соревнование: соревнование
сосед: соседом
состав: составе
состоять: состоит
спасатель: спасатель
спектр: спектра
специалист: специалистов специалисты
специальность: специальностям
специальный: специальном
спиральный: спиральная спиральной
сплошной: сплошных
спонтанный: спонтанным
спорт: спорта
сразу: сразу
средний: средних
стабильный: стабильнее
станция: станции
стартовать: стартовавшей
стать: став стала станет
странный: странное
стрекоза: стрекозы
сумеречный: сумеречное
сумерки: сумерки
сутки: суток
суточный: суточного
сформировать: сформирован
считывание: считыванием
сша: сша
также: также
такой: такое
такойсистема: такойсистемы
тбайт: тбайт
телескоп: телескоп телескопа телескопы
тема: темой
тестировать: тестировать
технический: технических
течение: течение
титан: титаном
толщина: толщину
тонкий: тонкого
тонна: тонны
точка: точке
точный: точный
транзиентный: транзиентное
транность: транности
треугольник: треугольнике
три: трех
тропик: тропиках
туманность: туманность
тусклый: тусклый
тяжёлый: тяжелых
тёмный: темное темном
тёплый: теплый
увидеть: увидеть
углеводород: углеводороды
угол: углом
удаться: удастся
узкий: узкие узком
украсить: украсит
ультрафиолетовый: ультрафиолетового
уникальный: уникального уникальный
управление: управления
условие: условиях
установка: установка установки
устройство: устройство
уступать: уступает
уточнить: уточнить
участник: участник
участница: участница
участок: участка участке
учиться: училась
учёный: ученые ученых
уэбб: уэббом
уэбба: уэбб уэбба
фаза: фазы
фактически: фактически
февраль: февраля
физика: физики
фильм: фильма
фильтр: фильтрами фильтров
флорида: флориде флориды
форма: форме формы
формироваться: формируется
фото: фото
фотоаппарат: фотоаппарат
фотография: фотографии
фотометрический: фотометрическими
фотоприёмник: фотоприемник
фотоприёмный: фотоприемное
хаббнуть: хаббла
хирон: хирона
хороший: хороших
центр: центр центра центре
центральный: центральной
цифровой: цифровое
чанъэ: чанъэ
час: часа
частица: частиц частицы
частность: частности
частота: частотой
частый: чаще
часть: части
четыре: четырех
четырёхмесячный: четырехмесячной
чёрный: черная черной черные черных
шаттл: шаттле
шестнадцать: шестнадцать
шестой: шестого
широта: широтах
школа: школе
шлейф: шлейф
эволюция: эволюция
экипаж: экипаж
эклиптика: эклиптике
экономист: экономист
экспедиция: экспедиции экспедиций
экстремальный: экстремальная экстремальные
элемент: элементов
эмиссия: эмиссия
этот: эта
эффект: эффектов
юбилей: юбилей
южный: южного
юный: юный
юриевич: юрьевна
юрий: юрия
явление: явление явлением
являться: является
ядро: ядрах ядре
японский: японского
яркий: яркий ярче
яркость: яркости
