абсолютно: абсолютно
активный: активного активной
александр: александр
альтернативный: альтернативные
альфа: альфа
аминхондриальный: аминхондриальные
амитохондриальный: амитохондриальные амитохондриальным
амёба: амёб
анализ: анализа
анаэробный: анаэробных
аппарат: аппарат
армен: арменом
арх: арх
архейной: архейное
архейном: архейном
архейный: архейного архейные архейный архейным архейных
архея: археи архей архею архея археями археях
асгарда: асгард асгарде
асгардархея: асгардархеи асгардархей асгардархею асгардархея асгардархеями
аспект: аспект аспекта
атмосфера: атмосфере атмосферы
бактериальный: бактериальная бактериального бактериальной бактериальному бактериальные бактериальным бактериальными бактериальных
бактерия: бактерии бактерий бактерию бактерия бактериям бактериями
безумно: безумно
безусловно: безусловно
белка: белки
белковый: белковой белковые
белок: белкам белков
беседа: беседы
беседовать: беседовали
бинарный: бинарного
биолог: биологи биологом
биологически: биологически
биологический: биологический
биология: биологии
биосинтез: биосинтезом
биотехнологический: биотехнологической
близкий: ближайшие ближайшими ближе
бог: бог бога боги богов
богатый: богатые
болотный: болотной
больший: большая большие большую
большинство: большинство
большой: большого большое большой велики
борис: борис бориса
буквально: буквально
бывать: бывает
быстро: быстро
быть: будем будете
важно: важно
важность: важность
важный: важна важная важное важные важный важных
вариант: варианта
вблизи: вблизи
вдаваться: вдаваясь
вдогонку: вдогонку
великий: великий
верно: верно
вернуться: вернемся вернусь
верный: вернее
вероятно: вероятно
вероятность: вероятность
версия: версии
весь: весь всей всем всему вся
весьма: весьма
ветвь: ветвей
ветка: ветка ветками ветке ветки
вещество: веществ
вещь: вещи вещь
взаимодействовать: взаимодействуют
взаимоотношение: взаимоотношений взаимоотношения
вид: виде виду виды
видеозапись: видеозапись
видеть: видим
видеться: видится
видимо: видимо
видимый: видимому видимых
википедия: википедия
вирус: вирусами вирусов вирусы
вклад: вклад
включать: включает
включая: включая
вложить: вложили
вместе: вместе
вмешаться: вмешаться
вне: вне
внимание: внимание
внимательно: внимательно
вносить: вносил вносят
внутри: внутри
внутриклеточный: внутриклеточное внутриклеточные внутриклеточных
внутрь: внутрь
водоросль: водорослей водоросли
возможность: возможность
возможный: возможным
возникать: возникает возникают
возникновение: возникновение возникновении возникновению возникновения
возникнуть: возникли
вокруг: вокруг
волноваться: волноваться
вообще: вообще
вопрос: вопрос вопроса вопросом вопросы
восприниматься: воспринималась
впервые: впервые
вперёд: вперед
вполне: вполне
враг: врагов
время: времени время
вроде: вроде
вселенная: вселенной
встроить: встроено
вступить: вступил вступили
всякий: всякие всякий всяких
всяческий: всяческое
всё: всё
вторично: вторично
вторичный: вторичные
второе: второе
второй: вторая второй
вы: вами
выбрасывание: выбрасывание
выглядеть: выглядит
выгода: выгоду
выдающийся: выдающимся
выжидать: выжидала
выжить: выживет выжить
выполнять: выполняя
выражаться: выражаясь
выходить: выходит
выше: выше
выявляться: выявляются
выясниться: выяснилось
выясняться: выясняется
вёз: вёзе
галактика: галактике
ген: ген генов гены
генетический: генетическое генетическом
геном: геном генома геноме геномом
гибрид: гибриды
гигантский: гигантские
гидросфера: гидросфере
гидротермальный: гидротермальный
гипотеза: гипотез гипотеза гипотезами гипотезы
глубокий: глубже глубокая
глубоко: глубоко
говорить: говорили говорим говорит говорить говорю говоря говорят
год: годами годов году годы лет
голова: голову
гораздо: гораздо
горячий: горячие горячих
градиент: градиенты
граф: графа графе
гренландия: гренландией
греческий: греческого
гриневич: гриневич
грубо: грубо
группа: группы
группироваться: группируются
давать: давайте дает дающее
давно: давно
далее: далее
далеко: далеко
дальнейший: дальнейшее дальнейшие
дальний: дальние
далёкий: дальше
данный: данном
датировка: датировок
дать: дала дали дало дать
два: две двум двух
дебатироваться: дебатируется
дебаты: дебатов дебаты
дело: деле дело
дельта: дельта
день: дне
дерево: дерева дереве дерево деревом деревья деревьях
деталь: детали деталях
дин: дин
дифференциация: дифференциации
днк: днк
добавить: добавить добавьте
добавлять: добавляют
довольно: довольно
договориться: договорились
дойти: дойдем
долгий: долгие
долго: долго
должный: должны
доля: доли
дом: дому
домен: домен домена доменов
дополнительный: дополнительные
допустить: допустим
достаточно: достаточно
достигнуть: достигнем достигнуть
достижение: достижением
драматический: драматическое
драматично: драматично
древний: древних
древо: древе
друг: друг друга
другой: другие другим других другое другую
думать: думать думаю
евгений: евгением евгений
ежели: ежели
еретический: еретическая
живой: живой
жизнь: жизни жизнь
жить: живут живущих жить
завершение: завершения
завершить: завершим
зависеть: зависит
заглатывать: заглатывали заглатывать
заглотить: заглотил
задаться: зададимся
задействовать: задействованы
задумываться: задумываясь
заключить: заключены
закончить: закончить
закруглять: закругляющее
закрытый: закрыты
заместиться: заместиться
заметить: заметим
заметно: заметно
замешать: замешана
замок: замок
заниматься: занимаются
зарождение: зарождении
заря: заре
звучать: звучал
здравоохранение: здравоохранения
здравствуйте: здравствуйте
зелёный: зеленые зеленых
земля: земле
знаменитый: знаменитым
знать: знаем знает знать знаю
значит: значит
значительный: значительная значительной
зой: зоев
зоя: зои
зрение: зрения
зыбкий: зыбкую
идея: идеи идея
идти: идет
иерархия: иерархии
известно: известно
известный: известной известные
изменение: изменение
изначальный: изначальные
изучать: изучать изучают
изучение: изучение изучения
илл: илл
именно: именно
именовать: именовать
иметь: имеем имели иметь имею имеют
иметься: имеется имеются
имя: именам
иначе: иначе
инновация: инновация инновациями
институт: институтов
интервью: интервью
интересно: интересно
интересный: интересном интересную интересны интересный
интересоваться: интересоваться
интрига: интригу
интуитивно: интуитивно
информационный: информационная
информация: информации информацию
ион: ионов
исключение: исключением исключения
исключительно: исключительно
исключить: исключены
исследование: исследования
исследователь: исследователей
исследовать: исследовали
истинный: истинный
история: историю история
источник: источник источники источников
исчезнуть: исчезли
итак: итак
казаться: кажется казалось
какой: какие каким каких какого
канал: канале
кандидат: кандидатов кандидаты
карл: карл карлом
карла: карла
картина: картину
картинка: картинки
картировать: картировано
карьера: карьеры
касаться: касается
катастрофа: катастрофа катастрофой
кислород: кислород кислорода
кислородный: кислородная кислородной кислородный
кислота: кислот
классический: классическом
клетка: клетка клетках клетке клетки клетку клеток
клеточный: клеточной клеточному клеточные
книжка: книжках
кодировать: кодирующих
количество: количество
коллега: коллегами
коллектив: коллектив
комбинация: комбинация
комментарий: комментария
компартментализовать: компартментализованы
комплекс: комплексы
компонент: компонентам компоненты
конец: конце
конкретный: конкретного конкретной конкретные
консервативный: консервативных
консорциум: консорциумами консорциумы
контекст: контексте
контринтуитивно: контринтуитивно
контур: контурах
конфликт: конфликт
концентрация: концентрация
координация: координация
корень: корня
короткий: коротких
который: которая которого которое которой котором которую которые который которым которыми которых
край: крае
крайний: крайней
красивый: красивые
красный: красных
круг: круга
кстати: кстати
кто: кого
кунин: кунин куниным
лаборатория: лаборатории
левый: левая
лезть: лезть
линн: линн
липид: липиды
литература: литературе
лока: локи
любим: любим
любить: любят
любопытный: любопытную
лямблия: лямблий
маленький: маленькие маленький
мало: мало
маловероятный: маловероятное маловероятный маловероятным
малый: малейшему малых
маргулис: маргулис
марков: марков
масштаб: масштабах
математический: математический математическими
машинерия: машинерия
мембрана: мембран мембрана мембранам мембранами мембраны
мембранный: мембранной
менее: менее
мера: мере
местность: местность
место: места место
метаболизм: метаболизм метаболизма метаболизме
метод: методы
микроскоп: микроскоп микроскопом
миллиард: миллиарда миллиардов миллиарды
мир: мира мире
митохондриальный: митохондриальные
митохондрия: митохондрии митохондрий митохондрия митохондриям митохондриях
мифология: мифологии мифология
многие: многие
многий: многим многих
многое: многое
моделирование: моделирования
модель: модели модель
мой: моей моими моих
молекула: молекул молекулы
молекулярный: молекулярных
момент: момент
морской: морском
морфология: морфологии
мочь: могла могли могло могут можем
мулкиджанян: мулкиджаняном
мы: нам нами
наблюдать: наблюдаем наблюдаемых
наблюдаться: наблюдается
набор: набор
наверное: наверное
надеяться: надеюсь
назад: назад
название: название
назвать: назвали названы
называть: называем называемые называемый называли называть
называться: называется называются
наиболее: наиболее
накладывать: накладывает
намного: намного
наоборот: наоборот
например: например
нарисовать: нарисовано
нарушаться: нарушалась
насколько: насколько
наслать: нашли
наследство: наследство
настоящий: настоящее настоящему настоящий
наступать: наступает
наталья: натальи
наука: наука
научный: научной
национальный: национального национальных
начало: начала начале начало
начать: начали
начаться: началось
наш: наша наше нашей наши нашим наших нашу
невежественный: невежественный
невероятно: невероятно
недавно: недавно
недалеко: недалеко
недопустимый: недопустимое
независимый: независимы
неизвестно: неизвестно
некий: некая некий некое
некоторый: некоторая некотором некоторыми некоторых
немало: немало
немедленно: немедленно
немногий: немногих
немного: немного
немножко: немножко
ненужный: ненужного
необходимость: необходимости
необходимый: необходимый
неоднозначный: неоднозначные
непонятно: непонятно
непосредственно: непосредственно
неправильно: неправильно
непредставимый: непредставимо
непрерывный: непрерывном
непросто: непросто
непростой: непростое
нередко: нередко
несколько: нескольких несколько
несовместимость: несовместимости
неточность: неточности
нетривиальный: нетривиально нетривиальные
неферментативный: неферментативная
неясно: неясно
нигде: нигде
никакой: никакая никаких никакой никакому
никто: никто
ничтожно: ничтожно
новизна: новизна
новинка: новинку
новый: нового новое новой новыми
норвегия: норвегией
нордический: нордическая
нормальный: нормальных
нота: ноте
нравиться: нравится
нужно: нужно
нужный: нужным
нуклеиновый: нуклеиновых
нынешний: нынешних
оба: обоих
обезвреживание: обезвреживанию
обеспечивать: обеспечивают обеспечивая
обеспечить: обеспечить
обитаемый: обитаемых
область: области
обмен: обмен
обнаруживаться: обнаруживается
обнаружить: обнаружены
обнаружиться: обнаружились
обозвать: обозвали
обозначать: обозначающий
оболочка: оболочка
обострить: обострить
образ: образом
образование: образованием
образовать: образуют
образовывать: образовывать
обратиться: обратимся обратиться
обстоятельство: обстоятельств обстоятельствах обстоятельство
общество: обществе
общий: общая общего общем общему общий общих
объяснение: объяснение
объём: объему
обычно: обычно
обязательно: обязательно
ограничение: ограничений
ограничивать: ограничивающей
ограничить: ограничены
огромный: огромное огромные
один: одна одни одной одну
однако: однако
однобоко: однобоко
однозначно: однозначно
однозначный: однозначного
одноклеточный: одноклеточных
озеро: озера
означать: означает
оказаться: оказалась
оказываться: оказывалось
океан: океана
около: около
олимп: олимпа
они: ними
оно: оно
опасаться: опасаюсь
опасение: опасение
опасность: опасности
операциональный: операциональные
оперировать: оперируем
определение: определению
определить: определены
определённый: определенный
оптимизм: оптимизма
оптимистический: оптимистической
опыт: опыты
органелла: органеллы
организация: организации
организм: организмов организмы
организовать: организована организованы
ориентировочно: ориентировочно
осадочный: осадочных
осмысленно: осмысленно
осмыслить: осмысленные
основание: основания
основать: основанные основаны
основное: основном
основный: основных
особенно: особенно
особый: особый
осознавать: осознают
оставаться: остаемся
остальной: остальном
остаток: остатки
остроумно: остроумно
ответ: ответа ответы
ответить: отвечу
отвечать: отвечает
отвратительный: отвратительного
отдельно: отдельно
открытие: открытия открытиями
открыть: открыты открыть
откуда: откуда
отличаться: отличаются
отличие: отличия
отлично: отлично
относительно: относительно
относиться: относиться
отношение: отношение отношению
отражать: отражают
отсылать: отсылает
отходить: отходит отходят
охранять: охраняющий
очень: очень
паноптикум: паноптикум
парадигма: парадигме
паразит: паразитов
партнёр: партнера
первичный: первично первичные первичный первичными первичных
первый: первая первого первое первой первые первый первых
перевод: переводе
передача: передачи передачу
передний: переднем
перенести: перенесены
переплетаться: переплетаются
перестройка: перестройки
переходить: переходим
пионер: пионер
питание: питанием
плазматический: плазматические
план: плане
планета: планет планете
пластида: пластидам
плохо: плохо
повестись: повелось
повод: поводу
повторить: повторить
повыситься: повысилась
поглотить: поглотила
поговорить: поговорить
поддерживать: поддерживает поддерживают
подлежать: подлежит
поднять: подняли
подобие: подобию
подозревать: подозреваю
подразумеваться: подразумевается
подчеркнуть: подчеркну
подытожить: подытожить
пожалуй: пожалуй
пожалуйста: пожалуйста
позаимствовать: позаимствовать
позволить: позволило
позволять: позволяет позволяющие
поздний: позднее поздний
пойти: пойдет
показать: показали показало
показывать: показывают показывающий
полезно: полезно
полностью: полностью
полный: полной
положить: положил
поломка: поломки
полтора: полтора
полупроницаемый: полупроницаемыми
получаться: получается
получить: получили получить
пользоваться: пользуясь
помочь: помогли
помощь: помощи
понимание: понимание
понимать: понимаем понимают
понятно: понятно
понять: понял понять
поправить: поправите поправьте
попробовать: попробуем
попросту: попросту
популярный: популярной
попытаться: попытаюсь
попытка: попыток
поразительный: поразительное поразительный
поскольку: поскольку
последний: последнего последнему последние
последовательность: последовательностей последовательностях
постоянно: постоянно
построить: построено построил
потеря: потери
потерять: потеряли
похоже: похоже
похожий: похожего
почва: почву
почему: почему
починка: починки
появиться: появилась появились появиться
появление: появление появления
правильно: правильно
правый: правая
практически: практически
предложить: предложена
предмет: предметом
предок: предка предками предку предок
предопределить: предопределено
представитель: представителей представители
представление: представления
представлять: представляем представляет
представляться: представляется
предшественник: предшественники
предшествовать: предшествует
прежде: прежде
преимущество: преимущества
преобразование: преобразованию преобразования
претерпевать: претерпевают
привести: привело
привлекательно: привлекательно
приглядеться: приглядеться
признать: признать
прийти: придем
примерно: примерно
примитивный: примитивному примитивный
принадлежать: принадлежало
принимать: принимают
принципиально: принципиально
принципиальный: принципиальная принципиальное принципиальные принципиальных
принять: принято
приобрести: приобрели
приобретение: приобретение
природа: природа
прислать: пришли
причислять: причисляю
приятно: приятно
проблема: проблем проблема проблеме проблемы
проводиться: проводятся
проглатывать: проглатывала
проглотить: проглотил проглотила
прогресс: прогресса
продвинуть: продвинутой продвинутом
продукт: продуктов продуктом продукты
произойти: произойти произошел произошла произошли произошло
происходить: происходил происходило происходим происходит происходить происходят происходящие
происхождение: происхождение происхождением происхождении происхождению происхождения
пройти: прошло
прокариот: прокариот прокариотам прокариотами прокариоты
прокариотический: прокариотическая прокариотических прокариотической
промежуток: промежутков
проникать: проникать проникают
прослеживать: прослеживаемые
прослеживаться: прослеживается
простейшее: простейшее
просто: просто
простой: простейших простое простой проще
пространственно: пространственно
протекать: протекал
протеобактерия: протеобактерии протеобактерий протеобактерию протеобактериями
противоположность: противоположность
проходить: проходя
процент: процента
процесс: процесс процесса процессах процессе процессы
прошлый: прошлый
прыгать: прыгаем прыгают
пускай: пускай
путём: путем
работа: работу
развитие: развитие
разговор: разговор
разнести: разнесенных
разнообразие: разнообразия
разнообразный: разнообразны
разный: разному разную разные разных
разобраться: разобраться
разойтись: разошлась разошлись
ранг: ранг
ранний: раннее раньше
распространять: распространяют
рассказать: расскажу
рассматриваться: рассматривается рассматривались рассматривался
раствориться: растворились
растение: растений
расцвести: расцвести
реализоваться: реализовалась
реальный: реальный реальным
редкий: редких
результат: результате результаты
резюме: резюме
репарация: репарации
репликатор: репликатора репликаторы
репликация: репликации репликация
реплицироваться: реплицируется
репродукция: репродукции
речь: речь
рибосома: рибосом
рибосомный: рибосомных
рис: рис
рнк: рнк
родственник: родственниками родственники родственников
роль: роль
ряд: ряд ряда
сам: само самом
самый: самые самый самых
свет: свете
свидание: свидания
свой: своей свой
свойство: свойства
связанный: связанную
сделать: сделали
себя: собой
сегодня: сегодня
секундочка: секундочку
семейство: семейство
серийный: серийного
серьёзно: серьезно
серьёзность: серьезностью
серьёзный: серьезные серьезный серьезных
сестра: сестры
сжатый: сжаты
сигнал: сигнал
сидеть: сидит сидят
симбиоз: симбиоза
симбионт: симбионт
симбиотический: симбиотические
синий: сине
система: система системы
ситуация: ситуации ситуация ситуациях
скажем: скажем
сказать: скажу сказали сказать
сказываться: сказывается
скандинавский: скандинавских скандинавской
скачок: скачок
скелет: скелетом
скепсис: скепсис
склонный: склонен
сколько: сколько
скорее: скорее
слабый: слабым слабыми
слева: слева
след: следов
следовать: следует
следующий: следующее следующие следующий следующим следующую
слишком: слишком
слияние: слияние слияния
слово: слов словах слово
сложно: сложно
сложность: сложности
сложный: сложна сложнее сложную сложные сложным
слой: слоях
случаем: случаем
случай: случае случай
случиться: случилось
слушатель: слушателей слушателям
смешанный: смешанными
смешение: смешение
смотреть: см смотреть смотрите
смысл: смысл смысле
сначала: сначала
соблазнительно: соблазнительно
собственно: собственно
собственный: собственную
событие: событие событии событий события
совершенно: совершенно
совместимый: совместимо
современный: современные
содержание: содержание содержания
содержать: содержат
содержимое: содержимое
сомнение: сомнений сомнению сомнения
сообщество: сообщества
соответственно: соответственно
составлять: составляют
состоять: состоит
сотня: сотен
сотрудник: сотрудник
спасибо: спасибо
спекуляция: спекуляция спекуляциями
специалист: специалистов
справа: справа
спросить: спросить
сравнение: сравнение сравнений сравнению
сравнительно: сравнительно
сразу: сразу
среди: среди
среднее: среднем
стадия: стадии
становиться: становится
старый: старой
стать: стали стало
статья: статьях
ствол: ствол ствола
степень: степени
стоить: стоило стоит
столь: столь
сторона: сторону стороны
страшный: страшный
структура: структур структуру структуры
суждение: суждение
суперсолёный: суперсоленые
существенно: существенно
существенный: существенного существенный
существование: существовании существования
существовать: существовать
существующий: существующих
сущность: сущности
схема: схемы
сценарий: сценарии сценарий сценариям сценариями
счастие: счастья
счастливый: счастливы
считать: считаете считаю считают
считаться: считались считалось
сша: сша
съесть: съел съест съесть
таить: таит
также: также
таки: таки
такой: такая такие таким такое таком такую
таксономический: таксономической
твориться: творилось
твёрдый: твердой
тема: темой
теоретический: теоретические
теория: теория
термин: термин терминами
терминология: терминология
терпение: терпение
тесно: тесно
технический: техническом
течение: течение
тип: тип типа
типичный: типичная
тор: тор
тот: те тех той тому
точка: точке точки
точно: точно
точный: точные точных
транскрипция: транскрипции транскрипция
трансляция: трансляции трансляция
транспорт: транспорт
требование: требований
требовать: требовал требует
треть: трети
трехдоменный: трехдоменная
три: тремя трех
троицкий: троицкого
туда: туда
тысяча: тысячах тысячу
тяжёлый: тяжелая
убедительно: убедительно
убедительный: убедительные
уверенный: уверен уверенным
угодный: угодно
удаться: удалось
удерживать: удерживают
удовольствие: удовольствием
узнать: узнаем
указание: указания
уметь: умели
унаследовать: унаследовали
упомянуть: упомянем упомянул упомянули упомянутое упомянуть
упорядочить: упорядочено
упрощение: упрощение
уровень: уровень уровне уровню
усвоить: усвоил
условие: условиях
усложнение: усложнение усложнению
услышать: услышал
устроить: устроены
уточняться: уточняться
участвовать: участвуют
учебник: учебниках
факт: факт
фантазия: фантазии
фермент: ферменты
физически: физически
фиксация: фиксация
филогенетика: филогенетики
филогенетический: филогенетические филогенетических филогенетического филогенетическое филогенетическом
филогения: филогении
форма: формы
фосфолипид: фосфолипидов
фосфолипидный: фосфолипидными
фото: фото
фотосинтез: фотосинтез фотосинтеза
фундаментальность: фундаментальности
фундаментальный: фундаментальная фундаментальном фундаментальному
функционирование: функционирование функционирования
функционировать: функционируют
функция: функции
характер: характер
хеймдалльархея: хеймдалльархеи хеймдалльархей
хеймдалля: хеймдалль
химера: химеры
химерный: химерная
химически: химически
химия: химию
хиральность: хиральность
хитрый: хитрые
хлоропласт: хлоропластам хлоропластов хлоропласты
хлорофилл: хлорофилла
ход: ходе ходу
хозяин: хозяевами хозяин
холодный: холодный
хороший: хорошего хороший
хотеть: хотел
хотеться: хотелось
хотя: хотя
хранение: хранения
хроматин: хроматин
хромосома: хромосомы
целостность: целостность
центр: центра
цианобактерия: цианобактерии цианобактерий
цикл: цикл цикла
цитоплазма: цитоплазму
цитоскелет: цитоскелет
частично: частично
частность: частности
часто: часто
часть: часть
человек: люди
человеческий: человеческом
четверть: четверть
число: числе
чёрненький: черненькие
шаг: шаге шагом
шанс: шанс
широко: широко
штерн: штерн штерна
эволюционист: эволюционисты
эволюционный: эволюционном эволюционных
эволюция: эволюции эволюция
эквивалент: эквивалент
экосистема: экосистемы
экстремальный: экстремальные
электронный: электронным
эмпирический: эмпирическими
эндосимбиоз: эндосимбиоз эндосимбиоза эндосимбиозе эндосимбиозов
эндосимбионт: эндосимбионтов эндосимбионты
энергетика: энергетику
энергетический: энергетическую
энергия: энергией
энзима: энзимы
эпоха: эпохи
этап: этап
это: этим
этот: эта этих этому
эукариот: эукариот эукариотам эукариотами эукариотах эукариотов эукариоты
эукариотический: эукариотическая эукариотические эукариотический эукариотическими эукариотических эукариотического эукариотической
эффективный: эффективную
являться: является являются
явно: явно
яд: яд яда
ядерный: ядерном ядерную ядерный
ядро: ядра ядро ядру
ясно: ясно
ясность: ясности ясностью
ясный: ясная
