август: августа
автоматический: автоматическом
автор: авторы
активизировать: активизировать
активность: активности активностью
алексей: алексей
аппарат: аппарат аппаратами аппаратов аппаратом аппарату
астероид: астероидов астероиды
астроновость: астроновости
астроном: астрономов астрономы
астрономический: астрономический
астрономия: астрономии
астроёлочка: астроёлочка
атака: атакой
атмосфера: атмосфер атмосфера атмосфере атмосферы
атмосферный: атмосферные
атомный: атомные
бабочка: бабочка
барицентр: барицентром
благодаря: благодаря
близкий: близкие
боде: боде
большинство: большинство
большой: большого большое
бомбардировать: бомбардируют
брильянт: брильянтами
будущий: будущая будущие
быстро: быстро
быстрорастущий: быстрорастущий
быстрый: быстрее
быть: будут
важный: важное важные
вдвое: вдвое
ведущий: ведущий
венера: венере
верхний: верхней верхние
взаимодействие: взаимодействием
взаимодействовать: взаимодействующие
вид: вид
видео: видео
видимый: видимыми
видный: видны
включая: включая
вновь: вновь
водород: водород
возможно: возможно
возможность: возможности возможность возможностями
возраст: возраст
вокруг: вокруг
волна: волн
восемь: восемь
восток: востоку
впервые: впервые
вращаться: вращается
время: времен временем времени время
вселенная: вселенной
вследствие: вследствие
всплеск: всплесками
вспышка: вспышек вспышки
всё: всё
вулкан: вулкан
выброс: выбросы
вывод: выводам выводу
выглядеть: выглядит
выделить: выделила
вызвать: вызваны вызвать
выраженный: выраженных
высадка: высадки
высокий: высокого высокой
высокоэнергичный: высокоэнергичных
выясниться: выяснилось
газ: газ
галактика: галактик галактика галактике галактики галактикой галактику
галька: галька
геологический: геологическую
гигант: гигантов
главный: главным
глаз: глазами
го: го
год: год года году годы лет
гость: гостей
гравитационный: гравитационного гравитационное гравитационной гравитационным
гравитация: гравитации
группа: группа
дальнейший: дальнейшем
датировать: датировать
дать: данные дать
два: две двух
двигательный: двигательной
двигаться: движется
движение: движению движения
двуликий: двуликий
двухлетие: двухлетию
действовать: действующий действуя
декабрь: декабря
делать: делающей
день: днем
десятилетие: десятилетие
деятельность: деятельность
джейм: джейм
джеймс: джеймс джеймса
джордж: джорджа
диапазон: диапазонах диапазоне
дифракционный: дифракционными
длина: длин
документ: документ
должный: должны
дополнение: дополнение
доставить: доставил
достаточно: достаточно
достигать: достигать достигающие
др: др
друг: друг другом
другой: других другое
дублировать: дублированные
дуга: дугу
дыра: дыр дыра дыре дыры
евклид: евклид
единственный: единственного
ежегодно: ежегодно
ежедневно: ежедневно
естественный: естественный
жидкий: жидкий
жидкость: жидкости
завершать: завершает
зависимость: зависимости
завязать: завязанное
заключаться: заключается
замечательный: замечательного
запас: запас
запечатлеть: запечатлено
запустить: запущен
заставлять: заставляет
зафиксировать: зафиксировал зафиксировать
заявлять: заявляли
звезда: звезд звезда звездами
звездообразование: звездообразования
звёздный: звездная звездное звездные звездных
земля: земле землей земли
земной: земное земной
зеркало: зеркал
зирование: зирование
знаменитый: знаменитую
знать: знаем
значительно: значительно
зонд: зонд
известный: известного известные известных
излучать: излучает
излучение: излучение
измерение: измерение
изначально: изначально
изображение: изображение изображений изображениях
изучать: изучать
изучение: изучения
изучить: изучил
иначе: иначе
инженер: инженеры
институт: институте
инструмент: инструмента инструментами инструментов
инструментальный: инструментальных
инфракрасный: инфракрасной инфракрасном инфракрасный инфракрасных
ио: ио
искажённый: искаженное
искривлять: искривляет
искривляться: искривляются
использовать: использовала использовали использовать используют
исследование: исследования
исследователь: исследователей исследователи исследователям
исследовательский: исследовательская исследовательскую
иссякнуть: иссяк
история: истории историю
источник: источников
исходящий: исходящими
итог: итоге
июль: июля
калифорнийский: калифорнийском
калифорния: калифорнии
каменный: каменный
камень: камни
кандидат: кандидат
каплан: каплана
карлик: карлик
квазар: квазар квазара квазарах квазаре квазаров
кеплер: кеплера
класс: класс
количество: количество
коллаж: коллажи
колонизация: колонизации
кольцо: кольца кольцо
команда: команда команду
комета: комет кометы
конец: конец концом
конструкция: конструкции
контролировать: контролировать
концентрировать: концентрируя
копейкин: копейкина
копия: копии
корабль: кораблей
корональный: корональные
космический: космические космический космическим космическими космического космическому
космология: космологии
космос: космос космоса космосе
который: которая которое которой которые который которых
красный: красной красную
кратер: кратеров кратеры
криогенный: криогенной
крупный: крупнейшие крупнейшим крупными крупных
кудрить: кудря
лаборатория: лаборатории
ландшафт: ландшафта
летний: летней
лето: летом
либо: либо
лина: лин
линза: линзой
линзирование: линзирование линзированием линзирования
линзировать: линзированной линзированных
ложенный: ложенные
локальный: локальная
луна: луне луной луны
лунный: лунное
луч: лучи
магелланов: магелланова магеллановы
максимальный: максимальном
маленький: маленькая меньше
малый: малое меньшая
марс: марс марса марсе
марсианский: марсианский марсианской
марсотрясение: марсотрясений
масса: масса массы
массивный: массивных
математика: математику
математический: математические
материал: материала
материя: материи материя
медленный: медленнее
мероприятие: мероприятия
местность: местности
метеорит: метеоритов
метеороид: метеороидов
метод: методы
мир: мир миром
миссия: миссии миссий миссия
мкм: мкм
млечный: млечном
многий: многих
многое: многое
молодой: молодыми
момент: момент
мочь: могут
мы: нам
наблюдать: наблюдая
наблюдение: наблюдений наблюдения
нагрев: нагреву
назад: назад
название: названием
назвать: названный
назначить: назначена
наименование: наименование
найти: найденных
намерение: намерениях
нарушить: нарушена
насколько: насколько
настоящий: настоящее настоящему
научный: научной
находить: находить
находиться: находится находятся находящееся
начало: началом
наш: нашей нашем
небесный: небесной
небо: небо
недоступный: недоступны
нейтронный: нейтронная
немного: немного
немой: нем
ненаблюдаемый: ненаблюдаемые
необходимо: необходимо
необходимость: необходимости
непосредственный: непосредственным
несколько: несколько
низкий: низкой
низко: низко
ниренберг: ниренберг
новогодний: новогодний
новый: новая новом новые новый новых
номер: номера
оба: обоими
обладать: обладает
облако: облака
область: области область областях
обнаруживать: обнаруживать
обнаружить: обнаружили
обозначение: обозначением
обработка: обработка
образ: образом
образование: образованием
обсерватория: обсерватории
обследовать: обследовал
общий: общая общей
объединить: объединенные
объект: объект объекта объектами объектов объекты
ограничение: ограничений
огромный: огромное
один: одним одно одной одном одну
однако: однако
ожидаться: ожидается
означать: означает
оказаться: оказались
оказываться: оказывается
околоземный: околоземной околоземных
окончание: окончание
окружающий: окружающего
они: ними
оно: оно
операция: операции
описывать: описывающий
определить: определить
опубликовать: опубликована
опуститься: опустится
орбита: орбитах орбите орбиты
орбитальный: орбитальный орбитальным орбитальных
организация: организаций
оснастить: оснащен
оставлять: оставляют
остаток: остатки остаток
отдалить: отдаленных
отклоняться: отклоняясь
открытый: открытых
открыть: открыл открыты
отличный: отличным
отменяться: отменяется
отмечать: отмечает отмечают
относительно: относительно
относительность: относительности
отправить: отправят
охлаждать: охлаждающей
оценивать: оценивали
оценить: оценить
очень: очень
очередь: очередь
падать: падающие
падение: падения падениями
паранальский: паранальской
первоначальный: первоначального
первый: первое первым первых
перевести: переведет
передний: переднем
пик: пика
пингвин: пингвин
план: плане
планета: планет планета планете планетой планету планеты
планетарный: планетарные
плотность: плотности
поблизости: поблизости
поверхность: поверхности поверхность
поглощение: поглощения
подвергаться: подвергается
подготовить: подготовить
подлёт: подлёте
подобный: подобные подобный
подсказка: подсказки
подсчитать: подсчитала подсчитали
подсчёт: подсчет
позволять: позволяет позволяло позволяют позволяя
поздний: позже
пока: пока
показать: показали
показывать: показывают
поле: поля
получить: получено получившей
полёт: полеты
помимо: помимо
помогать: помогают
помощь: помощью
понимание: понимания
пончик: пончик
пора: пор
портрет: портреты
порядок: порядка
посадка: посадка
посещение: посещения
последний: последнее последним
постепенный: постепенного
постулировать: постулирует
поэтому: поэтому
появляться: появляется
пояс: поясом
практически: практически
превышать: превышает
предназначить: предназначен
предоставлять: предоставляет
предполагать: предполагали
предсказать: предсказанное
представить: представило
представление: представление
представлять: представляет
препринт: препринтов
прибор: прибор
прибыть: прибыл
привести: привели привело
приводить: приводит
примерно: примерно
принять: принято
прислать: присланные
приурочить: приурочена
причина: причина
причём: причем
проблема: проблем проблемы
проведение: проведения
проводить: проводить
программа: программы
продолжать: продолжать
произвести: произвести
производить: производящая
произойти: произошло
пролетать: пролетая
проноситься: проноситься
пропасть: пропавшие
пространство: пространство
протозвезда: протозвездами
проходить: проходящие
прямо: прямо
публикация: публикация
пульсар: пульсара
путь: пути
путём: путем
пыль: пыль
пятно: пятна
пятьдесят: пятьдесят
работа: работе работу работы
работать: работавших работал
равнинный: равнинной
разглядеть: разглядеть
размазывать: размазывает
размер: размерами размерах
разместить: размещен
разница: разница разницы
разрешение: разрешения
рамка: рамках
ранее: ранее
ранний: ранней раньше
распадаться: распадаться
распо: распо
расположить: расположен
рассеянный: рассеянное
рассматривать: рассматривать
расстояние: расстоянии
расти: росла
расчёт: расчета расчетов
расширить: расширил
расширяться: расширяться
реактивный: реактивного
реальный: реальную
регион: регионы
регулярность: регулярности
редкий: редкую
режим: режим режиме
результат: результаты
рентгеновский: рентгеновское
решение: решение
робот: роботов
род: рода
рой: рой
рост: роста росту
рыба: рыбах
рядом: рядом
сам: сами
самый: самыми самых
сближаться: сближающиеся сближающийся
сближение: сближение
сверхновый: сверхновая сверхновой сверхновых
сверхскопление: сверхскопления
свет: свет света
световой: световые световых
свидетельствовать: свидетельствует
свободно: свободно
свой: своего своей своих
свыше: свыше
связать: связано
связь: связь
сгорать: сгорать
сгореть: сгорит
сгущение: сгущение
себя: собой
сей: сих
сейсмология: сейсмология
сейсмометр: сейсмометр
секунда: секунду секунды
сентябрь: сентябре
сервер: сервере
сергей: сергея
сила: силе
сильный: сильнее
синий: синяя
синхронизация: синхронизации
синхронизировать: синхронизировать
система: системы
сквозь: сквозь
скопление: скопление скоплений
скоро: скоро
скорость: скорости скоростью
слабый: слабые
следствие: следствий
слишком: слишком
слияние: слияния
сложность: сложности
слой: слои
случай: случае
смотреть: см
снимать: снимал
снимка: снимкам
снимок: снимке снимки
событие: событий
совершенно: совершенно
согласовываться: согласовываться
созвездие: созвездии
создавать: создает
создать: создать
солнечный: солнечной солнечные
солнце: солнце
сопротивление: сопротивление
составлять: составляет
спать: спящий
спектр: спектра
специалист: специалистов
спешить: спешить
спиралевидный: спиралевидная
спиральный: спиральной
способ: способ
спутник: спутников
сразу: сразу
среди: среди
стандарт: стандарт
стандартизировать: стандартизированное
становиться: становятся
старый: старые старыми
стать: стал станет
статья: статья
сти: сти
стыковка: стыковка
судьба: судьба
сутки: сутки
существовать: существует
существующий: существующие
сфера: сферой
считать: считают
считаться: считается считалось
также: также
такой: такие таким
тарантул: тарантул
телескоп: телескоп телескопа телескопом
тело: тел телами
темп: темпы
теория: теория
технологический: технологическом
течение: течении
течь: течет
тип: тип
толстяк: толстяк
тот: теми
точка: точка
точно: точно
точность: точность
точный: точное точный
традиционный: традиционный
туманность: туманности
тусклый: тусклое тусклыми
тяжесть: тяжести
тёмный: темной
тёплый: теплый
увеличивать: увеличивает
удалённость: удаленности
удалённый: удаленные удаленными
удар: ударам ударов
ударный: ударных
украсить: украсившую
уловить: уловленное
уникальный: уникальными
уран: уран
уровень: уровне
установить: установить
установка: установки
установленный: установленный
учёный: ученые ученых
уэбба: уэбб уэбба
февраль: февраль
физик: физиков
форма: форма
формироваться: формируется
фото: фото
фотография: фотографии
футбольный: футбольные
хаббл: хаббл
характеристика: характеристики
центр: центра центре
центральный: центральная центральное
ча: ча
чандра: чандры
часто: часто
частота: частоту
частый: частыми чаще
часть: части часть
часы: часы
чаша: чаши
человек: людей
четыре: четыре четырех
число: числе
чувствительность: чувствительности
чёрный: черная черной черных
эйнштейн: эйнштейном
экзолуна: экзолуны
экзопланета: экзопланеты
экономический: экономическую
эллиптический: эллиптическая эллиптическую
энергия: энергии
этот: этих
эффект: эффект
юго: юго
юпитер: юпитер
являться: является являясь
яйцо: яйцо яйцом
яркий: яркий ярких яркой яркую
ярко: ярко
ясно: ясно
