авторский: авторская
агентство: агентства
азот: азот азота
аккреционный: аккреционного
аккумулятор: аккумуляторов
активировать: активировать
активность: активности
алексей: алексей
анализировать: анализируя
аппарат: аппарат аппарата аппаратов аппарату
аппаратура: аппаратура
аргон: аргона
асимптотический: асимптотическую
астероид: астероид
астронавт: астронавты
астроновость: астроновости
астроном: астрономам астрономы
атака: атакой
атмосфера: атмосфере атмосферу атмосферы
балдж: балдж
белые: белые
белый: белого белых
беспилотник: беспилотник
беспилотный: беспилотного беспилотный
благодаря: благодаря
близко: близко
бо: бо
богатый: богатые
больший: большей
большинство: большинство
большой: большой большом
бортовый: бортовые
брильянт: брильянтами
будущий: будущие будущих
быстрый: быстрое
быть: будь
бюджет: бюджет
бюджетный: бюджетного
валинора: валинора
вблизи: вблизи
великий: великие
величина: величина величины
вертолетик: вертолетик вертолетика вертолетиком
вертолёт: вертолет вертолета
весь: всему
ветвь: ветвь
ветер: ветра
взлетать: взлетать
взлёт: взлета
взрыв: взрыв
вид: виде
видимый: видимого видимому
видный: видна
винт: винта винтами винтов
винтокрылый: винтокрылый
включать: включающую
вначале: вначале
внешний: внешних
вновь: вновь
водород: водорода
водяной: водяного
возможно: возможно
возможность: возможность
возможный: возможным возможных
вокруг: вокруг
волновой: волновых
вольф: вольфа
воровать: воровать
восемь: восемь
вперёд: вперед
вплоть: вплоть
вправо: вправо
время: временем время
всё: всё
второй: второй
входить: входит
выбор: выбора
выделить: выделило
вызывать: вызывает
выйти: выйдет
выполнение: выполнение
выразить: выражена
высокий: высоким
высота: высоту
выход: выхода
выявить: выявить
галактика: галактика галактике
галактический: галактическом галактическому
гало: гало
галька: галька
гарантировать: гарантировать
гелиевый: гелиевая гелиевого гелиевой гелиевые гелиевых
гелий: гелием гелий гелия
геликоптер: геликоптер
гибель: гибели
гигант: гигантов
гидрологический: гидрологического
год: год года годах году лет
голубой: голубого
гончий: гончих
гора: горе
гораздо: гораздо
горение: горение горения
готовиться: готовится
гравитационный: гравитационно
гравитация: гравитацию
график: график графиком
грузоподъёмность: грузоподъемности
грунт: грунте
давление: давления
дальнейший: дальнейшей
данные: данными данных
данный: данное
дата: дата
датчик: датчиков
дать: данные даст
два: две
двигатель: двигателей
движение: движения
двойной: двойной двойных
двуликий: двуликий
деймоса: деймоса
действие: действия
десятка: десятки
детектирование: детектирования
дефицит: дефицит дефицитом
джеймс: джеймса
джет: джета
диаметр: диаметр
диск: диска
долгосрочный: долгосрочный
должный: должен должна должно
долл: долл
дополнительный: дополнительное дополнительные
достаточно: достаточно
дуэт: дуэт
дыра: дыр дыра дыру дыры
дэниел: дэниелом
дюна: дюнами дюны
евклид: евклид
европейский: европейского европейской
ежедневно: ежедневно
ежедневный: ежедневного
езеро: езеро
ждать: ждать ждут
жизненный: жизненного
жизнь: жизни
завершать: завершает
зависимость: зависимости
задача: задачи
задержка: задержку
западный: западную
запуск: запуска
запустить: запущен
зарегистрировать: зарегистрированных
заряд: заряд
затем: затем
затрата: затрат
звезда: звезд звезда звездой звезды
звездообразование: звездообразование
звёздный: звездная звездного звездной
земля: земле земли
значительно: значительно
значительный: значительных
зодиакальный: зодиакальный
зона: зоны
идентифицировать: идентифицированы
известный: известных
изготовление: изготовлению
излучение: излучения
измерить: измерить
изображение: изображение изображения
изобретательность: изобретательность
изучение: изучение
иметь: имеет
иначе: иначе
инженер: инженеры
интересный: интересных
использовать: использовала используя
исправно: исправно
испускать: испускает
исследование: исследовании
исследователь: исследователям исследователями
исследовать: исследовать
итерация: итерации
июль: июль
каждый: каждого
казаться: казалось
какой: какие
каменный: каменный
карлик: карлик карлика карлики карликов
картографирование: картографирование
карьера: карьере
категория: категории
квадрокоптер: квадрокоптер
кислород: кислород кислорода
кислородный: кислородного
класс: класс класса
ключевой: ключевые
км: км
количество: количествах
коллаборация: коллаборация
коллапс: коллапса
кольцо: кольцо
комментарий: комментариев
компаньон: компаньона
компаньонка: компаньонки
компенсировать: компенсировать
конец: конце
конструктивно: конструктивно
конфигурация: конфигурация
концепция: концепция
кончик: кончик
координата: координаты
корма: кормы
корпус: корпусу
космический: космического
космос: космос
который: которая которого которое которой котором который которым которых
кпк: кпк
крайний: крайняя
красный: красного красное
кратер: кратера кратеров
крест: крест
кроме: кроме
кружочек: кружочком
крупный: крупная крупный
кудрить: кудря
лаборатория: лаборатории
ландшафт: ландшафтах
левый: левее
летать: летать летающего
лететь: летит
либо: либо
линия: линиями
лопасть: лопастей лопасти
лунный: лунное
льший: льших
лёд: льда
макет: макетов
маленький: меньше
мало: мало
малый: малой
марс: марс марса марсе марсом
марсианский: марсианский марсианским марсианских марсианского марсианской
марсоход: марсоход марсоходом
масса: масс масса массу массы
массивный: массивнее массивной массивные массивных
материал: материала
материя: материю
место: мест
металличность: металличностью
метан: метана
метановый: метанового
механизм: механизм механизма
миллиард: миллиарды
минимум: минимум
минута: минут
миссия: миссии миссию миссия
млечный: млечного
момент: момента
мониторинг: мониторинг
мочь: могут
мпк: мпк
наблюдаться: наблюдается
наблюдение: наблюдения
назвать: назвали
наземный: наземных
назначить: назначена
наличие: наличию
направление: направлении направления
настойчивость: настойчивость
научный: научных
находиться: находится находящегося
нахождение: нахождением
начало: начале
начать: начавших
наш: нашей
негласный: негласное
недавно: недавно
неделя: недель
нейтральный: нейтрального
некоторый: некоторые некоторых
необычный: необычная
неон: неона
неполный: неполные
непростой: непростых
несколько: несколько
несмотря: несмотря
несущий: несущих
низкий: низким низкой низкую
низкометалличный: низкометалличной
никакой: никакого
новичок: новичку
новонайти: новонайденная
новый: новые новый
номер: номера
носитель: носитель
ноябрь: ноябре
обеспечение: обеспечение
обладать: обладает
область: области
обнаружение: обнаружение обнаружения
обнаружить: обнаружена обнаруженная обнаруженной обнаружены обнаружили
обновить: обновленное обновленный
обозначать: обозначаемой
обозначение: обозначение
оборудование: оборудования
образование: образования
образовать: образуют
образоваться: образовавшихся
образовываться: образовываться
обращаться: обращающегося
обращение: обращения
обсерватория: обсерватории обсерваторий
обширный: обширной
общий: общая общей
ограничение: ограничений
один: одного одной одну
однако: однако
ожидание: ожидании
оказаться: оказалась оказалось
около: около
оконечность: оконечность
окончательный: окончательному
окрестность: окрестности
октокоптер: октокоптер
определение: определение
определить: определить
опубликовать: опубликована
орбита: орбите
орёл: орла
основание: основании
основное: основном
оставаться: остается
остальной: остальная
остаться: останется
отваживаться: отваживаемся
отвечать: отвечавшие
открытие: открытие открытия
отметить: отметить отмечено
относительно: относительно
отправка: отправки
отправлять: отправлять
отсюда: отсюда
охота: охота
очень: очень
память: памяти
пандемия: пандемии
панель: панели
параналя: параналь
парить: парящей
парсек: парсеках
первоначальный: первоначальной первоначальным
первый: первая первого первый
переводить: переводит
передать: передали
перелёт: перелета перелеты
переменный: переменные
перемещаться: перемещаться
перемычка: перемычкой
переформатировать: переформатировать
переходный: переходные
период: периодов
пингвин: пингвин
план: план
планета: планеты
планирование: планированием
плодовитый: плодовитая
поверхностный: поверхностная поверхностного поверхностную
поверхность: поверхности поверхность поверхностью
повлечь: повлек
повредить: повредил поврежден
погодный: погодных
подарок: подарком
подгруппа: подгруппу
подниматься: подниматься
подняться: поднялся
подобный: подобная
подсчитать: подсчитали
подтвердить: подтвердило подтверждено
подтверждение: подтверждения
позволить: позволили позволит
поздний: поздними
поиск: поисках
покинуть: покинувших
покой: покой
полагать: полагают
получить: получила получить
получиться: получившейся
польза: пользу
полёт: полета полету
помимо: помимо
пончик: пончик
попов: попов
попперо: поппером
попрощаться: попрощалось
поработать: поработать
портрет: портреты
посетить: посетит
последний: последнего последние последним
последовать: последуют
поставка: поставок
поступок: поступки
потеря: потери
потеряться: потерявшаяся
почему: почему
поэтому: поэтому
появление: появления
пребиотический: пребиотических
превратиться: превратился превратится
превращение: превращение
превысить: превысить
предварительный: предварительной
предел: предел пределах
предполагать: предполагает
предположительно: предположительно
предсказание: предсказания
представить: представлен
представление: представлении
представлять: представляет
предстоять: предстоит
прежде: прежде
преимущественно: преимущественно
прекращение: прекращения
преобладать: преобладает
преодолеть: преодолел
препринт: препринтов
прибор: приборов
прибытие: прибытия
прибыть: прибыть
привести: приведены
прийтись: пришлось
примерно: примерно
приметный: приметный
примечательный: примечательна
принадлежать: принадлежит
принести: принести
присутствие: присутствием
причём: причем
проверить: проверить
проверка: проверки
проверять: проверять
провести: провел провели
программа: программы
программный: программное
продолжать: продолжать продолжая
продолжительный: продолжительной
продолжить: продолжит продолжить
проект: проект проекта проекту
проектирование: проектированию проектирования
проектировщик: проектировщикам
произойти: произойдет
происходить: происходили происходит
происхождение: происхождения
пройти: прошла
просто: просто
просыпаться: просыпаться
протекать: протекающих
процесс: процесса процессов
путь: пути
пыльный: пыльных
пять: пять
пёс: псов
работа: работ работой работу
работать: работает
равный: равной
раз: раза
размер: размере размеры
разместить: размещенных
разный: разных
разрешение: разрешением
разрешить: разрешено
райя: райе
ракета: ракету
ранний: ранней
рано: рано
расположение: расположение
расположить: расположенную
расстояние: расстояние расстояниях
расход: расходы
расширение: расширение
реактивный: реактивного
редкий: редкий
резкий: резкими
результат: результате результатов
рекордный: рекордная
рентгеновский: рентгеновских рентгеновского
ретроградный: ретроградной
речной: речных
решение: решение
решить: решили
рой: рой
руководитель: руководитель
русеть: русел
сам: сама самой
самый: самая самым
сатурн: сатурна сатурну
сбор: сбор сбора
сверхгигант: сверхгигант сверхгиганта
сверхмассивный: сверхмассивной
свет: свет света
светило: светила
светить: светил
световой: световых
свидетельство: свидетельства
свой: свое своего своей свои своим
свойство: свойства
связь: связи
сдвинуть: сдвинуло
сдвоить: сдвоенными
сделать: сделал
себя: собой
сейсмический: сейсмической
сервер: сервере
сергей: сергей
серро: серро
сильный: сильными
система: систем системах системе системы
сказать: сказал
скорость: скорости скорость
слабо: слабо
следовательно: следовательно
следовать: следует
слияние: слияние слияния
сложность: сложность
слой: слоев слоя слоях
случай: случае
смещение: смещение смещения
смотреть: см
смочь: сможет
снимка: снимок
собирать: собирать
собранный: собранных
событие: события событиях
совершить: совершив совершит
совместно: совместно
согласно: согласно
согласоваться: согласуется
содержание: содержанием содержания
содержать: содержат содержит
созвездие: созвездии созвездия
создание: создание
сократить: сократить
солнечный: солнечной солнечных
солнце: солнца
сообщить: сообщило
соответствие: соответствии
соответствовать: соответствовать
соревнование: соревнование
состав: состава составе
составить: составило
составлять: составляет
состояние: состояние состоянии
состоять: состоит
спектр: спектр
спектральный: спектрального спектральными
спектрограф: спектрографа
спиральный: спиральная
спутник: спутника спутнике спутнику
сравнение: сравнению
среди: среди
среднее: среднем
средство: средств
ставить: ставит
стадия: стадиями
стать: стало
статья: статья
стационарный: стационарный
стоимость: стоимость стоимостью
стрекоза: стрекоза стрекозы
строй: строя
структура: структура
судьба: судьба
суровый: суровых
существовать: существуют
считаться: считается
счёт: счет
также: также
такой: такая такие таких
тедди: тедди
текущий: текущим
телескоп: телескоп телескопе
температура: температура температуре температуры
теоретически: теоретически
теория: теории
термоядерный: термоядерного термоядерное термоядерный
терять: теряют
тестирование: тестирование
тзанетос: тзанетос
тип: тип типа
титан: титан титана титане титаном титану
тот: те тому
точно: точно
три: трех
тропинка: тропинках
тяжёлый: тяжелее
увеличение: увеличение увеличения
углерод: углерод углерода
углеродный: углеродно углеродные
угловой: угловые
углублённый: углубленной
удалить: удалена
удаться: удалось
удивить: удивил
указывать: указывает
ультрафиолетовый: ультрафиолетового
условие: условиям условиях
условно: условно
успешно: успешно
установленный: установленного
утвердить: утвержден утверждена утверждены
участвовать: участвовали
уэбба: уэбба
фаза: фазы
фаэтон: фаэтон
февраль: февраля
финальный: финальный
финансирование: финансирование финансирования
финансовый: финансовый финансовых
фотографировать: фотографировать
хаббнуть: хаббла
характеризоваться: характеризуются
хватить: хватить
химический: химических химического
холм: холмах холмы
холодное: холодные
художник: художника
центр: центра
цепочка: цепочки
цикл: цикла
чандрасекар: чандрасекара
частность: частности
часть: часть частью
человечество: человечество
чили: чили
чёрный: черная черной черную черные черных
эволюция: эволюции
экзолуна: экзолуны
экстремальный: экстремальная экстремальной экстремальные
элемент: элементов
эпоха: эпоху
эскизный: эскизных
этап: этап этапе
эффективный: эффективная
южноафриканский: южноафриканский
южный: южной
являться: являются
ядро: ядра
яйцо: яйцом
январь: января
яркость: яркость
