абсолютно: абсолютно
абсолютный: абсолютной
авария: аварии авария
австралиец: австралийцы
адрон: адронов
академик: академика
аккуратно: аккуратно
активный: активную активные активный активных
актуальный: актуальная
аламос: аламосе
американский: американский американского
анализ: анализ
анализировать: анализировали
аналогичный: аналогичный
анатолиевич: анатольевич
английский: английскими
анизотропия: анизотропии
аннигилировать: аннигилирующих
аномалия: аномалии аномалию аномалия
антивещество: антивещества
антинейтрино: антинейтрино
античастица: античастицы
аренда: аренду
артур: артуру
асимметрия: асимметрией асимметрию
атмосферный: атмосферная атмосферные атмосферный атмосферным атмосферными атмосферных
атом: атомы
база: база базе базой
байкальский: байкальский
баксанский: баксанской
барионный: барионная барионную
безнейтринный: безнейтринного
беседа: беседа беседу
беседовать: беседуем
бета: бета
блестяще: блестяще
ближний: ближнего ближнем ближний
близкий: близки близок поближе
близко: близко
блинников: блинникова
больший: большая большие большим большими больших большую
большинство: большинство
большой: большой
борис: борис борисов
бочка: бочкой
брать: брать
бруно: бруно
буквально: буквально
бывать: бывает
быть: будем
важно: важно
важность: важность
важный: важна важная важнейший
валерий: валерий
вариант: вариант
ваш: ваш ваша вашей ваши
вежливый: вежливо
величина: величина величиной величину
верить: верили верят
верно: верно
верный: вернее
вероятность: вероятность
верхний: верхний
весна: весной
вести: ведут
вестись: ведутся
весь: всем вся
вето: вето
вещество: вещество
вещь: вещей вещь
взаимодействие: взаимодействий взаимодействия
взаимодействовать: взаимодействовали взаимодействует взаимодействующих
взаимосталкиваться: взаимосталкивающихся
взгляд: взгляда
взрыв: взрыв
взять: взяли
вид: вид виду
видеть: видят
вклад: вклад вклада
владимир: владимира владимире
вместе: вместе
вмещать: вмещающей
внеосевой: внеосевой
внешний: внешний
вниз: вниз
внутренний: внутренний
вовсе: вовсе
вода: вода воде водой воды
водный: водного
водород: водород водороде
водяной: водяным
возглавлять: возглавлял
возможно: возможно
возможность: возможности возможность возможностью
возникать: возникает возникают
возникнуть: возник возникла возникло возникнет
возраст: возраст
войти: войти вошло
волокно: волокна
вообще: вообще
вопрос: вопрос вопросы
восемь: восемь
восстановление: восстановления
вписываться: вписывается
время: времени время
вселенная: вселенной
встать: встал
вступать: вступает
всякий: всякие
всё: всё
второе: второе
второй: вторая второго второму
входить: входил входят
выбираться: выбирается
выдвинуть: выдвинул выдвинута
выйти: выйти вышел
выкупать: выкупать
вынудить: вынудило
выработать: выработанных
выражение: выражении выражения
высокий: высокие высоких высокое высокой
высота: высотой
выход: выход
выше: выше
гаврина: гаврина
галактика: галактики
галлиевый: галлиевый
галлий: галлий
галлия: галлия
генерировать: генерирует
геонейтрино: геонейтрино
германиевый: германиевого
германия: германии германия
гидроудар: гидроудар
гипер: гипер
гл: гл
главное: главное
главный: главный
глубина: глубине
глубоко: глубоко
говорить: говорил говорили говорим говорить говорю говоря говорят
говориться: говорится
год: года годов году годы лет
гораздо: гораздо
горный: горной
готовиться: готовятся
гран: гран
группа: группа группами
гэв: гэв
гэвной: гэвной
гэвном: гэвном
давать: дает
давление: давления
далее: далее
далеко: далеко
дальнейший: дальнейшем
дальний: дальнего дальний дальним
далёкий: дальше подальше
данные: данных
дать: данные
два: две двумя двух
двадцать: двадцать
двойной: двойного двойной
девушка: девушки
действительно: действительно
делать: делаем делали делать делают
делаться: делается делалась делался делаются
дело: дела дело
деньга: денег деньги
десять: десяти десять
детектирование: детектирования
детектор: детектор детектора детекторам детекторами детекторе детекторов детектором детекторы
дефицит: дефицит
дзержинск: дзержинске
диаметр: диаметром
дираковский: дираковскую
директор: директором
длинный: длинной
добавить: добавлены
довольно: довольно
докт: докт
должный: должен должна должно должны
дом: дом
допустить: допустим
дорого: дорого
дорогой: дорогая
достаточно: достаточно
достигнуть: достигла достигнуть
доступный: доступным
др: др
друг: друг друга другом другу
другой: другие других другое
думать: думать думаю
дэвис: дэвис дэвиса дэвису
европа: европе
европеец: европейцев
ездить: ездили
естественно: естественно
жан: жан
жизнь: жизни
забавный: забавная
зав: зав
заведовать: заведующего
зависеть: зависит
загрузка: загрузки
задавать: задавали
задача: задач задача задачей
заключаться: заключается заключалась
закончить: закончена
заложить: заложили
замазаться: замазалось
замдиректора: замдиректора
заметка: заметку
замечательный: замечательном замечательные
замешать: замешано
заниматься: занимались заниматься занимаются
заняться: заняться
заполнение: заполнения
запустить: запустили запущен
запутанно: запутанно
зарегистрировать: зарегистрировали зарегистрированы зарегистрирует
затем: затем
защищать: защищая
заявляться: заявляется
земля: земле землей земли землю
зеркальный: зеркальный
знаменатель: знаменателе
знание: знание знанием
знать: знаем знал знали знать знают зная
значит: значит
зря: зря
идея: идеи идею идея
идти: идет идут шел шло
иерархия: иерархии
известно: известно
извлекаться: извлекались
изготовить: изготовили
изготовление: изготовления
изменение: изменений
изменять: изменяет
измерение: измерение измерении измерения
измерить: измерить
измерять: измеряет
измеряться: измерялся измеряются
изотоп: изотопов
изучаться: изучались
изучение: изучению изучения
именно: именно
иметь: имеет имела иметь
иметься: имеется
имплозивный: имплозивный
импульс: импульсов
инвариантность: инвариантности инвариантность
индивидуальный: индивидуальные
инженерный: инженерными
институт: институт института институте институтов институтом
интенсивность: интенсивность
интенсивный: интенсивная интенсивный
интересный: интересные
интермедиат: интермедиат
интерпретировать: интерпретирована
искать: искали ищем
исключительно: исключительно
искусственный: искусственного
исполнение: исполнении
использовать: использовать использует используют
испускать: испускает
испустить: испустив
исследование: исследований исследования исследованиями
исследовать: исследовали
история: история
источник: источник источника
исчезать: исчезает исчезают
италия: италии
итальянец: итальянцы
итальянский: итальянский
ияи: ияи
кавказ: кавказ
кадзита: кадзита кадзите
казаться: кажется
каков: каков какова
какой: какие каким каких какую
калибровка: калибровка калибровке
камиоканд: камиоканде
канадец: канадцы
канал: канала
каон: каонов
каонной: каонной
каонном: каонном
каргин: каргина
картинка: картинках
катрин: катрин
качели: качелей
квадрат: квадратов
кварк: кварки
кварковый: кварковом
кек: кек
километр: километр
килотонна: килотонн
кислород: кислород
ключевой: ключевой ключевых
км: км
колба: колб колбами колбы
количество: количество
коллаборация: коллаборацией коллаборацию коллаборация
коллега: коллег коллегами коллеги
колориметр: колориметр
колоссальный: колоссальные
комбинированный: комбинированную
комиссия: комиссии комиссию комиссия
комментарий: комментария
комплекс: комплекса
конец: конце концов концу
конструкция: конструкцию
контролировать: контролировать
кореец: корейцами
корень: корень
короткий: короткой
косвенный: косвенном
косиб: косибе
космик: космики
космический: космических
космология: космологию космология
который: которая которого которое котором которую которые который которым
край: крае
крайне: крайне
критика: критике
кроме: кроме
круг: кругу
кстати: кстати
кто: кем кого
кубик: кубиков
куденко: куденко
купол: купол
кусок: кускам
кэвной: кэвное
лаборатория: лаборатории
легко: легко
лептогенезис: лептогенезиса
лептон: лептонам лептонами лептонов
лептонный: лептонное лептонном
леска: лесках
лететь: летят лечу
либо: либо
лишь: лишь
лобашёв: лобашёва
ловец: ловцы
лопнуть: лопнула
лос: лос
любить: любят
любой: любом
лёгкий: легкие легким легкое легче
магнит: магнит магните
майорановский: майорановскими
макдональд: макдональду
максим: максим
максимально: максимально
максимальный: максимальное максимальному
максимович: максимович
максимум: максимум максимуму
маленький: мала маленькая маленькие маленький маленьких меньше
мало: мало
малый: малая малую меньшая
масатося: масатоси
масса: масс масса массах массой массу массы
массивный: массивный массивными
массовый: массового массовые массовых
мат: мат
материя: материи материю
матрица: матрица матрице матрицу
машина: машины
мгу: мгу
международный: международной
мезон: мезонов
мелкий: мельчайшая
менее: менее
место: места месте место местом
месяц: месяца
метр: метров
механизм: механизм механизме
механика: механику
миллион: миллионов
мимо: мимо
мир: мир мире
мифь: мифи
михаилович: михайловича
мишель: мишель
мишень: мишени
младший: младшего
многие: многие
многократно: многократно
модель: моделей модели модель
молодёжь: молодежи
момент: момент
мочь: могли могут можете
мс: мс
мфть: мфти
мы: нам нами
мэв: мэв
мюон: мюонов
мюонный: мюонного мюонные мюонным мюонных
набор: набор
набрать: набрать
наверное: наверное
надежда: надежда
назад: назад
называть: называемая называемую называемые называемый называемыми
называться: называется называются
найти: найдем найти
наложение: наложение
намёк: намек намеки
напечатать: напечатана
направить: направлен направлена направленных
направление: направление направления
например: например
народ: народ
нарушать: нарушает
нарушаться: нарушается
нарушение: нарушение нарушением нарушений нарушению нарушения
насколько: насколько
наслать: нашли
настраиваться: настраивается
настроить: настроить
наука: наук наука
научий: науч
находиться: находился находится находящаяся
начало: начала начале
начать: начал начали начнет
начаться: началась начаться
начинание: начинании
начинать: начинает начинали начинают
наш: наш наше нашего нашем наши нашим наших нашу
небольшой: небольшая небольшое небольшой небольшом
недавний: недавнего
неделя: недели
недоказуемый: недоказуемо
незнание: незнание
неизвестный: неизвестный
нейтральный: нейтральным нейтральными
нейтринный: нейтринного нейтринной нейтринные нейтринный нейтринными нейтринных
нейтрино: нейтрино
некий: некий
некоторый: некоторых
немедленно: немедленно
немножко: немножко
ненадолго: ненадолго
неодинаковый: неодинаково
неоднократно: неоднократно
неожиданно: неожиданно
неожиданный: неожиданную неожиданные неожиданный
неподъёмный: неподъемные
непонятый: непонято
неразрешимый: неразрешимые
несколько: несколько
несопоставимый: несопоставимы
несчастливый: несчастливой
неточность: неточности
неуловимый: неуловимого
нечётный: нечетная
неэффективно: неэффективно
нижний: нижний
низкий: низкий низким
нии: нии
никакой: никаким
николаевич: николаевича
никто: никто
нобелевский: нобелевские нобелевскую
новый: новая нового новом новую новый
номер: номере
ноябрь: ноября
нужно: нужно
нужный: нужен
нуклон: нуклонов
нуль: нулю
ню: ню
оба: оба
обладать: обладать обладают
область: области область
обнародовать: обнародованы
обнаружение: обнаружение обнаружения
обнаружить: обнаружено обнаружил
обнаружиться: обнаружились
обработка: обработка
образ: образом
образовать: образуют
обсерватория: обсерватории
обсуждать: обсуждали
обсуждаться: обсуждался
обсуждение: обсуждений
общий: общем
объединить: объединить
объединиться: объединились
объяснение: объяснение объяснении объяснений объяснения
объяснить: объяснить
объяснять: объясняющего
объясняться: объясняется
объём: объем
обязательно: обязательно
обязательство: обязательство
огромный: огромное огромную огромный
один: одна одно одного одном
одинаково: одинаково
однако: однако
одновременно: одновременно
однозначно: однозначно
означать: означает
оияй: оияи
оказаться: оказалась оказались оказалось оказался оказаться
оказываться: оказывается
около: около
окончательный: окончательного окончательное
октябрь: октября
они: ими ними
онкология: онкологии
оно: оно
описывать: описывать описывают описывая
описываться: описываться
определение: определение определению
определяться: определяется
определённый: определенную определенные определенными
оптимальный: оптимальное
оптический: оптические
опустить: опущен
опыт: опыт
ортогональный: ортогональными
осесть: осели
основа: основы
основное: основном
основной: основной
основный: основная основную основными основных
особенно: особенно
остановить: остановлен
осуществляться: осуществляется
осциллировать: осциллируют
осцилляционный: осцилляционной осцилляционный
осцилляция: осцилляцией осцилляции осцилляций осцилляцию осцилляция осцилляциях
отверстие: отверстиями
ответ: ответа
ответить: ответил
отводиться: отводится
отдача: отдачи
отдел: отделе отделом
отдельный: отдельная
отказаться: отказались
откровенно: откровенно
открытие: открытие открытием открытия
отличать: отличает
отличаться: отличается
отличиться: отличился
отличный: отличные
отметить: отметить
относительно: относительно
относиться: относится
отношение: отношение
отправить: отправили
отрабатывать: отрабатывали
отрабатываться: отрабатывалась
отставать: отставали
отъехать: отъедете
оценить: оценить
очевидный: очевидного
очень: очень
ошибка: ошибка ошибки
палец: пальцах
память: память
пандемия: пандемии пандемию
парадокс: парадокс
параметр: параметр параметра параметрами параметры
первый: первое первом первые первый первых
перевезти: перевезена
передний: переднем
перейти: перейти
переслать: перешли
пересмотреть: пересмотреть
перестать: перестал перестанет
переход: переход
переходить: переходить переходят
пещера: пещеру
пион: пионов
плавно: плавно
планировать: планировали
планироваться: планировался планируется
пластина: пластины
плодотворный: плодотворной
плоскость: плоскостей плоскости плоскостям
плохой: плохое
плюс: плюс
побывать: побывал
поведение: поведение поведении
повезти: повезет
повысить: повысить
погибнуть: погибло
погрешность: погрешностей
подавить: подавлена
подавление: подавления
подавлять: подавляли
подвергаться: подвергается
подготовка: подготовка
поддержать: поддержал
поделить: поделенный
подобный: подобное подобных
подправлять: подправляют
подтвердить: подтвердил подтвердили подтверждены
подтверждаться: подтверждались подтверждался
подтверждение: подтверждение
подход: подходы
позволить: позволило
позволять: позволяет
поиск: поиск поиске поиски поиску
поймать: поймать
пойти: пошел пошла пошло
пока: пока
показать: показал показала показали
показывать: показывают
покрывать: покрывает
поле: поле поля
полимер: полимеров
политик: политик
полметра: полуметра
полномасштабный: полномасштабные
полностью: полностью
полный: полная полным
половина: половина
положение: положения
положительно: положительно
получаться: получается
получить: получен полученные получены получил получить
получиться: получился
померить: померить
помочь: поможет
помощь: помощью
понимание: понимании понимания
понимать: понимали понимаю понимают
понтекорво: понтекорво
понятно: понятно
понятный: понятен
попасть: попали
попытка: попытки
пора: пор
порог: порог порогом
порода: породе
порядок: порядка порядки порядков порядок
посвятить: посвященную посвящены
поскольку: поскольку
последний: последние последний
последовать: последовал
послезавтра: послезавтра
поставить: поставить
постоянно: постоянно
постулировать: постулировала
поступать: поступать
посчитать: посчитать
посёлок: поселке
потихоньку: потихоньку
поток: поток
потратить: потрачены
потрясать: потрясающий
похоже: похоже
почему: почему
поэтому: поэтому
появление: появление
появляться: появляться
правильный: правильное
правый: правыми
предел: предел предела
предложение: предложению
предложить: предложившими предложили
предложный: предложен
предоставлять: предоставляют
предприятие: предприятии
представить: представлен представленные
представлять: представлял
предыдущий: предыдущие
премия: премии премию
преследовать: преследует
претендовать: претендует
привязать: привязаны
придерживаться: придерживался
придумать: придумали
приезжать: приезжали
приехать: приехал
призвать: призвана
прийти: пришло
примерно: примерно
принимать: принимало принимать
принцип: принципе
принять: принято
природа: природа природе
присоединиться: присоединились
присоединяться: присоединяться
присудить: присуждены
притянуть: притянуть
причина: причине
причём: причем
проаннигилировать: проаннигилируют
проблема: проблема проблемы
проверить: проверить
провести: проведя
проводиться: проводился проводится
продвигаться: продвигается
продолжать: продолжать
продолжаться: продолжалась продолжались
продолжение: продолжения
продолжить: продолжить
проект: проект проекте
произойти: произойти произошел произошли произошло
происходить: происходят
пролетать: пролетают
промахнуться: промахнулись промахнуться
промежуточный: промежуточного промежуточную промежуточный
промоделировать: промоделировали
проосциллировать: проосциллировать
пропонент: пропоненты
простаивать: простаивать
просто: просто
простой: прост
протестировать: протестировали
противопоказанный: противопоказанного
протон: протона протонов протоны
протонный: протонного протонном
прототип: прототипы
протяжение: протяжении
проходить: проходят
процесс: процесса процессах процессе процессов
прошлый: прошлом
проявление: проявление
прямо: прямо
прямой: прямого прямое прямой прямом
публикация: публикацию
публиковать: публикуем
пуск: пуске
путис: путису
путч: путча
пучок: пучка пучок
пытаться: пытались
пять: пять
работа: работа работах работе работу работы
работать: работаем работает работал работали работать работают
равный: равна
радиоактивный: радиоактивных
развиваться: развивалось
развитие: развития
различие: различие
разместить: размещен
разница: разница
разность: разностью
разный: разные разных
разработать: разработан разработана разработать
разработка: разработками
разрушить: разрушил
разрушиться: разрушилось
район: районе
ран: ран
ранний: ранней
распад: распад распада распадах распаде распадов
распадаться: распадается
располагаться: располагалось располагаться
расположить: расположены
рассасываться: рассасывается
расстояние: расстояние расстоянии
расчёт: расчет
расширять: расширяют
реактор: реакторов
реакторный: реакторная реакторную реакторные реакторный реакторным
реакция: реакции
реализовать: реализована
реализоваться: реализовалось
реально: реально
ребята: ребят
регистрация: регистрации регистрация
регистрировать: регистрировать регистрируют регистрируя
ред: ред
редкий: редкое
редко: редко
резервуар: резервуар
результат: результат результата результатам результате результатов результаты
реймонд: реймонда реймонду
реликтовый: реликтовых
ресурс: ресурсы
речь: речь
решение: решение решением решения
решить: решена решить
родить: рожденных
рождаться: рождаются рождающийся
рождение: рождения
роль: роль
российский: российские российской
российско: российско
россия: россии
рубак: рубаков
рука: руки
руководить: руководит
руководство: руководство руководством руководству
рядом: рядом
сайт: сайта
сам: сама сами самим самом
самый: самая самое самые самым
сассо: сассо
сахаров: сахарова
сборка: сборка сборке сборки
сверху: сверху
свободный: свободных
свой: своего
свойство: свойства
связанный: связанные
связать: связана связанная связано
связывать: связывает
связь: связи связь
сгладить: сгладить
сдвинуться: сдвинулось
сделать: сделали сделан сделана сделано сделать
сеанс: сеанс сеансов сеансу
себя: собой
северный: северный
сегмент: сегментов
сей: сих
сектор: секторе
сердце: сердце сердцем
середина: середине
серьёзный: серьезная серьезный
сечение: сечение сечений сечения сечениями
сигнал: сигналы
сильно: сильно
сильноточный: сильноточном
симметрия: симметрии симметрию симметрия
систематический: систематические систематических
ситуация: ситуация ситуациях
скажем: скажем
сказать: сказал сказали сказать
сколько: сколько
скончаться: скончался
скорее: скорее
слабый: слабым
слева: слева
след: следов
следующий: следующего
слово: словах
сложиться: сложившегося
сложно: сложно
сложность: сложностей
сложный: сложная сложнее сложным
сломать: сломать
служить: служит
случай: случае
смена: сменах
сместить: смещены
смешивание: смешивание смешивания
смешиваться: смешиваться
смотреть: см смотрело
смочь: смогла сможет
смущать: смущала
смысл: смысл смысле
сначала: сначала
снижать: снижать
снимать: снимают
снова: снова
снятой: снят
собирать: собирали
собранный: собран
собрать: собрали
собственно: собственно
событие: событие событий
совершенно: совершенно
совместный: совместной
сожаление: сожалению
создавать: создаете
создание: создании
создать: создана создать
солнечный: солнечные солнечный солнечных
солнце: солнца солнце
соответствовать: соответствующее
соотношение: соотношение
соседний: соседние
состав: состав
составлять: составляет составляют
состояние: состояния
состоять: состоит состоящий
состояться: состоялась
сотня: сотен сотни
сотр: сотр
сотрудник: сотрудники
сотрудничать: сотрудничать
сотрудничество: сотрудничества сотрудничество
сохранение: сохранения
сохраниться: сохранились
сохранять: сохранять
сочетание: сочетание
спектр: спектр спектра
спектросмещать: спектросмещающие
специальный: специальные
способ: способ
справа: справа
спуститься: спуститься
срабатывать: срабатывать
сравнение: сравнению
сравнить: ср
средство: средств
стабильность: стабильностью
стандартный: стандартная стандартной стандартную стандартные
старший: старше
старый: старых
статистика: статистика статистики статистикой статистику
статистический: статистическая
стать: стал стала стало
статья: статья
стерильный: стерильное стерильные стерильных
сто: ста
стоимость: стоимость
стоить: стоит
столько: столько
сторона: стороны
стоять: стоял стояли
страна: страны
стратегия: стратегию
строительство: строительство
строиться: строится
студент: студентов студенты
студентка: студентки
судьба: судьбой
суммарный: суммарной
супер: супер
существенный: существенную
существовать: существовать существует
существующий: существующую
схема: схема
схожий: схожих
сцинтилляционный: сцинтилляционные
счастие: счастью
счастливый: счастливы
счёт: счет
сша: сша
сыграть: сыграть
такааки: такааки
также: также
таки: таки
такой: такая такие таким таких такое такую
тактично: тактично
тау: тау
твёрдый: твердое
телевидение: телевидении
телескоп: телескоп телескопа
тема: теме
теорема: теорема
теория: теории теорий теория
территория: территории
тест: тестов тесты
тестировать: тестировали тестируем
технология: технологией технологию технология
течение: течение
тип: типа типов
токай: токай
толща: толще
тонна: тонн тонны
тот: те тех той тому ту
тоцук: тоцука
точность: точности
трансформация: трансформациях
трансформироваться: трансформировалось
тратиться: тратятся
трв: трв
требовать: требует
три: тремя трех
тридцать: тридцать
тринадцатиэтажный: тринадцатиэтажный
тритий: трития
триумф: триумф
троицк: троицк
трудиться: трудятся
трудно: трудно
трудность: трудности
трудный: труднее
туда: туда
тысяча: тысяч
тяжёлый: тяжелые тяжелым тяжелыми тяжелых
тёмный: темной темную
убедить: убедить
убрать: убрать
увеличить: увеличит
увидеть: увидев увидел увидели увидите
угол: угла углами углов углы угол
удалённый: удаленно
удачно: удачно
удачный: удачное удачным
удивительно: удивительно
указание: указание указаний
указывать: указывают
улучшиться: улучшится
уменьшить: уменьшить
унипласт: унипласт
уничтожать: уничтожаем
упомянуть: упомянутом упомянуть
управляться: управляться
уровень: уровень уровне уровнях
усилие: усилий усилия
ускоритель: ускорителе ускорителем ускоритель ускорителя
ускорительный: ускорительный
условие: условие
успевать: успевают
успешно: успешно
устанавливаться: устанавливается
установить: установить установлен установлена
установка: установка установке установки установкой установку
ухищрение: ухищрений
участвовать: участвовали участвуют
участие: участие
участник: участники
учёный: ученого ученые
фаза: фаза
факт: фактов факты
фактически: фактически
фактор: фактор факторы
февраль: февраля
фермилабнуть: фермилаб
фермион: фермионов
фиан: фиан
фианом: фианом
физ: физ
физика: физика физике физики физику
физический: физический физических физическом
физтех: физтеха
флаг: флаг
флейворный: флейворные флейворных
фон: фон
фото: фото
фотоумножитель: фотоумножителей фотоумножители
француз: французы
фундаментальный: фундаментальная фундаментальный
функционировать: функционировала функционировать функционирует
футбольный: футбольного
характер: характер
хватать: хватает
хиггс: хиггса
химический: химического
ход: ход ходом
хороший: лучшие лучший хорошая хорошей хорошими хорошую
хотеть: хотим хочу
хотеться: хочется
хотя: хотя
цель: цели
цена: цены
ценность: ценности
ценный: ценная
центр: центр центре
цепной: цепной
церн: церн церне
цукуб: цукуба
частица: частиц частица частицам частицах частицы
часто: часто
часть: частей части часть
чей: чья
человек: людей люди людьми людям человек человека
черенковский: черенковский черенковского
четыре: четыре
числитель: числителе
число: числа числе число
чистый: чистой
читатель: читателя
член: членами
чувствительность: чувствительность
чувствительный: чувствительные
чувствовать: чувствуют
чудовищный: чудовищные
чёткий: четких
чётко: четко
шахта: шахтах шахту
швейцарец: швейцарцы
ширина: шириной
широкий: широкий
шкирка: шкирку
школа: школой
штерн: штерн штерна
эксперимент: эксперимент эксперимента экспериментах эксперименте экспериментов эксперименты
экспериментальный: экспериментальной экспериментальные экспериментальными
эксперт: эксперты
электромагнитный: электромагнитный
электроника: электроника
электронный: электронного электронные электронным электронных
электрослабый: электрослабых
элемент: элементах элементов элементы
энергия: энергией энергии энергий энергию энергия
это: этим
этот: эта этими этих
этюд: этюды
эффект: эффект эффекта
эффективность: эффективность эффективностью
юрий: юрием юрий
явить: явил
явление: явлением
являться: является
ядерный: ядерного ядерных
ядерщик: ядерщики
ядро: ядрам ядрах ядро
японец: японцами японцы
япония: японией японии японию япония
японский: японские японский японскими японских
ясный: ясном
ёдзь: ёдзи
