абсолютный: абсолютного
автор: авторы
аккреции: аккреции
алексей: алексей
американский: американского
анализировать: анализируя
андерсон: андерсона андерсоном
аномалия: аномалии
аномально: аномально
античный: античным
архив: архив
астрометрия: астрометрии астрометрия
астроном: астроном астрономам астрономов
астрономия: астрономии астрономия
астрофизик: астрофизиков
балтимор: балтиморе
благодаря: благодаря
близкий: ближайшей близкими близких близок
блуждать: блуждающая
большинство: большинства
будущий: будущих
быстродвижущийся: быстродвижущиеся быстродвижущихся
быстрый: быстрейшей быстрых
важный: важны
ван: ван
вблизи: вблизи
величина: величина величине
вероятно: вероятно
верхний: верхней
весьма: весьма
видный: виден
включая: включая
вместе: вместе
вместилище: вместилищем
внутренний: внутренней
внутри: внутри
возможный: возможную
возникнуть: возникла возникнет
возраст: возраст
волна: волн
волновой: волновое
вообще: вообще
вопрос: вопрос
впервые: впервые
впереди: впереди
время: временем время
вряд: вряд
второй: второго
входить: входят
вывод: выводы
выглядеть: выглядит
выдавать: выдавать
выдвинуть: выдвинутую
выделить: выделенных
выделяться: выделяется
вызвать: вызвал
высокий: высокими
высококачественный: высококачественными
вычисление: вычислений
газ: газа
галактика: галактик галактика галактике галактики галактикой галактику
галактический: галактических
гибель: гибели
гипотеза: гипотеза гипотезу гипотезы
главный: главной
глаз: глазом
глобуляр: глобуляр глобуляра глобуляров
глобулярный: глобулярный
год: года году годы лет
гравитационный: гравитационно гравитационный гравитационных
граница: границы
груз: груз
группа: группы
давно: давно
далёкий: далеком
данлоп: данлоп
данные: данных
дать: данные
два: две двух
двадцатилетний: двадцатилетний
движение: движение движения
двумерный: двумерная
действительно: действительно
дер: дер
десятка: десятки
детектирование: детектирование
детектор: детектора
джей: джеем
джеймс: джеймс
джон: джон
диаграмма: диаграмма диаграмме
диаметр: диаметре
диапазон: диапазона диапазоне
динамика: динамики
довольно: довольно
долгожданный: долгожданной
должный: должен должна должны
дополнительный: дополнительное
допущение: допущению
дорастить: дорасти
достаточный: достаточного
достоверность: достоверностью
другой: другие другими других
дыра: дыр дыра дырами дыре дырой дыру дыры
ева: ева
европейский: европейского
естественный: естественной
жизнь: жизни
журналист: журналистах
задержаться: задержаться
заключение: заключению
заключить: заключили
закончить: закончило
закончиться: закончились
закрасить: закрашенных
запланировать: запланирован
зарегистрировать: зарегистрировать
зародышевый: зародышевых
затем: затем
звезда: звезд звездами звезды
звёздный: звездная звездного звездное звездной
земля: земле земли
значок: значками
идти: идти
известный: известен известного известны известных
излучение: излучением излучения
измерение: измерениями
измерительный: измерительные
измеряться: измеряются
изображение: изображение
изучить: изучены
иметь: имеют
институт: института
интервал: интервале
интересный: интересные
интерпретировать: интерпретировали
информация: информацией
использование: использованием
использовать: используя
исследование: исследований исследования исследованиям
история: истории
источник: источник
итоговый: итоговое
какой: каком
кандидат: кандидаты
карликовость: карликовости
карликовый: карликовой карликовых
каталог: каталоге
качественный: качественные
качество: качестве
кинематика: кинематике кинематику
клавдия: клавдия
кластер: кластер кластера кластере
км: км
количественный: количественное
количество: количества
коллапс: коллапс
коллега: коллеги
коллектив: коллектив
комментарий: комментария
комплекс: комплексы
конец: конец
конечный: конечном
космический: космического космическом
космос: космос космоса
который: которая котором которые
кпк: кпк
край: крае
кроме: кроме
крупный: крупных
левин: левин
лежать: лежат лежащие лежащими лежит
либо: либо
лишиться: лишился
лишь: лишь
логика: логики
маленький: меньше
малочисленный: малочисленны
малый: меньшей меньшие
марел: марела марелом
маркер: маркером маркеры
масса: масс масса массами массой массу массы
массивный: массивного массивной
материя: материя
международный: международный
менее: менее
метод: методами методах
микролинзирование: микролинзирования
миллиард: миллиардами
миллион: миллионами
минимум: минимум
михаил: михаил
млечный: млечного млечный
моделирование: моделирование
мочь: мог могла могло
наблюдение: наблюдений наблюдения
нагреваться: нагреваться
надёжность: надежностью
назад: назад
наземный: наземных
называть: называть
найти: найдены
накопиться: накопилось
наличие: наличии наличия
направление: направлению направления
население: население населения
настолько: настолько
наука: науки
научный: научных
находиться: находиться находятся
начало: начало
начальный: начальными
наш: нашей нашу
небольшой: небольшое невелика
невооружённый: невооруженным
недалеко: недалеко
недостаточно: недостаточно
незакрашенный: незакрашенных
нейтронный: нейтронные нейтронными
необходимый: необходимой
необычный: необычен
несколько: несколько
нижний: нижней
новый: новое новой новом новые
нойол: нойола
обещать: обещают
область: областей области
обнаружить: обнаружена обнаружили
обозначать: обозначают
обозначение: обозначением обозначения
общий: общей общем
объявить: объявлено
огромный: огромный
один: одну
однако: однако
ожидать: ожидает
около: около
описать: описал
опровергнуть: опровергли
опубликовать: опубликовали
орбитальный: орбитальном
основной: основной
особый: особой
остальной: остальные
остаться: остался
отделять: отделяет
открытие: открытии открытиях
открытый: открытый открытым
отличаться: отличаются
отличие: отличие
отметить: отметить отмечено отмечены отмечу
отношение: отношении
отрезок: отрезками
отсортировать: отсортированы
оценка: оценку
очень: очень
ошибка: ошибки
партнёр: партнера
первый: первое первой первым
передний: переднем
перейти: перейдем
перекочевать: перекочевала
перпендикулярный: перпендикулярную
перспективный: перспективным
пк: пк
плен: плен
плоскость: плоскость
плотность: плотность
подобный: подобных
подтвердить: подтвердил
подтвердиться: подтвердится
подтверждение: подтверждение подтверждением
позволить: позволит
позволять: позволяют
поздний: позднее
поиск: поиск
пока: пока
показатель: показатель
покинуть: покинуть
полностью: полностью
положение: положение
положить: положено
получить: полученная полученной
получиться: получится
польза: пользу
помощь: помощью
понадобиться: понадобятся
попасть: попала
популяризация: популяризации
порядок: порядка порядок
поскольку: поскольку
последний: последние
последовательность: последовательности
послезвёздный: послезвездных
поставить: поставлены
постепенно: постепенно
потенциальный: потенциальным
потомок: потомками
появиться: появилось появятся
появляться: появляются
превышать: превышает превышающими
предел: пределах
предполагать: предполагаемого
предположить: предположить
предсказание: предсказании
предстоять: предстоит
прежний: прежнем
препятствовать: препятствующее
претендент: претенденты
претерпевать: претерпевают
приблизительно: приблизительно
прийтись: придется
прилегать: прилегающих
примерно: примерно
принять: принято
природа: природе
прислать: пришли
присутствие: присутствие
притяжение: притяжение
проанализировать: проанализировал
проекция: проекция
промежуточный: промежуточной промежуточными промежуточных
проследить: прослежены
проставить: проставлены
процесс: процесс процессе
прочий: прочих
прошлый: прошлом
птолемей: птолемея
публикация: публикации
путь: пути путь
пыль: пыли
пять: пяти
работа: работы
работать: работали
равный: равен
ради: ради
радиовсплеск: радиовсплесках
разбегание: разбеганию разбегания
разный: разный
разрыв: разрыв
расположение: расположение
расположить: расположенном расположенных
рассказывать: рассказывать
расстояние: расстояние расстоянию
расти: растут
реальный: реальном
ревнивец: ревнивцев
результат: результат результате результаты
реликтовый: реликтовые
рентгеновский: рентгеновская рентгеновской
речь: речь
рис: рис
ровесница: ровесниц
рождаться: рождаются
рождение: рождением рождении
розовый: розовым розовыми
роланд: роландом
сам: самого
самый: самым
сверхмассивность: сверхмассивности
сверхмассивный: сверхмассивными сверхмассивных
светить: светил
световой: световых
свидетельство: свидетельство
свой: свое своем своим
сегодня: сегодня
секунда: секунд
семейство: семейств семейства
семёрка: семерку
серый: серые
сжигать: сжигают
сила: силу
скопление: скопление скоплении скоплений скопления
скорость: скорости скорость скоростями скоростях
скучный: скучна
слияние: слияний
смотреть: см
смысл: смысле
снизить: снизили
собрать: собрать
собственный: собственного
совершенно: совершенно
согласно: согласно
содержать: содержать содержит
содержаться: содержатся
сожаление: сожалению
создавать: создающей
солнечный: солнечной солнечных
солнце: солнц солнца солнце
сомнение: сомнение
соответствующий: соответствующими
состав: состав составу
составлять: составляет
состоять: состоят
сотрудник: сотрудниками
спектральный: спектральные
сплошной: сплошные
способ: способом
спустя: спустя
сравнительно: сравнительно
среднее: среднем
статус: статуса
стать: стало
статья: статьи
стоить: стоит
столетие: столетии столетия
столкновение: столкновений столкновения
судьба: судьба
супертелескоп: супертелескопах
существование: существование существовании существования
существовать: существует
сценарий: сценарии
считать: считать
считаться: считается
счёт: счете
сша: сша
также: также
такой: такие таким таких
телескоп: телескоп телескопа телескопе
тень: тень
теоретический: теоретическом
теория: теории теория
тепловой: тепловым
термоядерный: термоядерное
тип: типу
типичный: типичные
титул: титул
топливо: топливо
тот: той тому
точнее: точнее
точно: точно
три: трех
трое: трое
трёхмерный: трехмерных
тысяча: тысяч тысячи тысячу
тяготение: тяготение
тёмный: темная
убегание: убегания
увидеть: увидеть
угловой: угловых
удаться: удалось
удержать: удержать
уйти: уйти
указывать: указывает
улучшить: улучшить
ультравысокий: ультравысокой
уровень: уровне
установить: установить установлено
учесть: учесть
учёный: ученые
уэбба: уэбб
физический: физической
формирование: формирования
формироваться: формироваться
фотометрический: фотометрические
фрг: фрг
хаббл: хаббл
характеристика: характеристики
химический: химическому
ход: ходе
хотя: хотя
цвет: цвет цветом
центавро: центавра
центр: центр центра центрах центре центром
центральный: центральную
частица: частицы
чей: чьи
чили: чили
чёрный: черная черной черную черные черными черных
шаров: шаровых
шаровой: шарового шаровое
шестнадцать: шестнадцать
шотландский: шотландский
энергия: энергии
это: этим
этот: эта этих этому
являться: являющихся
ядро: ядер ядрах
японский: японского
