авральный: авральном
австралия: австралии
агентство: агентство
агрегатор: агрегатора
аделаида: аделаида
администратор: администратора
аккумулятор: аккумулятор аккумуляторов
альтемуса: альтемус
альтернативный: альтернативных
альтиметр: альтиметр альтиметра
американский: американского американской
анализ: анализ
аналог: аналогов
ангара: ангара
андрей: андрей
антенна: антенн антенны
аполлон: аполлона
аппарат: аппарат аппарата аппаратах аппарате аппаратов аппаратом аппараты
астроном: астронома
бак: баках баков
баллистический: баллистические
барьер: барьеров
безусловный: безусловным
бельгийский: бельгийского
беспилотный: беспилотных
бесполезный: бесполезными
билл: билла
близкий: ближайшие
блок: блоках блоки
бок: бок
больший: большая большей
большинство: большинство
большой: большой
бояться: боялись
будущий: будущей будущих
бур: бур буром
буран: буран
буровой: буровое
бывший: бывший
быть: будем
важный: важнейшие важной
ватт: ватт
вбок: вбок
версия: версии версиях
вертикально: вертикально
вертикальный: вертикальная
верхний: верхней верхнюю
весь: всеми вся
вибрационный: вибрационный
видео: видео
видеть: видела
видимый: видимой
википедия: википедия
виток: витка
включая: включая
включение: включение включениями
владелец: владельцем
влияние: влиянием влияния
внести: внести
внешний: внешний внешних
внимание: внимание
внутри: внутри
вовсе: вовсе
вода: воду
возврат: возвратом
возможно: возможно
волноваться: волновались
вопрос: вопросы
восемь: восьми
вперёд: вперед
впоследствии: впоследствии
вправо: вправо
вращаться: вращался
время: времени время
вряд: вряд
встать: встанет
всё: всё
второе: второе
второй: вторая второй
вывести: выведя вывела
вывод: вывод
выгодно: выгодно
выйти: вышел
выключение: выключении
выполнить: выполнен
выпускник: выпускник
высокий: высокие
высота: высота высоте высотой высоты
выстрелить: выстрелить
выходец: выходцы
выше: выше
вышеуказанный: вышеуказанных
выясниить: выясниить
выясниться: выяснилось
газ: газов
гаффарян: гаффарян
гелий: гелия
генеральный: генеральным
германия: германии
глава: главой
главный: главный главным
глубокий: глубокого
год: год года годах году годы лет
годность: годности
гораздо: гораздо
горизонтальный: горизонтального горизонтальной горизонтальным
готовый: готово
гранд: грандов
громкий: громком
груз: грузов
грузоподъёмность: грузоподъемностью
грунт: грунта
группа: группа
дальний: дальней
далёкий: дальше
данные: данных
данный: данный
датчик: датчики
дать: данной данные
два: две двух
двенадцать: двенадцать
двигатель: двигателей двигателя
двигательный: двигательной двигательные
девять: девять
действие: действие
делать: делали
дело: дело
демонстрационный: демонстрационные
держаться: держится
десять: десять
детально: детально
джонсон: джонсона
диагностировать: диагностировать
директор: директором
диск: диске
добиться: добиться
дойти: дошли
долгоживущий: долгоживущих
должный: должен должна
досадный: досадных
доставка: доставке
достигнутый: достигнутая
достижение: достижении достижения
дракон: дракон дракона
древний: древний
другой: другие других
ду: ду
европейский: европейской
едва: едва
единица: единиц
железа: железе
жидкий: жидком
журнал: журналах
завершить: завершена завершить
задействовать: задействовано
заказчик: заказчиком
заключить: заключенные заключены
закончиться: закончился
закрытый: закрытого
закрыться: закрывшегося
замглавы: замглавы
заменить: заменить
заметно: заметно
замечательный: замечательные
занять: занял
записать: записанные
запись: записи
запланировать: запланирован запланированной запланированных запланированы
заправочный: заправочные
запрыгать: запрыгал
запуск: запуск запуске запуском
запустить: запустить
заряд: заряд
затаиться: затаившийся
затенить: затененных
звёздный: звездные
земля: земли землю земля
значение: значения
значительный: значительные
зря: зря
зурбухен: зурбухеном
играть: играет
идеология: идеология
идти: шла
иезуит: иезуита
известно: известно
известный: известнейшие
изменение: изменений
изменить: изменил
измерять: измеряющий
изображение: изображение
изоляция: изоляции
изрядно: изрядно
изучение: изучения
именно: именно
импульс: импульсу
имя: имени
индийский: индийской
индия: индии
инженер: инженер инженеры
инновационный: инновационных
инструмент: инструментов инструментом
интересный: интересными
информация: информации информацию
инцидент: инцидент инцидентов
искать: искать
испарение: испарению испарения
использовать: использовать
испытание: испытание испытаний испытанию испытания
испытывать: испытывая
исток: истоки
история: истории
источник: источник источником
итог: итоге итоги
какой: каким каких
кам: кам
камера: камер камерой
картинка: картинке
касание: касания
касаться: касается
качество: качестве
кг: кг
кислород: кислорода кислородом
кислородный: кислородном
китайский: китайской
классический: классического
клиент: клиентов клиентом
клипса: клипс
ключевой: ключевому
км: км
колин: колин
количество: количестве количество
команда: команда
комментарий: комментария
коммерческий: коммерческой
компания: компании компаний компанию компаниями
компоновка: компоновки
компьютер: компьютер
конец: конец конца
конкурент: конкурентами
конкуренция: конкуренции
конкурс: конкурсе
контейнер: контейнера
контракт: контрактов контракту контракты
корабль: корабли
короткий: короткой
коррекция: коррекции
космический: космические космических космического
космонавтика: космонавтика космонавтике
космопорт: космопорт
космос: космоса космосе
костюм: костюма
который: которая которого которые который которым которых
кратер: кратер кратера кратеры
крейн: крейн
крест: крест
криогеника: криогеники
криогенный: криогенной криогенную криогенных
критика: критике
критически: критически
кроме: кроме
круговой: круговую
крупный: крупнее крупной крупные
крутой: крутым
кубсат: кубсат
курс: курса
лендёр: лендер лендера лендеров
лететь: летевший
линдон: линдона
линза: линз
лишь: лишь
луна: луна луне луну луны
лунник: лунник
лунный: лунная лунного лунной лунную лунных
луноход: луноход лунохода
лёгкий: легкой
малаперо: малапера
малаперт: малаперт
маленький: меньше
малый: меньшей
манёвр: маневр маневру
марс: марс
март: марта
маск: маск
маска: маска
масса: масса массы
массивный: массивнее
мегабайт: мегабайт
международный: международная
межпланетный: межпланетные
менее: менее
менять: меняет
меняться: меняется
место: место
местоположение: местоположения
метан: метана метане
метановый: метановой метановом
механизм: механизм
микро: микро
миллиард: миллиард
миллиардер: миллиардер
миниатюрный: миниатюрных
минута: минут
минь: мини
мировой: мировой
миссия: миссии миссий миссия
мкс: мкс
мнение: мнения
многое: многое
многоимпульсный: многоимпульсные
многократно: многократно
многомесячный: многомесячные
многочисленный: многочисленные
множественный: множественными
множество: множество
модный: модными
модуль: модуль
момент: момент моменты
мочь: могут
мощность: мощности
мягкий: мягкая
мягко: мягко
набок: набок
набор: набор
навигационный: навигационной навигационный навигационных
навигация: навигация
наглядный: наглядной
нагрузка: нагрузка нагрузки нагрузок
надеяться: надеяться
назад: назад
название: название
назвать: назван
назначить: назначенное назначенной
наклон: наклона
намереваться: намереваются
намного: намного
написание: написания
написать: написанные
направить: направлен направлены
направление: направления
например: например
напрячь: напряженная
наряду: наряду
насколько: насколько
настать: настал
насчёт: насчет
научный: научного научной научные научных
начало: начало
начальный: начальной
начаться: начались
начинаться: начиналось
небо: небо
небольшой: небольшой
невыставленный: невыставленной
негативный: негативные
неделя: неделю
незапланированный: незапланированные
неизвестно: неизвестно
нельсон: нельсона
ненамного: ненамного
неноминальный: неноминальных
ненулевой: ненулевому
необходимо: необходимо
необходимый: необходимый необходимых
неплохой: неплоха
непогашенный: непогашенная
неполадка: неполадки
непонятный: непонятные
нержавеющий: нержавеющей
неровный: неровной
несколько: несколько
несмотря: несмотря
неудача: неудач неудачи
неудачный: неудачных
неуспешный: неуспешные
неутомимый: неутомимый
ниже: ниже
низкий: низкую
никакой: никакие
ножка: ножек ножка
носитель: носитель носителя носителях
ночь: ночи
нужно: нужно
область: области областях
обнародовать: обнародована
обработка: обработки
обратить: обратить
обсерватория: обсерватории
обтекатель: обтекателем
общечеловеческий: общечеловеческие
объявить: объявили объявило
объём: объеме
обычно: обычно
ограничивать: ограничивают
ограничить: ограничен ограничена
огромный: огромных
один: одна одни одними одного
одиссей: одиссее одиссеем одиссей
одиссея: одиссея
ожидать: ожидаемо
ожидаться: ожидается
ожить: оживет
озвучить: озвученная
оказаться: окажется окажутся оказалась оказались оказалось
около: около
околоземный: околоземную
окрестность: окрестностях
оператор: операторы
опора: опор опоры
определение: определением определению определения
определять: определять
опрокинуться: опрокинулся
орбита: орбиту
орбитальный: орбитальных
ориентация: ориентации ориентацию
осесть: осел
оснастить: оснастить
основать: основавший основали
основной: основной основные
основный: основная основное основным
особый: особое
остаться: остались
ответственность: ответственности
отдел: отдела
отделение: отделение отделением отделения
отдельный: отдельные
отзыв: отзывам
отказаться: отказаться
отличный: отличного
отложиться: отложится
отломиться: отломившейся
отлёт: отлете
отмена: отмены
относительно: относительно
отстреливать: отстреливаемого
отстрелить: отстрелен
отсюда: отсюда
отчитаться: отчиталась
оценка: оценка
очень: очень
очистка: очистки
ошибка: ошибкой
панель: панелей панели
панорама: панорама
пара: пару пары
параллель: параллели
параметр: параметров
партнёр: партнера
пассивный: пассивных
первый: первая первой первые первых
перевести: переведен
переводить: переводящее
передать: передал передали переданное
передача: передача
перезагрузить: перезагрузить
переключить: переключен
переменный: переменной
перенастройка: перенастройка
перестать: перестал
переход: переходу
перечисленный: перечисленные
перечислимый: перечислим
писатель: писателя
плазма: плазмы
план: планов планы
плохой: хуже
поверх: поверх
поверхность: поверхности
повод: поводу
повредить: повредил
погрешность: погрешность
подать: подана
подбор: подбора
подвести: подвести
подломиться: подломилась
подробный: подробной
подтвердить: подтверждена
подтверждение: подтверждение подтверждения
позволить: позволило
позволять: позволяют
поздний: позже
позитивный: позитивные
позорный: позорным
поймать: поймать
пойти: пошло
пока: пока
показатель: показатели
полгода: полгода
полдень: полдня
полезный: полезная полезной полезных
полететь: полетит
полноценный: полноценной
полный: полном
положение: положение
полулёжа: полулежа
получать: получал
получаться: получается получающиеся
получение: получением
получить: полученные полученных получить
получиться: получившееся
польза: пользе
полюс: полюса
полярный: полярную
полёт: полет полета полетом
понять: поняли
попробовать: попробуем
попытка: попытке попытки
порядок: порядке
посадка: посадка посадке посадки посадкой посадок
посадочный: посадочный посадочных
последний: последние последний
последующий: последующим
поставить: поставило поставить поставленных
поступить: поступило
появиться: появятся
предварительно: предварительно
представиться: представится
предыдущий: предыдущие предыдущий предыдущую
пресс: пресс
прибор: прибор прибора приборов
прибыть: прибыл
привести: привела привело
призвать: призванные
прийти: пришел пришло
прийтись: придется
прикрепить: прикрепленным
прилунение: прилунение
прилуниться: прилунился
применение: применение
примерно: примерно
принадлежать: принадлежат
принимать: принимать
принцип: принципы
принять: принято
приповерхностный: приповерхностную
приполярный: приполярного
прислать: пришли
притом: притом
приходить: приходит
причина: причин причинам причиной причину
проблема: проблема проблему
провал: провалом
проверить: проверить
провести: проведены
проводить: проводили
программа: программа программе программы
программный: программная
продолжение: продолжение продолжении
продолжить: продолжить
проектировать: проектирующих
произвести: произведено произведены произвести
произноситься: произносится
произойти: произошла произошло
пройти: пройти
просто: просто
простой: простой
протестировать: протестировать
противоположный: противоположными
прототип: прототип
протяжение: протяжении
профессиональный: профессиональных
проходить: проходило
процент: проценту
процесс: процессе
прочий: прочие
проясниться: прояснится
прыжковый: прыжковые
прямо: прямо
прямой: прямой прямую
пусковой: пускового
путь: пути
пыль: пыли пыль
работа: работа работу работы
работать: работал работали работающего
работник: работник
работоспособность: работоспособность
работоспособный: работоспособен
рабочий: рабочее рабочих
равно: равно
радар: радар
радиомаяк: радиомаяк
радиостанция: радиостанция
радиотелескоп: радиотелескоп
радиошум: радиошумы
радиоэнергетический: радиоэнергетическую
раз: раза
разбиться: разбился
разгонный: разгонные разгонных
размер: размер
размещение: размещения
разный: разным
разобраться: разобраться
разработка: разработки
разработчик: разработчиков
ракета: ракета ракетах ракеты
рамка: рамках
ранний: пораньше
расположить: расположена
расследование: расследование
расстояние: расстояний расстояния
расчётный: расчетная
реальный: реальных
режим: режим
резервный: резервный
результат: результате результаты
реинкарнация: реинкарнация
рекорд: рекорд
релиз: релизам
ретро: ретро
рефлектор: рефлекторов
решение: решение
решить: решено решили решить
римский: римская
роль: роль ролях
российский: российской
сам: сами самого самой
самый: самая
сателлитный: сателлитные
сбрасывать: сбрасывать
сверху: сверху
свой: своей своих свой
связь: связи связь
священник: священника
сдвигаться: сдвигалось
сдвинуться: сдвинутся
сделать: сделанное
сеанс: сеанс
секунда: секунд
сео: сео
серия: серии
сесть: сесть
сигнал: сигнал сигнала сигналов
сильно: сильно
системный: системный
ситуация: ситуация
сказаться: сказалось
склонность: склонности
сколько: сколько
скорее: скорее
скорость: скорости скорость скоростью
скульптура: скульптур
слабый: слабый
следить: следящие
следом: следом
следующий: следующему следующий
слишком: слишком
сложно: сложно
сложность: сложностей
слой: слой
случай: случае
сми: сми
смотреть: см смотрели
смочь: смогла смогли
сначала: сначала
событие: события
совершенно: совершенно
сокр: сокр
солнечный: солнечные солнечных
солнце: солнца солнце
сообщение: сообщение сообщению
сооснователь: сооснователей
соотношение: соотношения
сосредоточить: сосредоточено
состояться: состоялся
сотрудник: сотрудники
спать: спящий
специальный: специальным
список: списке
спортивный: спортивного
сработать: сработала сработали
сразу: сразу
среда: среду
срок: сроков сроком
стабильный: стабильным
стандарт: стандартам
станция: станции
стартап: стартапа
стать: ставшие ставший стал стали стало
статья: статьи
стационарный: стационарные
стереокамера: стереокамера
стив: стив
сто: ста сто
стоить: стоит
сторона: стороне сторону стороны
сторонник: сторонником
строка: строк
струить: струи
ступень: ступени ступень
судьба: судьбу
суметь: сумела сумели
сутки: суток
суть: сути
сфотографировать: сфотографировать
схема: схема схеме схемы
схожий: схожего
считать: считают
считывание: считывания
счёт: счет счетов
съёмка: съемками
таблица: таблице
также: также
таки: таки
такой: такие такое
такси: такси
текущий: текущие текущий
телеметрия: телеметрии телеметрию
телескоп: телескоп
теперешний: теперешними
термальный: термальной
терпимый: терпимыми
тест: тест
технический: техническим
течение: течении
тим: тим
типичный: типичной
тишина: тишина
тогдашний: тогдашним
томас: томасом
топливный: топливной топливную
топливо: топлива
торможение: торможение
тот: те тому
точка: точке
точно: точно
точность: точность точностью
точный: точного
траектория: траектории траекторий траекторию траектория
транслунный: транслунную
трансляция: трансляцией трансляции
требовать: требует
третий: третьей
три: трех
тросик: тросиком
увеличение: увеличения
угол: угла
ударный: ударный
удельный: удельному
удешевление: удешевления
удивиться: удивится
удовлетвориться: удовлетворился
управление: управления
уровень: уровнем
условие: условиях
успеть: успели
успех: успеха успехе успехом
успешно: успешно
успешность: успешности
успешный: успешное успешные успешным
установить: установили
установка: установки
устройство: устройство
уточнение: уточнения
участвовать: участвовал участвовали участвующей
фаза: фаза
февраль: февраля
фиксировать: фиксированной
финансирование: финансирования
фото: фото
фотографирование: фотографирования
фотография: фотографии
функция: функциями
характеристика: характеристики
хороший: лучшей
хотя: хотя
хранилище: хранилища
хьюстон: хьюстона хьюстоне
царить: царила
цель: целей целью
цена: ценой
центр: центра центре
цифра: цифра
цупа: цупе
чандраяна: чандраян
чанъэ: чанъэ
час: час часа часов
частность: частности
частный: частной частными частных
часть: часть
человек: людей
черёд: черед
честь: честь
четыре: четырех четырьмя
число: числа числе
шанс: шанс
шарль: шарля
широкий: широчайшее
эгида: эгидой
экипаж: экипажем
экспансия: экспансия
эксперт: экспертов
экстренный: экстренная
электропитание: электропитании
элемент: элементов элементы
энергия: энергии
этап: этапах
этот: этих
эффект: эффекта
южный: южного
являться: являющееся
явный: явного
японский: японской
японско: японско
