абсолютно: абсолютно
абсолютный: абсолютная
автор: автору
активность: активности
активный: активный
алай: алая
алексей: алексей алексею алексея
альфа: альфа
аналогия: аналогию
ао: ао
апертурный: апертурными
апрель: апреля
арктурович: арктуровича
астроклимат: астроклимата
астроновость: астроновости
астроном: астрономы
астрономический: астрономического астрономической
астрономия: астрономии астрономия
астрофото: астрофото
астрофотограф: астрофотограф
астрофотография: астрофотографии
ахромат: ахромат
аэрофотоплёнка: аэрофотопленку
байер: байера
барлоу: барлоу
благодаря: благодаря
блок: блок
блокировать: блокирующий
большой: большое велики
браться: берутся
будущее: будущее будущем
быстрый: быстрые быстрым
важный: важное важным
вверх: вверх
вдоль: вдоль
великолепный: великолепных
весь: весь
взгляд: взгляд
взять: возьмем
видео: видео
видеть: вижу
видимость: видимость
видимый: видимых
видный: видна
включая: включая
внутри: внутри
воздух: воздуха
возможность: возможностей возможности
возможный: возможным
возрастать: возрастает
вопрос: вопрос
восторг: восторгом
восхищаться: восхищались
время: временам времени
вспоминать: вспоминаю
вспышка: вспышка вспышку
всякий: всяком
всё: всё
второй: вторым
втулка: втулки
выбор: выбора
выбрать: выбрать
вызвать: вызвали
выполнять: выполняет выполняли
высокий: высокий высокого
выше: выше
галактический: галактическое
галлий: галлий
гармоника: гармоники
геометрический: геометрических
германиевый: германиевого
гигабайт: гигабайт
глаз: глазах
глобальный: глобальный глобальным
говорить: говорят
год: год года годов году годы лет
годиться: годится
госуниверситет: госуниверситета
гуманный: гуманный
даблстек: даблстек
давать: давайте дает дают
давно: давно
дальнейший: дальнейших
данные: данных
дать: данные
двигаться: движутся
двойной: двойной
двухлинзовый: двухлинзовым
делать: делать делают
демонстрировать: демонстрировал демонстрируют
день: день дня
десятилетие: десятилетий
деталь: деталей детали
детальность: детальности
джеймс: джеймс
диаметр: диаметр диаметром диаметру
динамика: динамику
динкинеш: динкинеш
директор: директора
диск: диска диском
добиться: добиться
доводить: доводить
докт: докт
документ: документы
должный: должен
доработка: доработку
дорога: дорогой
достаточно: достаточно
древний: древнейший
дрожание: дрожания
друг: друг друга другом
другой: другие
думать: думаю
евклид: евклида
ежедневный: ежедневных
жанр: жанр
жатый: жатого
желать: желаю
жизнь: жизни
журнал: журнале
заветный: заветный
зависеть: зависело зависеть
замахнуться: замахнуться
заметно: заметно
замечание: замечание
замечательный: замечательно замечательные замечательный
заниматься: заниматься
запись: запись
затвор: затвор затвором
затем: затем
зафиксировать: зафиксировать
звезда: звезды
земной: земного земной
значит: значит
значительный: значительной
зрение: зрения
иго: игу
избежать: избежать
известный: известного
изготовление: изготовления
изменение: изменения
изображение: изображение изображением изображений изображения изображениях
именно: именно
иметь: имел имели иметь
институт: институт института институте
инструмент: инструмент инструмента инструментами инструментов инструментом
интерференционный: интерференционно
интуитивно: интуитивно
ионосфера: ионосферы
иркутск: иркутске
иркутский: иркутского
исзф: исзф
искажение: искажений
искусство: искусства
использовать: использовал используют
исток: истоках
итог: итогам итоге итогу
к: ко
кадр: кадр кадра кадрах кадров кадры
каждый: каждого каждые каждый
казаться: кажется
какой: какую
камера: камера камерой камеру
канал: канале
картинка: картинка картинку
касаться: касается
качественный: качественнее
качество: качества качестве качество
квазар: квазар
класс: классе
коварство: коварство
количество: количество
коллега: коллеги
комбинировать: комбинировать
компонент: компонентом
комфортный: комфортной
конец: конце
конечный: конечная
конкурс: конкурсах
контраст: контраст
корона: короны
корональный: корональные
космический: космические
космос: космос
который: которую которые которым
красивый: красивого
красный: красный
крупный: крупным
кстати: кстати
кудрить: кудря
купить: куплю
линза: линзу
линия: линии линий
лишний: лишней
ловец: ловцы
любитель: любители
любительский: любительская
магнетизм: магнетизма
магнитный: магнитные магнитных
максимально: максимально
максимум: максимума
маленький: меньше
манипуляция: манипуляциями
массив: массивы
массовый: массовый
мастер: мастера
мат: мат
международный: международном международный
мелкозернистый: мелкозернистую
метод: методы
методика: методика
механизм: механизм
мечта: мечта
минута: минут
мир: мира
мировой: мировых
мм: мм
многие: многие
многий: многим многих
многодневный: многодневной
многолетний: многолетних
многочасовой: многочасовой
мой: мое моей
момент: момент
мониторинговый: мониторинговые
монохромный: монохромную
монтировка: монтировке
мочь: могла могу могут
мы: нам
наблюдать: наблюдать
наблюдаться: наблюдалась наблюдаются
наблюдение: наблюдений наблюдения наблюдениями
назад: назад
наземный: наземной
называть: называемый
накопить: накопил
например: например
насколько: насколько
настоящий: настоящий
наука: наук наука
научий: науч
наш: наш нашей наши наших
небольшой: небольшая небольшой
невозможно: невозможно
недавно: недавно
нейтринный: нейтринного
некоторый: некоторые
немного: немного
необходимый: необходимые
несколько: несколько нескольку
несмотря: несмотря
неуловимый: неуловимого
нижний: нижнюю
никак: никак
новосибирск: новосибирск новосибирска
новосибирский: новосибирский новосибирском
новый: новыми
ноутбук: ноутбук
ночь: ночь
обеспечивать: обеспечивает
область: области
оборудование: оборудование
обработка: обработки обработку
обрезать: обрезать
обсерватория: обсерватории
общий: общий
объект: объекта
объектив: объектив объективом
объём: объем
обязательно: обязательно
огромный: огромной
один: одни одного одной
оказаться: оказался
они: ими
опасность: опасности
оптика: оптика оптики
опубликовать: опубликовал
опыт: опыт
освоение: освоении
осуществляться: осуществлялась
отбирать: отбирать
отведение: отведения
отдельный: отдельных
отзыв: отзывов
отличаться: отличаются
отобрать: отобранный
отрезать: отрезает
очень: очень
память: памяти
пара: паре
паразитный: паразитные
параллельный: параллельном
параметр: параметров
паспорт: паспорт
патрульный: патрульных
перверсия: перверсия
первоклассный: первоклассные
первый: первые
перо: перо
петля: петли
пиксель: пиксель
плазма: плазмы
план: планах планом
плюс: плюс
плёнка: пленки пленок
поверхность: поверхности поверхность
повторять: повторяю
подбираться: подбираются
подписчик: подписчиков
подчеркнуть: подчеркнуть
позволять: позволяет
пока: пока
полностью: полностью
полный: полного
положительный: положительных
полоса: полоса полосой полосы
получать: получать
получаться: получалась
получение: получения
получить: получил получить
получиться: получилось
поляк: поляков
поляков: полякова
поляризационный: поляризационный
помнится: помнится
помнить: помню
помощь: помощью
понимать: понимаете понимаю
попросить: попросили
пора: пору
порадовать: порадует
поразительный: поразительные
поразить: поразили
порядок: порядка
построить: построит
потерять: потеряем
поток: поток потоки потоком
потребоваться: потребуется
потрясать: потрясающими
почему: почему
появиться: появилась
правка: правка
превышать: превышает
предпринять: предпринял
представлять: представляет
привести: привел
приехать: приехал
признать: признан
применять: применяет
примерно: примерно
принижать: принижает
проведение: проведения
провести: провел
проводить: проводил
программа: программах программы
продвинуться: продвинулась
произведение: произведение
произвести: произвел
происходить: происходит происходящих
пройти: пройти
прокомментировать: прокомментировать
пропускание: пропускания
пропустить: пропустить
просто: просто
простой: проще
протуберанец: протуберанцы
протяжение: протяжении
профессионал: профессионалов
профессиональный: профессиональные профессиональных
профессор: профессора
проходить: проходил
процесс: процессов
проявитель: проявителя
прямо: прямо
публичный: публичная
пучок: пучке
работа: работу работы
работать: работали работать
рабочий: рабочим
радиоволна: радиоволн
раз: разы
разворачиваться: разворачиваются
разгон: разгона
разгонный: разгонные
раздаваться: раздавались
разобраться: разберемся
разработать: разработанном
разрешать: разрешающая
разрешение: разрешение разрешении
ран: ран
расположить: расположенных
распространение: распространения
рассказать: рассказал
рассматривать: рассматриваю
расстояние: расстоянием расстояния
рассчитать: рассчитаны
расчёт: расчетом
реализовать: реализует
реальность: реальности
регион: регион
регулярно: регулярно
редкий: редких
режим: режиме
резонатор: резонатор
результат: результатов результаты
результирующий: результирующая
рекомендовать: рекомендую
рефрактор: рефрактор
решить: решил
российский: российской
россия: россии
рулон: рулоне
ручной: ручной
сам: самого
самый: самые самый
свой: своей своем свои своих
сделать: сделана сделать
себя: собой
северный: северное
сегодняшний: сегодняшнего сегодняшних
секвенция: секвенциях
секунда: секунду секунды
сергей: сергей сергея
сердце: сердцем
сетапа: сетап
сеть: сети
сибастро: сибастро
сибизмир: сибизмир
сибирский: сибирском
сигнал: сигнала
силовой: силовых
симпозиум: симпозиум
синоптический: синоптических
система: системы
сияние: сияние
сказать: скажу сказал сказать
скоро: скоро
скрещивать: скрещивая
слишком: слишком
случай: случае
смотреть: см
смочь: сможем
снимать: снимаем снимали снимать
сниматься: снималось
снимка: снимками
снимок: снимка снимки снимков
событие: события
солнечно: солнечно
солнечный: солнечная солнечного солнечной солнечные солнечный солнечных
солнце: солнца солнце солнцем
соответственно: соответственно
составить: составил
сотр: сотр
софт: софта
социальный: социальной
специально: специально
специальный: специального
способ: способу
способность: способность
справиться: справиться
сравнительно: сравнительно
среднее: среднем
ст: ст
старый: старым
статистика: статистике
стек: стек
степень: степени
страница: странице
студия: студии
сувенир: сувениров
сужение: сужения
сутки: сутки
существенно: существенно
схема: схеме
сходиться: сходящемся
считывать: считывает
съёмка: съемки съемок
также: также
такой: такие таким такими таких такого таком такую
тбайт: тбайт
твёрдо: твердо
телескоп: телескоп телескопа телескопах телескопе
теоретический: теоретическое
тепловой: тепловой
техника: техника
технический: технических
технология: технологией
течение: течение
тип: тип
тонкий: тонкие
топ: топ
тот: ту
точка: точки
трв: трв
требовать: требуют
требоваться: требуется
три: трех
трио: трио
труба: трубы
уверенность: уверенностью
увидеть: увидеть увидим
угловой: угловой
угроза: угрозы
удаваться: удавалось удается
удаться: удалось
узел: узлов
уметь: умеют
умещаться: умещалось
уникальный: уникальный
уровень: уровня
успех: успехов
устанавливаться: устанавливаются
установка: установки
уходить: уходящие
уэбба: уэбб
фабрить: фабри
фактор: фактора
фантастика: фантастика
фестиваль: фестивале
фигурировать: фигурировать
физ: физ
физика: физики
фильтр: фильтр фильтра фильтрах фильтры
фирма: фирмы
фокус: фокусе фокусом
фокусный: фокусного фокусным
форма: форм
форум: форуме
фотограф: фотограф
фотография: фотографии
фотопортрет: фотопортрет
фотостудия: фотостудия
хаббнуть: хаббла
хороший: лучшие лучшим
хотеть: хочет
хромосфера: хромосфере хромосферу хромосферы
хромосферный: хромосферного хромосферный
цветной: цветная
целиком: целиком
ценник: ценник
центр: центре
час: час часа часов
часто: часто
часть: часть
часы: часы
человек: люди
четвёртый: четвертый
шаг: шаги
штатный: штатных
экземпляр: экземпляр
элитный: элитной
энергия: энергии
эпоха: эпохи
эталон: эталон эталона эталоны
являться: является
язев: язев язева
