аббревиатура: аббревиатурой
автор: авторы
акваря: аквари
аккреции: аккреции
аккрецировать: аккрецирующую
активный: активное активной активных
алексей: алексей
американский: американским
амс: амс
анализ: анализа анализе
аналогичный: аналогичными
андалусийский: андалусийского
аномальный: аномальный
апрель: апреле
астероид: астероид астероида
астроновость: астроновости
астроном: астроном астрономов астрономом астрономы
астрономический: астрономические астрономическим астрономических астрономической
астрономия: астрономии
астрофизик: астрофизики
астроёлочка: астроёлочка
афелий: афелий афелия
ахилл: ахилла
ацетилен: ацетилена
бабочка: бабочка
белый: белый белым
близкий: ближайшем
близлежащий: близлежащих
боде: боде
больший: большая
большой: большого большое
будущее: будущем
будущий: будущими
быстрорастущий: быстрорастущий
быстрый: быстрый
быть: будут
вверху: вверху
вега: вега
величина: величины
весьма: весьма
вещество: вещества
взрыв: взрыва
видеть: видеть
видимость: видимость
видимый: видимому
видный: видна
влияние: влияние
вместе: вместе
внизу: внизу
внутренний: внутренние внутренних
внутренность: внутренности
внутри: внутри
вода: вода воды
водород: водорода
возвращаться: возвращается
возвращение: возвращение
возле: возле
возможно: возможно
возраст: возраст возрасту
вокруг: вокруг
волна: волн
впоследствии: впоследствии
вращаться: вращаются
время: времени время
вселенная: вселенная вселенной
всемирный: всемирному
вследствие: вследствие
всё: всё
выбрать: выбрала
выдвинуть: выдвинули
вызвать: вызвал вызван вызвана
вызывать: вызывать
выйти: вышла
выложить: выложенной
вырастать: вырастают
выявить: выявить
газ: газа
газовый: газовых
галактика: галактик галактика галактике галактики
галлей: галлей галлея
геракл: геракла
гибель: гибель
гигант: гигантов
гидра: гидры
гипотеза: гипотезу
глаз: глазами
го: го
говорить: говоря
говориться: говорится
год: года годах годом году лет
голубой: голубым
гравитационный: гравитационных
группа: группа группой группу группы
далеко: далеко
дальнейший: дальнейшем
далёкий: далекого
данные: данным данных
данный: данное
датироваться: датируются
дать: дали данная данные
два: две двух
дважды: дважды
двигаться: движется
движение: движение
двойной: двойного двойными
декабрь: декабрь декабря
дело: дело
детальный: детальное
джеймс: джеймс джеймса
джотто: джотто
диаметр: диаметром
диапазон: диапазон
динкинеш: динкинеш
диоскур: диоскуров
диск: диск диска дисками дисках диски дисков диском
довольно: довольно
дожить: дожил
доказательство: доказательства
достигнуть: достигнет
др: др
древнегреческий: древнегреческой
друг: друга
другой: другие другим другого другую
ды: ды
дыра: дыр дыра дырами дыру дыры
европейский: европейская
египет: египте
единица: единиц
ежегодный: ежегодных
жизнь: жизнь
загадка: загадкой
задача: задача
закрыть: закрыл
заметить: заметить замечено
заметно: заметно
заметный: заметных
запад: западе
заслонять: заслоняя
затмение: затмение затмения
звезда: звезд звезда звездой звезду звезды
звездообразование: звездообразования
звёздный: звездная звездное звездной звездном
земля: земли
земной: земной
знаменитый: знаменит знаменитая
значение: значения
зрение: зрения
идентифицировать: идентифицированным идентифицированных
известный: известной известных
излучение: излучением
изменение: изменение изменению
измениться: изменилось
изначально: изначально
изображение: изображение изображении изображения
изолировать: изолированных
изучать: изучал изучая
изучить: изученных изучить
именоваться: именоваться
имя: имени имя
институт: института
инструмент: инструмент
интенсивный: интенсивному
интерес: интерес
интересно: интересно
интересный: интересные
интерпретировать: интерпретировано
искать: ищут
испания: испании
использование: использование
испытывать: испытывает
исследование: исследований исследования
исследователь: исследователей исследователи
исследовательский: исследовательскую
исследовать: исследовать исследуемой
история: истории
итог: итоге
июль: июля
казаться: кажется
каков: каков
какой: какие
каменистый: каменистых
карлик: карлик карликов
карта: карта
квазар: квазар
кентавр: кентавра кентавров
кеплер: кеплера
китайский: китайские
класс: класса
классификация: классификации
км: км
коваль: ковалем
колебаться: колеблется
количество: количества количество
кольцевой: кольцевая
кольцо: колец кольца кольцо
команда: команда командой
комета: комета комете кометой комету кометы
кометный: кометной кометную
компаньон: компаньонов
конец: конце
контактный: контактного
концентрация: концентрация
корректировка: корректировке
космический: космические космический космического
космос: космос
который: которая которое которой которые который которых
коттамиа: коттамиа
красный: красном красным красных
краткий: краткое
кристаллический: кристаллическая
кроме: кроме
кружка: кружками
кружок: кружком кружок
крупный: крупным
кудрить: кудря
ледяной: ледяных
любитель: любителям
магнетар: магнетара
май: мае
малый: малой
масса: масса массой массы
массивный: массивная массивные массивных
материал: материал материала
международный: международным
мелкий: мелкая
меняться: менялось
мерка: меркам
метеорный: метеорных
метод: метода
миллиард: миллиард
мимо: мимо
минимум: минимум
мир: мир
миссия: миссией миссии
мифологический: мифологического
мифология: мифологии
михаил: михаил
мнение: мнению
множество: множество
модель: модели
молекула: молекулы
молодой: молодая молодой молодых
момент: момент
мочь: могли могут
наблюдатель: наблюдателя наблюдателям
наблюдать: наблюдаемой наблюдаемые наблюдает наблюдали
наблюдаться: наблюдается наблюдалось
наблюдение: наблюдение наблюдений наблюдения наблюдениям наблюдениями наблюдениях
нагреваться: нагреваться
надеяться: надеясь
назвать: названо
называться: называются
найти: найденных найдены
наклон: наклоном
наличие: наличие
направить: направила
настоящий: настоящее настоящий
наступить: наступил
находиться: находилась находится находятся
начало: начала
наш: нашей наши
небесный: небесное
небольшой: небольшого небольшой
недалеко: недалеко
нейтронный: нейтронная
некий: некая
немного: немного
неподалёку: неподалеку
непосредственный: непосредственного
нептун: нептуна
несколько: нескольких
несмотря: несмотря
нестабильный: нестабильна
низкий: низкой
низко: низко
новогодний: новогодний
новость: новостей
новый: новая нового новой новые новый
номер: номере
ноябрь: ноября
ньютон: ньютона
оба: обе
обвести: обведена
обзор: обзор
область: областей области область областях
облучение: облучению
облучить: облученных
обнаружение: обнаружении обнаружению
обнаружить: обнаруженная обнаруженного обнаруженных обнаружено обнаружены обнаружили
обозначить: обозначенная
образ: образом
образование: образование
образовать: образуют
образовываться: образовываться
обратно: обратно
обсерватория: обсерватории
обширный: обширный
объединить: объединенные
объект: объект объекта объектов объекты
объектив: объективах
объяснить: объяснить
один: одна одно одной одном одну
ожидание: ожидании
ожидать: ожидать
ожидаться: ожидается
озадачить: озадачил
оказать: оказать
оказаться: оказалось
окись: окиси
около: около
окрестность: окрестностей окрестности
окружающий: окружающего окружающей
окружение: окружение окружения
октябрь: октябре
омар: омар
описывать: описывающей
описываться: описываться
определённый: определенной определенный
оптический: оптическая
опубликовать: опубликовала опубликованной опубликованные
орбита: орбита орбитами орбите орбитой орбиты
орионида: ориониды
основание: основание основании
особенность: особенностей
особый: особый
оставаться: остается
оставлять: оставляет
остановить: остановить
остаток: остаток
остаться: осталось
открытие: открытие открытий
открыть: открыт
отличаться: отличаются
отметить: отметил отмечено
относительно: относительно
отойти: отошел
отправить: отправлены
отсутствовать: отсутствуют
оцениваться: оценивается
оценка: оценки
очень: очень
очередной: очередное
очередь: очередь
очертить: очерченные
падение: падений
паламарский: паламарской
пара: пары
первый: первая первого первый первым
перемещаться: перемещался
перигелий: перигелии перигелия
период: периода
периодический: периодическая
периодичность: периодичность
песочный: песочные
писать: писали пишут
план: планы
планета: планет планеты
планетезималь: планетезималей планетезимали
планетоид: планетоида планетоидом
плотность: плотности
поглощение: поглощения
подавлять: подавлять
подвергаться: подвергается
подобный: подобная подобных
подождать: подождать
подразумевать: подразумевают
подтверждение: подтверждение подтверждением
позапрошлый: позапрошлом
позволить: позволили
поздний: поздние
пока: пока
показать: показали
показывать: показывают
покрытие: покрытие покрытиями
полагать: полагать
полностью: полностью
половина: половина
положение: положении положения
полуось: полуось
получить: полученные полученный получил
полушарие: полушария
помочь: поможет
помощь: помощью
порядок: порядка
посетить: посещенного
последний: последним
постепенно: постепенно
потенциально: потенциально
потеря: потерю
поток: потока потоке
потускнеть: потускнел
похожий: похожего
поэтому: поэтому
появление: появление появлением появления
прародитель: прародитель
предел: пределах
предполагать: предполагают
предположение: предположение
предсказать: предсказал предсказанный
представить: представлены
предыдущий: предыдущем предыдущих
прежде: прежде
препринт: препринтов
привести: привели привело
примерно: примерно
принять: принято
природа: природой природу
присутствовать: присутствует присутствуют
приходиться: приходится
проанализировать: проанализировав проанализировали
провал: провал провалов провалы
провести: проведенного проведенные проведенных
программа: программах
происходить: происходит происходят
пройти: прошел прошла
проксим: проксимы
пролетать: пролетающие
промежуток: промежутке
пропасть: пропавшие
прославить: прославило
просто: просто
простой: проще
протекать: протекают
протопланета: протопланет
протопланетный: протопланетного протопланетные протопланетным протопланетных
профессиональный: профессиональным
проходить: проходит
процесс: процессе процессы
прочий: прочие
прямоугольник: прямоугольником
пульсар: пульсара пульсары
пунктирный: пунктирными
пурпурный: пурпурный
пыль: пыли пыль
пятно: пятна
пять: пять
равный: равна
ради: ради
радиус: радиусах
раз: раза
разница: разницей
ранее: ранее
ранний: ранней ранних ранняя
располагаться: располагается располагаются
расположить: расположена расположенных
распределение: распределение распределения
расстояние: расстоянии расстояниях
расти: растущими
расчётный: расчетная
расширять: расширяя
ревнивец: ревнивцев
регистрировать: регистрировать
регулярно: регулярно
результат: результаты
рекорд: рекорд
решение: решение
ровно: ровно
рождение: рождение
рост: рост
сазерленд: сазерленде
сам: самого самой
самый: самую самых
сближение: сближения
свежеоткрытый: свежеоткрытого
сверхмассивный: сверхмассивными
сверхновый: сверхновой
свет: свет свете
световой: световом световых
свидетель: свидетелями
свой: свое своей своем
свойство: свойств
связанный: связанных
связать: связано связаны
северный: северного
северо: северо
сентябрь: сентябре сентября
сервер: сервере
серый: серыми
сигнал: сигналов
силикатный: силикатная силикатной
сильно: сильно
симметричный: симметричные симметричных
система: систем система систему системы
сквозь: сквозь
скорее: скорее
скорость: скоростью
скорпион: скорпиона
скучный: скучна
слабый: слабых
слева: слева
слегка: слегка
следующий: следующим
слипаться: слипаются
слишком: слишком
слияние: слияния
сложный: сложную
смещение: смещением смещении
смотреть: см
смочь: смогут
снимка: снимок
снимок: снимки
снова: снова
событие: событие события
советский: советские
согласно: согласно
сожаление: сожалению
созвездие: созвездие созвездии созвездия
солнечный: солнечной солнечную
солнце: солнц солнца
солнцеподобный: солнцеподобной солнцеподобных
сообщать: сообщают
сообщение: сообщения
соответствовать: соответствует
соответствующий: соответствующего соответствующих
состав: состав состава
составлять: составляет
составной: составное
сохранять: сохранять
союз: союзом
спектр: спектров
спектральный: спектрально
спектроскопия: спектроскопии
спокойный: спокойных
справа: справа
спустя: спустя
спутник: спутника спутники
сравнимый: сравнимы сравнимые
среда: сред среды
срок: срок
стабильный: стабильных
стать: стал стали стало
статья: статье статьи статья
стоить: стоит
сторона: сторон стороны
странность: странности
странный: странная
структура: структуры
сумерки: сумерках
существо: существа
существующий: существующей
сходный: сходные
считаться: считалось
счёт: счет
таинственный: таинственный
также: также
такой: таким таких
телескоп: телескоп телескопа телескопам
тело: тело
тельце: тельца
теория: теории теория
тип: типа
тормозить: тормозит
тот: теми
точка: точка точки точку
транность: транности
трансформироваться: трансформирующегося
третий: третий
три: трех
триумфальный: триумфальным
туманность: туманности туманность
тяготение: тяготения
тёплый: теплый
увеличение: увеличением
увидеть: увидели
углерод: углерода
удалённый: удаленную
удивительный: удивительного
узкий: узкие
указать: указаны
ультрафиолетовый: ультрафиолетовым
умеренно: умеренно
уран: уран
условие: условия условиями
успешно: успешно
утверждать: утверждать
учитель: учителя
учёный: ученые ученых
уэбб: уэббом
уэбба: уэбб уэбба
фаза: фазе
февраль: феврале
физический: физические
формирование: формирование формированием формирования
формироваться: формируются
хаббнуть: хаббла
харикло: харикло
хвост: хвоста
химический: химические химический химического
хирон: хирон хирона хироном
ход: ходе
хотя: хотя
цветной: цветное
центавро: центавра
центр: центра центре
центральный: центральной центральных
циан: циана
цианистый: цианистого
чандра: чандры
чарлз: чарлзом
частица: частиц
частично: частично
частность: частности
часть: части часть частях
часы: часы
честь: честь
член: членов членом
чёрный: черная черной черную черные черными черных
шанс: шансов
широкий: широкая
эволюция: эволюцию эволюция
эдмунд: эдмунд
экзолуна: экзолуны
экстремальный: экстремальные экстремальных
эксцентриситет: эксцентриситетом
электронный: электронных
эмбрион: эмбрионы
этот: эта этих
южноафриканский: южноафриканской
юпитер: юпитер юпитера
явление: явления
являться: является
ядовитый: ядовитого
ядро: ядер ядро
язев: язев
яркий: яркий ярких
яркость: яркости
ясон: ясона
