абляция: абляцией абляция
абрам: абрам
австралия: австралия
автор: авторами авторы
азия: азия
азот: азота
айсберг: айсбергов
аккумуляция: аккумуляцией аккумуляции аккумуляция
аккуратно: аккуратно
активность: активности активность активностью
актуальный: актуален
александр: александр александра
алексей: алексей
алмазный: алмазная
альбедо: альбедо
аляска: аляска аляски
америка: америка америке америки америку
американский: американский
амундсена: амундсена
амундсный: амундсен
аналогичный: аналогичное аналогичные
английски: английски
английский: английского
англия: англии
аномалия: аномалией аномалии аномалий аномалию аномалия
антарктида: антарктида антарктиде антарктиду антарктиды
антарктика: антарктике антарктики
антарктический: антарктические антарктическим антарктических антарктическом
антропогенный: антропогенного антропогенное антропогенному антропогенные антропогенный антропогенных
апогей: апогея
апрель: апреле
арктика: арктика арктике
археология: археологии
архив: архивы
архивный: архивные
аспирантка: аспиранткой
астроном: астронома
атлантика: атлантика
атмосфера: атмосфере атмосферой атмосферу атмосферы
атмосферный: атмосферная атмосферной атмосферных
аэрозоль: аэрозоля
баланс: баланс баланса
бедно: бедно
бедствие: бедствиям
берег: берегов
бережно: бережно
бериллий: бериллий
беспрецедентный: беспрецедентен
бесследно: бесследно
биологический: биологических
биомасса: биомассы
биосфера: биосферой
благодать: благодать
благоприятно: благоприятно
благоприятный: благоприятного
благоприятствовать: благоприятствует
близко: близко
болезнь: болезней
больцмана: больцмана
большинство: большинстве большинство
большой: большое большой
брать: берут
браться: берется
британский: британского
будущее: будущего будущее
бывать: бывают
быстро: быстро
быть: суть
важно: важно
важный: важный важных
ватт: ваттах
вводить: вводят
везувий: везувия
век: века веках веке веков веком
великий: великий
величина: величина величины
велосипед: велосипеда
верить: верить
вернуться: вернемся вернуться
вероятность: вероятности
вероятный: вероятную
версия: версии
верхний: верхней
вестись: ведутся
весь: всей вся
весьма: весьма
вещество: вещества
взаимодействие: взаимодействии
взаимосвязанный: взаимосвязанных
взломать: взломали
взрыв: взрыв
взять: взять
вид: вид виде видов
видеть: видела видим
видимо: видимо
видимость: видимости
видный: виден
византийский: византийской
викинг: викингам
вихрь: вихрь
вклад: вклад
включая: включая
вкратце: вкратце
влага: влага влаги
влажный: влажный
влияние: влияние влиянием влиянии влияния
влиятельный: влиятельными
влиять: влиявшие влияет влиять
внешний: внешней
вниз: вниз
внимание: внимание
вновь: вновь
вовлекаться: вовлекается
вовсе: вовсе
вода: вода воде водой воды
водный: водного
водород: водорода
водяной: водяного водяной
возбудитель: возбудителей
возвращаться: возвращаться
воздух: воздух воздуха воздухе
воздушный: воздушную воздушные
возможно: возможно
возможность: возможность
возможный: возможных
возраст: возраст возрасте
возрастать: возрастает возрастать
война: войнам войны
вокруг: вокруг
вольф: вольфа
вопрос: вопрос вопросом
восемь: восемь
воспользоваться: воспользовавшись
восприятие: восприятия
воспроизводить: воспроизводит
воспроизводиться: воспроизводится
восстанавливаться: восстанавливаться
восток: восток востоке
восточный: восточно восточной
впервые: впервые
впечатлять: впечатляет
вплоть: вплоть
врать: врем
вращение: вращения
временна: временн
временной: временных
временный: временны
время: временем времени время
вроде: вроде
вручить: вручил
вспоминать: вспоминая
вспышка: вспышек вспышки
всё: всё
вт: вт
вторжение: вторжения
второе: второе
второй: второй втором вторую вторых
вулкан: вулкан вулкана вулканов вулканы
вулканический: вулканическая вулканическим вулканических вулканического вулканической
вы: вами
выбрасывать: выбрасывают
выбрасываться: выбрасывается
выброс: выброс выбросов выбросы
выбросить: выброшенного выброшенной
вывести: вывести
вывод: вывод выводы
выделение: выделение
выделять: выделяет
выжиматься: выжимается
вызвать: вызвал вызвало
выйти: вышла
выложить: выложили
вымываться: вымываются
выпадать: выпадает выпадают
выпадение: выпадения
выполняться: выполнялись выполнялось
выражать: выражают
выражаться: выражается
выраженный: выраженным
высокий: высокая высокими высоких высокой высоком
высоко: высоко
высота: высота высоте высотой
выходить: выходит
вычет: вычетом
выше: выше
вышележащий: вышележащих
выявление: выявления
гавайский: гавайские
газ: газ газа газов
газа: газы
газовый: газовый
гвинея: гвинея
геогра: геогр
географически: географически
география: география
геофизический: геофизический
гибнуть: гибнуть
гипоксия: гипоксия
гипотеза: гипотезы
глобальный: глобальная глобального глобальной глобальном глобальную глобальный глобальным
говорить: говорит говоря говорят
год: год года годам годами годов годом году годы лет
годичный: годичные годичным
годовой: годовую годовых
голод: голод голода
голодный: голодные
голоцен: голоцен голоцена голоцене голоцену
голубой: голубая голубой
гора: гора горах
гораздо: гораздо
гордый: гордое
горный: горные горных
город: городов
городницкий: городницкий
государственный: государственных
градус: градус
граница: граница границе
граничный: граничные
грант: грант
гренландия: гренландии гренландию
грозить: грозит
давать: давайте дает дают
давление: давление давления
далее: далее
далеко: далеко
дальнейший: дальнейшем
дальтон: дальтона
дальтоновский: дальтоновским
далёкий: далеком
данные: данным данными данных
дата: дат
датировать: датированное датировать
датироваться: датируется
датировка: датировка датировки
дать: данные
два: двум двух
двадцатилетие: двадцатилетие
двадцать: двадцать
движение: движения
деградация: деградация
действительно: действительно
действительность: действительности
действовать: действовали действует
дейтерий: дейтерия
дело: деле дело
демографический: демографическими
денге: денге
дендрохронологический: дендрохронологических
дендрохронология: дендрохронологией дендрохронологии дендрохронология
дерево: дерево деревьев деревья
десятилетие: десятилетий десятилетия
десять: десяти десять
детальный: детальную детальный
диаграмма: диаграмму
диапазон: диапазон диапазона диапазоне
длина: длина длиной
длинноволновый: длинноволнового
длительный: длительный
длиться: длились длился
добавка: добавки
доверительный: доверительный
довольно: довольно
дождевой: дождевая
доиндустриальный: доиндустриального доиндустриальному доиндустриальную доиндустриальный
доказательство: доказательств доказательством
доклад: доклада
докт: докт
долгий: долгое
долгопериодный: долгопериодные
должный: должен должна должно
доля: доли долю доля
донный: донные донных
досконально: досконально
достаточно: достаточно
достигать: достигает
достигнуть: достигло
доступ: доступ
доступно: доступно
доступность: доступность
доступный: доступный
доходить: доходит
древесина: древесине
древний: древними древних
друг: друг другом
другой: другая другие других другое другому
европа: европа европе европы
европеец: европейцев
европейский: европейский
единица: единицами единицах единицу
единственный: единственный
ежедневно: ежедневно
екайкина: екайкин
естественный: естественная естественной
животное: животных
жидкий: жидкой
жизнь: жизни
житель: жителей
заболевание: заболеваний
забрасываться: забрасываются
завершение: завершении
зависеть: зависит
зависимость: зависимость
задаться: задались
задача: задача задачу
задокументированный: задокументированная
задокументировать: задокументировано
закисление: закисление
закись: закиси закись
заключаться: заключается
заключение: заключение заключения
закон: закону
закономерность: закономерности закономерность
закончиться: закончилась
закрасться: закралась
заливка: заливка заливкой
заметить: заметить
заметка: заметке заметки
заметный: заметное заметной заметные
заниматься: заниматься
занятой: занятых
западный: западная западной
запас: запасы
запечатываться: запечатываются
запись: записи запись записях
запустение: запустение
засуха: засухами
затем: затем
зато: зато
заток: затоков
затруднить: затруднен
затруднять: затрудняют
затянуться: затянуться
защитный: защитный
звание: звание
звёздочка: звездочками
зелёный: зеленая
земля: земле земли землю земля
земной: земной
зерно: зернами
зима: зима
зимой: зимой
злоумышленник: злоумышленники
знак: знак
знаменитый: знаменитое знаменитую
знать: знаем
значение: значение значений значения
значимый: значимо значимых
значит: значит
значительный: значительную значительный
значок: значками
зона: зонах зоне зону
зрение: зрения
игла: игл
избавиться: избавиться
извержение: извержение извержением извержении извержений извержения извержениями
известно: известно
известный: известным известных
извинение: извинения
извлечь: извлечь
излучение: излучению излучения
изменение: изменение изменением изменении изменений изменению изменения изменениях
изменчивость: изменчивости изменчивость изменчивостью
измерение: измерения
измерить: измерить
изобретение: изобретение
изотоп: изотоп изотопа изотопами изотопов изотопы
изотопный: изотопное изотопный
изучать: изучает изучая
изучение: изучение изучении изучения
изъятие: изъятию
изыскание: изыскания
иллюзия: иллюзию
иллюстрация: иллюстрации
илопанго: илопанго
именно: именно
иметь: имеет имел имели имело иметь имеющим
иметься: имеется
империя: империи
имя: имени
иначе: иначе
индекс: индекс индекса
индийский: индийский
индонезийский: индонезийского
индустриальный: индустриальной
инертность: инертность
иной: иному иными
инсоляция: инсоляции
инструментальный: инструментальные инструментальным инструментальных
интенсивно: интенсивно
интенсивность: интенсивностью
интенсивный: интенсивный
интервал: интервал интервалы
интересный: интересная
интерпретация: интерпретации
интерпретироваться: интерпретируется
информация: информации информацию
исключение: исключением исключения исключениями
исключить: исключено
исландия: исландию
исландский: исландского
испаряться: испаряется
использование: использованием
использовать: использованы использует используют используя
использоваться: используется
исследование: исследований исследования
исследовательский: исследовательских
исследовать: исследованы
истинный: истинные
исторический: исторические исторических
история: истории историю
источник: источник источникам источнике
исходный: исходные исходных
исчерпывание: исчерпывание
итог: итоге
итоговый: итоговая
июнь: июне
каганат: каганата
каждый: каждого каждое каждой каждый
казаться: казалось
каков: какова
какой: какие каким каких каком
календарный: календарным
канада: канады
капелька: капельки
карбонат: карбонатов
картина: картину
касадый: касадо
качество: качестве
квадратный: квадратный
керн: керн керна кернам кернами кернах кернов керну керны
кислород: кислорода
кислота: кислота кислоты
китай: китая
клапейрон: клапейрона
клаузиус: клаузиуса
клещевой: клещевого
климат: климат климата климате
климатгейт: климатгейт
климатический: климатическая климатические климатическими климатических климатической
климатолог: климатологи
ключевой: ключевые
клюшка: клюшка клюшку
км: км
ковид: ковид
колебание: колебаний колебания колебаниях
количественно: количественно
количество: количества количестве количество количеством
коллега: коллег
колонна: колонны
колумбийский: колумбийского
кольцевой: кольцевой
кольцо: колец кольца кольцам
комиссия: комиссий
комментарий: комментария
компенсировать: компенсировать
комплекс: комплекс
компонент: компоненты
комфортный: комфортные комфортных
конденсация: конденсации
конец: конца конце
конечный: конечном
контакт: контакт
континент: континента континенте континентов
континентальный: континентальные
контраст: контраст
конфигурация: конфигурация
концентрация: концентрацией концентрации концентрацию концентрация концентрациях
копия: копий
коралл: кораллов кораллы
коренной: коренных
королева: королевы
корректный: корректного
коррелировать: коррелируют
корреляция: корреляция
космический: космических космического
космос: космос
который: которая которого которое которой которому которую которые который которым которыми которых
край: краям
красиво: красиво
красный: красная
кривая: кривая кривой кривые кривых
кризис: кризисом
кристаллик: кристаллики
кроме: кроме
кружка: кружки
крупный: крупнейшим крупного крупные крупных
крыться: кроется
кстати: кстати
культура: культура культуры
купол: купола
ледник: ледниках леднике ледники ледников
ледниковый: ледниковая ледниковой ледниковую ледниковый ледниковых
ледяной: ледяного ледяной ледяному ледяные ледяным ледяными ледяных
лежать: лежат
лес: леса лесов
лесной: лесные
летний: летнего летней летние летний летних
лето: лета лето летом
либби: либби
либо: либо
лимитировать: лимитирующим
линейный: линейная
линия: линией линии линия линиями
лихорадка: лихорадки
лишь: лишь
лоу: лоу
луч: лучам лучах лучей лучи
льшать: льшая
любой: любой любых
лёгкий: легкий
лёд: лед льда лёд
майкл: майкл майкла
максимальный: максимальное максимальному
максимум: максимума максимумов
маленький: меньше
мало: мало
малый: малая малой малую малый меньшей
малярия: малярии
манна: манн манну
манный: манна
масса: масса массу массы
массовый: массовой массовые
масштаб: масштабе масштабы
материал: материала материалы
материк: материков
матрица: матрице
матья: матье
маундеровский: маундеровский
маундёр: маундер маундера
мгэик: мгэик
мегавулкан: мегавулканов
мегаизвержение: мегаизвержениями
мегхалайский: мегхалайский
медаль: медаль
медицина: медицина
медленно: медленно
межгодовой: межгодовой
межледниковый: межледниковая межледниковых
межполушарный: межполушарный
мелибенга: мелибенгой
мелкий: мельчайшие
мельница: мельнице
менее: менее
менять: меняет
меняться: меняется менялась менялись менялось менялся меняться
мера: мер меру
мерзлота: мерзлоты
мериться: меряется
место: месте место
метан: метан метана
метель: метелью
метеонаблюдение: метеонаблюдения
метеорологический: метеорологические
метеорология: метеорология
метеостанция: метеостанциях
метод: метод метода методами методах методов методом методы
методика: методики
метр: метр
микроорганизм: микроорганизмов
миланкович: миланковича
миллиард: миллиарды
миллион: миллион
минеральный: минеральный
минимальный: минимальное
минимум: минимум минимумов минимумом минимумы
мир: мира
мировой: мирового
мияк: мияке
млп: млп
мм: мм
многие: многие
многий: многим многих
многое: многом
многолетний: многолетней
мода: мод моды
модель: моделей модели
модулировать: модулируют
молекула: молекулами
моллюск: моллюсков
море: моря
морской: морская морские морских морского
мочь: мог могла могли могло могут можем
мошенничество: мошенничества
мощность: мощности мощность мощностью
мощный: мощнее мощные мощным мощных
мы: нам
мэри: мэри
наблюдаться: наблюдается наблюдалась наблюдалось наблюдался наблюдаются
наблюдение: наблюдением наблюдений наблюдения
набор: набор наборов
набрать: набрать
наверняка: наверняка
навечно: навечно
наводнение: наводнений
нагреть: нагреть
надёжно: надежно
надёжность: надежности
надёжный: надежных
назад: назад
название: название названия
называть: называемая называемое называемой называемых называют
называться: называется
наиболее: наиболее
найти: найдены найти
наклон: наклона
накопить: накоплено
накопление: накоплением накопления
наличие: наличии
наоборот: наоборот
напоминание: напоминание
напомнить: напомню
например: напр например
напросто: напросто
напротив: напротив
напрямую: напрямую
нарушение: нарушения
наряду: наряду
население: население населения
настолько: настолько
настоящий: настоящее
наступать: наступает
наступить: наступила
насыщение: насыщения
наука: наук наука наукой
научиться: научилась
научно: научно
научный: научного научной научных
находиться: находится находиться
начало: начала начале начало началом
начать: начнем
начаться: началась начались началось начнутся
начинать: начинает начиная
наш: наш наша нашего нашей наши
небо: неба небе
небольшой: небольшие небольших небольшое небольшой небольшому небольшую невелик невелико
невзрывной: невзрывного
невозможно: невозможно
негативный: негативных
недавно: недавно
недоедание: недоедания
недооценивать: недооценивают
недостаточно: недостаточно
нежели: нежели
независимо: независимо
независимый: независимые
незначительно: незначительно
неизвестный: неизвестные
неизменный: неизменными
некорректный: некорректным
некоторый: некоторую некоторые
немного: немного
немногочисленный: немногочисленных
необратимый: необратимые
необходимо: необходимо
необходимость: необходимости
необычный: необычных
непонятный: непонятный
непрерывно: непрерывно
неравномерно: неравномерно
неравномерность: неравномерность
несколько: нескольких несколько
несложный: несложным
нетрудно: нетрудно
неурожай: неурожаи неурожая неурожаям
ниже: ниже
нижний: нижней
низкий: низких
нисходящий: нисходящий
нобелевский: нобелевскую
новаторский: новаторских
новозеландский: новозеландского
новый: новая
номер: номер
нормировать: нормированные
носить: носит носят
нужно: нужно
нужный: нужна
нынешний: нынешнее
нэрить: нэрили
нюанс: нюанс
оба: оба обе обоих
обвести: обведены
обеспечить: обеспечит
обзор: обзор обзору
облако: облака
обмен: обмен
обнаруживать: обнаруживают
обнаруживаться: обнаруживается
обнаружить: обнаруженное обнаружено обнаружил обнаружили обнаружить
обогреваться: обогревались
обозначать: обозначает
обозначить: обозначены
обострять: обостряет
образ: образом
образование: образовании
образовать: образует
образоваться: образуются образующийся
обратить: обратить
обратно: обратно
обратный: обратную обратные обратных
общий: общего общее общей общий общую
объект: объекты
объяснение: объяснение объяснения
объяснять: объясняли
объём: объем объемом объему
обычно: обычно
обычный: обычного обычными
обязательно: обязательно
огромный: огромное огромный
один: одна одним одно одной
однако: однако
одновременно: одновременно
однозначно: однозначно
озеро: озер озера
ознаменоваться: ознаменовалась
означать: означает
озёрный: озерные озерных
оказать: оказало
оказаться: оказалось оказался
оказывать: оказывает оказывать
океан: океан океана океанов океаном океану
океанический: океанической
океания: океания
окмокнуть: окмок
около: около
окружающий: окружающей
оксид: оксид оксидов
оледенение: оледенения
они: ними
оно: оно
оорт: оорта
опасный: опасна
опираться: опираясь
определение: определений
определить: определили
определять: определяет
определяться: определяется
оптимальный: оптимальные оптимальный оптимальным
оптимум: оптимума
оптический: оптическая
опубликовать: опубликована опубликованные
опускаться: опускается
опуститься: опустилась
орбитальный: орбитальные орбитальный орбитальных
организация: организаций
организм: организма
органика: органике органики
органический: органического
осадка: осадками осадках осадки
осадки: осадков
осаждаться: осаждается
освоить: освоить
ослабление: ослабление
основа: основе
основать: основан
основное: основном
основный: основного основными
особенно: особенно
особенность: особенность
осреднива: осреднив
осреднённый: осредненная
оставаться: оставались остаются
остальной: остальные
остановиться: остановится
остаток: остатков
остров: острове
осуществляться: осуществляется
ось: оси
ответственно: ответственно
отдалить: отдаленного отдаленной отдаленные
отдельно: отдельно
отдельный: отдельная отдельного отдельными отдельных
откол: откола
открытие: открытие
открытый: открытый
открыть: открывшего
откуда: откуда
отложение: отложения
отметить: отметить
относительно: относительно
относительный: относительных
относиться: относятся
отражать: отражает отражающий
отражаться: отражается
отрицательный: отрицательная отрицательный
отсутствие: отсутствием
отсутствовать: отсутствуют
оттуда: оттуда
отчасти: отчасти
отчётливо: отчетливо
отёл: отела
охарактеризовать: охарактеризовать
охватывать: охватывало охватывающий
охлаждаться: охлаждается
оценить: оценить
оценка: оценки
оценочный: оценочного
очевидный: очевидно очевидным
очень: очень
очередь: очередь
ошибка: ошибка
падение: падением
палеогеографический: палеогеографические палеогеографическим палеогеографическими палеогеографических палеогеографической
палеогеография: палеогеографии палеогеография
палеоклиматический: палеоклиматические палеоклиматическим палеоклиматических
палеонтология: палеонтологии
палеореконструкция: палеореконструкций
палеотемпературный: палеотемпературная
палеотермометр: палеотермометрами
панель: панели
паника: паники
папуа: папуа
пара: пар пара пару
параллельно: параллельно
параметр: параметров параметры
паркер: паркер
парниковый: парникового парниковые парниковый парниковых
парциальный: парциального
пг: пг
пепел: пепла
первоначальный: первоначальная
первый: первой первом первую первые первым первых
перегиб: перегиба
перейти: перейдут перешла
переохлаждение: переохлаждение
переписка: переписку
пересечение: пересечения
переслать: перешли
переставать: перестает перестают
перехватывать: перехватывают
переход: переход переходе
переходный: переходных
перигей: перигея
период: период периода периодов периодом периоды
перпендикулярный: перпендикулярную
перспектива: перспективе
перуанский: перуанского
пещера: пещер
пик: пики пиков
пинатубо: пинатубо
питание: питания
плавный: плавное
план: плане
планета: планета планете планеты
плато: плато
плотность: плотность
плохо: плохо
площадка: площадку
площадь: площадей площади площадь площадью
побережье: побережье побережья
поверхность: поверхности поверхность поверхностью
повествование: повествования
повесть: повести
повод: повод
повышаться: повышалась повышаются
повышение: повышение повышении повышению
повышенный: повышенное
поглощательный: поглощательная
поглощаться: поглощается
поговорить: поговорим поговорить
погрешность: погрешностей погрешности погрешностью погрешностях
подверженный: подвержены
подводный: подводного
поддержка: поддержке
подобный: подобный
подписать: подписаны
подробно: подробно
подтасовка: подтасовки
подтверждать: подтверждает подтверждают
подходить: подходит
пожалуй: пожалуй
пожар: пожары
позволить: позволило
позволять: позволяет позволяют
позднеантичный: позднеантичная
поздний: позднего позднем поздний позже
познакомиться: познакомиться
поисковик: поисковике
пока: пока
показатель: показателями
показать: показало показан показана показанной показанные показаны
показывать: показывают
покидать: покидает
покрытие: покрытия
поле: полей полями
полно: полно
полностью: полностью
полный: полным
половина: половине половину
положительный: положительному положительные
полуостров: полуострове
полураспад: полураспада
получаться: получается
получить: полученная полученные полученный полученных получивший получил получить
получиться: получилась
полушарие: полушарие полушарии полушарий полушария
польза: пользу
полюс: полюсах
полярный: полярные полярный полярных
помимо: помимо
помогать: помогает помогают
помощь: помощь помощью
помпей: помпеи
понижаться: понижается
понижение: понижение
понизить: пониженной
понизиться: понизилась
понимание: понимание понимания
понятие: понятие
понятно: понятно
понять: понять
попадать: попадают
попасть: попало
пополняться: пополняться
попросту: попросту
пора: пор поры
поровну: поровну
порог: порог
порода: породы
порядок: порядка
посверкивать: посверкивают
посвятить: посвящена
поскольку: поскольку
последний: последние последний последним последними последних последняя
последствие: последствие последствий последствия
посмотреть: посмотрим
постоянный: постоянна постоянная постоянной
построение: построение построении
поступать: поступает
посчитать: посчитали посчитать
посылать: посылают
потепление: потепление потеплением потеплении потеплению потепления
потеря: потерей потеря
поток: поток потока потоков
потреблять: потреблять
похолодание: похолодание похолоданий похолоданию похолодания
почему: почему
почитать: почитать
поштучно: поштучно
поэтому: поэтому
появиться: появился
пояс: поясе
пояснить: пояснить
правда: правда
право: прав правом
правота: правоты
практически: практически
превращаться: превращается превращаются
превысить: превысила
превышать: превышало
предел: пределах пределы
предложить: предложили
представить: представлена представленную
представление: представлениях
представлять: представляют представляющие
предыдущий: предыдущая предыдущие
прежде: прежде
преимущественно: преимущественно
премия: премию
пренебречь: пренебречь
претерпевать: претерпевала
преувеличить: преувеличены
приблизительно: приблизительно
прибрежный: прибрежной
прибывать: прибывает прибывать
привести: приведем привел привело
привнос: привноса
приводить: приводит
пригодный: пригодны пригодными
придавать: придает
приземный: приземного
признак: признаки
прийти: пришел пришло
применить: применив
пример: примере
примерно: примерно
принести: принесли
принимать: принимать
приносить: приносят
принятие: принятие
приостановка: приостановке
природный: природный природных
прирост: прирост
приурочить: приурочены
приходить: приходит приходят
приходный: приходная
приходящий: приходящей
причина: причин причина причинам причине причиной причины
причём: причем
пробурить: пробурить
проверить: проверить
проверка: проверки
прогноз: прогноза прогнозы
продлиться: продлившийся продлилась
продовольствие: продовольствия
продолжаться: продолжалось
продолжить: продолжить
продукт: продукты
производить: производят
производство: производства
произойти: произошло
происходить: происходили происходит
происхождение: происхождение
пройти: пройдет
прометей: прометей
пропасть: пропавшего пропавшему
просто: просто
простой: простая простое простые проще
пространственный: пространственное
протекание: протекания
протяжение: протяжении
профессор: профессора
проходить: проходит
прохождение: прохождения
процесс: процессе процессов
прошерстить: прошерстили
прошлое: прошлое
прошлый: прошлом прошлые прошлых
проявиться: проявилась
проявляться: проявляется проявляются
пузырёк: пузырьки
пункт: пункте пунктов
пунктир: пунктиром
пунктирный: пунктирными
пыль: пыль
пыльца: пыльце пыльцы
пятно: пятен
пятый: пятого
рабаул: рабаул
работа: работы
равно: равно
равный: равна
радиационный: радиационного радиационным
радиация: радиации
радиоактивный: радиоактивные радиоактивный
разбор: разбор
разброс: разброс
разбушеваться: разбушевался
развитие: развитие развитии
разгар: разгар
раздел: раздела
различаться: различается различаться
различие: различия
различный: различные различных
размах: размах
разница: разница
разнородный: разнородную
разность: разность разностью
разный: разному разные разным разными разных
разобраться: разобраться
разработка: разработку
разразиться: разразился
разрешение: разрешением
район: районам районах районов
раковина: раковин
рамка: рамках рамки
ранний: раньше
раскрошить: раскрошить
распад: распада
расплавить: расплавить
расположение: расположение
расположить: расположенного
распределение: распределение
распределить: распределены
распределённый: распределенную
распространение: распространению
распространяться: распространяться
распространённость: распространенность
рассказ: рассказ
расследование: расследований
рассмотреть: рассмотрим
рассчитать: рассчитать
растение: растение растений растениям растениями
расти: растет растут росла
растительность: растительность
расчёт: расчеты
расширение: расширением
реагировать: реагируя
реакция: реакций
реальность: реальности
регион: региона регионам регионах регионов региону
редкий: редкими
режим: режима
резкий: резким резкое
резко: резко
результат: результатам результате результатов результатом результаты
река: рек
реконструировать: реконструированная реконструированные реконструировать
реконструкция: реконструкции реконструкций реконструкция
ресурс: ресурсы
решить: решит решить
римский: римский римским римских
рис: рис
рисовый: рисовыми
рисунок: рисунка рисунке
ровный: ровного
розовый: розовые
роль: роль
российский: российского
россия: россии
рост: рост росте ростом
рубеж: рубеже
руис: руис
рынок: рынка
ряд: ряд ряда рядов ряды
рядом: рядом
сальвадор: сальвадор
сам: сами само самой самом
самалас: самалас
самый: самые самый самым самых
сасанид: сасанидов
сведение: сведения
светимость: светимость
свидетельство: свидетельства
сводиться: сводится
сводный: сводная сводной
своеобразный: своеобразными
свой: свое свой
свойство: свойства
связанный: связанному связанный
связать: связан связана
связывать: связывают
связь: связей связи
сгладить: сглаженная сглаженный
сглаживание: сглаживание
сдвиг: сдвиг
сдвинуть: сдвинуты
сделать: сделал сделать
себя: собой
северный: северная северного северное северной северном
северо: северо
сезон: сезона сезонов сезоном
сезонный: сезонный
сей: сих
сельский: сельского сельское
сельскохозяйственный: сельскохозяйственной сельскохозяйственным
семь: семи
сера: серы
сервер: сервера
середина: середине середины
серия: сериям
серный: серная серной
серый: серой
сигнал: сигнал
сильно: сильно
сильный: сильнее сильного сильном сильным
синий: синие синяя
синтез: синтеза
синхронизация: синхронизации
синхронизировать: синхронизировать
синхронный: синхронным
система: система системе системы
систематический: систематические
сказать: сказано
скандал: скандал
скачок: скачков
скважина: скважины
скептик: скептиков
складываться: складывалось
сколько: сколько
скорее: скорее
скорость: скорости скорость скоростью
скотт: скотт
скрытый: скрыт
слабо: слабо
слабый: слабых
след: следы
следовать: следовали следует
следствие: следствие
следующий: следующая следующие
слишком: слишком
слово: словами
сложно: сложно
сложный: сложные
сложённый: сложены
слой: слоев
сломать: сломано
служить: служат служить
слух: слухи
случай: случаев
случаться: случались случалось случаются
случиться: случившегося случились случилось случился
смена: смену
смениться: сменилась
смерть: смерти
смещение: смещение
смотреть: см
смутный: смутного
сн: сн
сначала: сначала
снег: снег снега
снегонакопление: снегонакопления
снижаться: снижалась
снижение: снижение снижением снижении снижению
снизить: снизить
снизиться: снизилась
соавтор: соавторами
собрать: собрали
собственно: собственно
событие: событие событием событии событий события
совершенно: совершенно
совпадать: совпадает
современный: современная современного современное современной современном современному современную современный современным
согласиться: согласятся
согласно: согласно
согласованность: согласованность
согласоваться: согласуются согласующиеся
содержание: содержание
содержать: содержат содержать содержит
создавать: создает
создание: создание
создать: созданы
сократить: сократило
сокращение: сокращение
солнечный: солнечная солнечного солнечной солнечные солнечным солнечных
солнце: солнца солнце солнцем
соответственно: соответственно
соответствовать: соответствующее
соотношение: соотношение соотношением соотношения
сопоставить: сопоставить
сопоставление: сопоставление
сопоставлять: сопоставлять
соприкасаться: соприкасается
сопровождаться: сопровождается сопровождаться
сосредоточить: сосредоточена
состав: состав состава
составить: составил
составлять: составляет составляла
состоять: состоит состоящего
сотня: сотен
социально: социально
социальный: социальным
союз: союз
специальный: специальной
спор: спор
способность: способность
способствовать: способствовали способствует
справедливо: справедливо
справляться: справляться
спрессовываться: спрессовывается
спровоцировать: спровоцировало
спустя: спустя
спутник: спутников
сравнение: сравнению сравнения
сравнивать: сравнивать
среда: среды
среди: среди
средиземноморье: средиземноморье средиземноморья
средневековый: средневековый
среднее: среднем
средний: средней средние средними средних среднюю средняя
стабильный: стабильными стабильных
сталагмит: сталагмиты
сталактит: сталактиты
стандарт: стандартом
станция: станции
статистический: статистические
стать: ставший стали
статья: статье статьи статья
степень: степени степенью
стефан: стефана
сто: ста сто
стоить: стоит
столб: столба
столетие: столетий столетия
столько: столько
стоп: стоп
сторона: сторону стороны
страна: стран
стратосфера: стратосфере стратосферу
стратосферный: стратосферного
сублимация: сублимации
сублимировать: сублимирует
сульфат: сульфатов
сульфатный: сульфатного
сумма: сумма сумме
суша: суше
сушить: суши
существенный: существенного
существовать: существует
существующий: существующий
счастие: счастью
считать: считает считать
считаться: считается
счёт: счет
сыграть: сыграть
таинственный: таинственного
также: также
такой: такая такие таким таких такую
тамбора: тамбора тамборе тамборы
таупо: таупо
таяние: таяние таяния
таять: тают
твёрдый: твердом твердых
тектоника: тектоника
текущий: текущая текущим
тема: тема
температура: температур температура температурах температуре температурой температуру температуры
температурный: температурная температурного температурной температурные температурный
теоретически: теоретически
теоретический: теоретические
теория: теории
тепло: тепла теплом
теплолюбивый: теплолюбивых
термодинамический: термодинамического
термометр: термометров
территория: территории
терять: теряет терять
течение: течение
тип: типа
тихий: тихого
толщина: толщина
тонга: тонга
тонна: тонн
тот: те тех той тому
точечный: точечную
точка: точками точках точке точки точку
точный: точные
траектория: траектории
тренд: тренд тренду
третий: третьем третьих
треугольник: треугольники
тропик: тропиках тропики
тропический: тропических тропического тропической
тропосфера: тропосфере
тула: туле
тысяча: тысяч
тысячелетие: тысячелетии тысячелетий тысячелетия
тюркский: тюркского
тяжесть: тяжестью
тяжёлый: тяжелых
тёплый: теплая теплее теплого теплой теплые теплый теплым теплыми теплых
уайнапутин: уайнапутина
убедительный: убедительным
убывать: убывать
убыль: убыль
увеличение: увеличение увеличении увеличения
увеличиваться: увеличивается
увлекательный: увлекательной
увы: увы
увязать: увязать
углекислый: углекислого углекислый
углерод: углерод углерода
угодный: угодно
угол: угла
угрожать: угрожать
удаться: удалось
удивительный: удивительный
удовлетворительный: удовлетворительного
узнать: узнать
уиллард: уиллард
умеренный: умеренной умеренном
университет: университета университете
уникальный: уникальные
уничтожить: уничтожившее
уолтер: уолтера
упасть: упали
упомянуть: упомянутое
уравнение: уравнению уравнения
уровень: уровень уровне уровню уровня
урожай: урожай
усваиваться: усваивается
усиление: усиление усилением
ускорение: ускорения
ускорить: ускорить
условие: условия условиях
условно: условно
успеть: успела
устареть: устареть
утверждать: утверждают
утончение: утончения
уточнить: уточнить
участвовать: участвовать участвует
участие: участия
участок: участках
учащение: учащением
учитывать: учитывать
учиться: учился
учёный: ученые ученый ученых
факт: факт фактов факту
фактически: фактически
фактор: фактор фактора факторами факторов фактором факторы
февраль: февралю
феномен: феноменом феномену
фигурировать: фигурирует
физически: физически
физический: физические физических
филиппинский: филиппинского
фирн: фирн фирна
фирновый: фирновых
фон: фоне
фонд: фонда
формирование: формирование
формировать: формируют
формула: формуле
форсинг: форсинг форсинга форсингов форсингом
франкенштейн: франкенштейн
фуса: фусой
хаапай: хаапай
ханс: ханса
характеризовать: характеризует
характеризоваться: характеризуется
характеристика: характеристик характеристики
характерный: характерной
хватать: хватает
химический: химических химического
химия: химии
ход: ход ходе
хозяйство: хозяйства хозяйство
хоккейный: хоккейная
холодно: холодно
холодное: холодного холодные
холодный: холодная холоднее холодный холодным холодных
хороший: лучшего хороший хорошим
хотеться: хотелось
хотя: хотя
худо: худо
хунг: хунга
цвет: цветом
цветной: цветные
целлюлоза: целлюлозы
целое: целом
целый: целых
центр: центров
центральный: центральной центральную центральных
цивилизация: цивилизации цивилизаций
цикл: цикл цикла
циркуляция: циркуляцией циркуляции циркуляцию циркуляция
чайник: чайник
частность: частности
частный: частных
частота: частоты
частый: чаще
часть: частей часть
человек: человека
человечество: человечество
чернокульский: чернокульского
черёд: черед
численность: численности численность
число: чисел числе
читатель: читатель
чих: чих
чтение: чтении
что: чему
чувствительность: чувствительности чувствительность
чума: чуму
чёрный: черная черной
чёткий: четкая
шарообразность: шарообразности
шелли: шелли
шельф: шельфов
шестой: шестом
ширина: ширина ширину
широкий: широкие широких
широко: широко
широта: широтами широтах широты
широтный: широтное
шкала: шкале шкалой
шперер: шперера
шпереровский: шпереровским
шум: шума
щит: щита щитах щитов
эдвард: эдварда
эйяфьядлайекюдль: эйяфьядлайекюдль
эквивалент: эквивалента
эквивалентный: эквивалентно
экономический: экономическими
экран: экран
экстремальный: экстремальных
электрический: электрический
электропроводность: электропроводности
эмиссия: эмиссии
энергия: энергии энергия
энцефалит: энцефалита
эпидемия: эпидемии эпидемиям эпидемиями
эпизод: эпизод эпизода эпизоды
эпоха: эпох эпоха эпохами эпохи эпоху
эра: эры
эрозия: эрозия
эруптивный: эруптивной
эскимосский: эскимосская
этика: этики
это: этим
этот: эта этих этому
эффект: эффекта
эффективный: эффективное эффективному
эшгера: эшгера
южный: южная южного южной
юстинианов: юстинианову
я: мной
явление: явление
являться: является являются
явно: явно
якобы: якобы
январь: январе января
японский: японской
ярко: ярко
ярус: ярус
ясный: ясного ясном
