аккреционный: аккреционного аккреционном аккреционный
активный: активного активной активных
алексей: алексей
анализ: анализ анализа
андромеда: андромеде
аппарат: аппарат аппарата аппаратов
апрель: апреля
ароматический: ароматических
астроновость: астроновости
астроном: астрономов астрономы
астрономия: астрономии
астрофизик: астрофизики
атмосферный: атмосферной
банально: банально
безлунный: безлунную
белый: бело белого белый белым
беспрецедентный: беспрецедентный
блеск: блеска
ближний: ближнего
близкий: ближайшие близкой
близко: близко
богатый: богата
болометрический: болометрическая
боль: боль
больший: большая большие
большинство: большинства
большой: большое большой велик
борьба: борьбе
будущее: будущее
быть: будут
важный: важную важным
величина: величиной
венера: венерой
версия: версия
ветер: ветрами
вещество: вещества
взрыв: взрыв взрывы
взрываться: взрывалась
взрывной: взрывной
вид: видов
видеть: видеть
видимый: видимой
видный: виден видны
включая: включая
влага: влаги
вместе: вместе
вновь: вновь
внутри: внутри
вода: водой воды
водород: водорода водородом
водяной: водяного
возможно: возможно
возможность: возможность
возможный: возможны
возникать: возникает возникающие
возникнуть: возникла
возраст: возраст
вокруг: вокруг
восстанавливаться: восстанавливается
впервые: впервые
вращаться: вращаются вращающемся
время: временем время
вселенная: вселенной
вскоре: вскоре
вспыхивать: вспыхивала
вспышка: вспышка вспышками вспышки
всё: всё
второй: второй
выборка: выборку
вывод: выводу
выпадать: выпадает
выпасть: выпадет
вырезать: вырезаны
выходить: выходящие
вязкость: вязкости
газ: газ
газопылевой: газопылевых
галактика: галактик галактика галактике галактикой
гелий: гелия
гигант: гиганта гигантом
глаз: глазом
год: года году лет
головной: головная
голубой: голубое
гора: горах
горячий: горячие
грандиозный: грандиозных
группа: группа группы
давать: дает
давний: давняя
дальний: дальние
данные: данным данными данных
данный: данном
датчик: датчика
дать: данной данные
два: двух
двойной: двойную двойных
дежавю: дежавю
демонстрировать: демонстрирует
десяток: десятков
джеймс: джеймс
диаметр: диаметр
диапазон: диапазона
диск: диск диска диске
добавление: добавлением
довольно: довольно
должный: должна
достаточно: достаточно
достигать: достигать
др: др
друг: друг друга
другой: другая другие других
дыра: дырой
евклид: евклид евклида
жизнь: жизни
завысить: завышенная
задача: задачу
заключаться: заключается
заметить: заметила
запуск: запуска запуском
защита: защита
звезда: звезд звезда звезды
звездообразование: звездообразования
звёздный: звездная звездной звездными
земля: земли
земной: земной земном
зеркало: зеркал зеркала
знаменитый: знаменитой
знать: знают
зрение: зрением зрения
играть: играет
идеальный: идеальная идеальным идеальных
идентифицировать: идентифицированных
избавиться: избавиться
излечить: излечить
излучение: излучение излучению излучения
изменение: изменение
измерение: измерения измерениям измерениях
измерительный: измерительным
изморось: измороси
изначально: изначально
изображение: изображение изображении изображения
изотропность: изотропности
изучение: изучение изучения
изучить: изучив
иметь: имеет
индивидуальный: индивидуальный
инженер: инженеры
инженерный: инженерной
инструмент: инструментом
интеграл: интеграл
интенсивный: интенсивное
информация: информации информацию
инфракрасный: инфракрасного
ионизированный: ионизированного
искать: ищут
использовать: используют
исследование: исследований
исследователь: исследователей
источник: источник
исходный: исходные
итог: итоге
кадр: кадров
каждый: каждый
калибровка: калибровки
камера: камерой
кандидат: кандидатах кандидатов
карлик: карлик карлика карликом
карта: карта карту
картинка: картинка
картирование: картирование
катаклизмический: катаклизмических
каталог: каталог каталога каталогах каталоге
каталогизация: каталогизацию
квазар: квазара квазаров квазары
килопарсек: килопарсека
класс: класса классов
количество: количество
команда: команда командой команды
композитный: композитное
конец: конце концов
конкретный: конкретном
конструктор: конструкторов
конструкция: конструкции
конус: конус
корона: корона короне
космический: космические космический космических космической
космология: космологии
космос: космос космоса космосе
который: которая которой котором которую который которых
красный: красного красным красных
кривая: кривая кривой
кроме: кроме
крупномасштабный: крупномасштабного
крупный: крупнейшим крупных
кудрить: кудря
лишь: лишь
луч: лучей лучи
лёд: лед льда
магелланов: магеллановых
магнитный: магнитное
маленький: меньше
март: марта
масса: масса массы
массивный: массивные
материал: материал материалы
материя: материю
международный: международных
межзвёздный: межзвездной
менее: менее
место: месте
месяц: месяцы
метод: методы
методический: методические
методологический: методологических
мешать: мешал
миллиард: миллиарды
мир: мир
млечный: млечного
многие: многие
многий: многих
многоэтапный: многоэтапная
молекула: молекул молекулы
молекулярный: молекулярным
молодой: молодая
момент: момент
мочь: могут
мощный: мощное
мс: мс
мы: нам
наблюдать: наблюдаемых
наблюдаться: наблюдается наблюдалась
наблюдение: наблюдения наблюдениям
наведение: наведения
нагрев: нагрев нагреве
нагревать: нагревать
назад: назад
название: название
наземный: наземной
накапливать: накапливая
наледь: наледь
нанести: нанесенных
наносить: наносимых
напоминать: напоминающих
нарушение: нарушению
настолько: настолько
настоящий: настоящий
настройка: настроек
насытить: насыщены
находиться: находилась находится находятся
начинаться: начинается
наш: нашего нашей
небесный: небесной небесном
небо: неба небе
небольшой: небольшим
невозможно: невозможно
невооружённый: невооруженным
недреманный: недреманное
независимый: независимый
незадача: незадача
неизбежно: неизбежно
некоторый: некоторая некоторое некоторых
несколько: несколько
несмотря: несмотря
низкий: низкая низким
нить: нити
новорождённый: новорожденных
новость: новостей
новый: новая новой новом новые новый новых
носить: носит
ночь: ночь
ноябрь: ноябре
оба: оба
обеспечение: обеспечения
обзор: обзор обзоре обзором
обзорный: обзорное
облако: облаках облаков
область: областей области область
обледенение: обледенением
обнаружить: обнаружено
обновление: обновление
обогреватель: обогревателей
обработка: обработка
образец: образцов
образование: образованием
образоваться: образовалась
обсерватория: обсерватории обсерватория
обслуживание: обслуживания
обширный: обширного
объединить: объединенные
объект: объектов
объяснение: объяснения
обычно: обычно
один: одна одними
однородность: однородности
ожидать: ожидают
око: око
около: около
окружающий: окружающие окружающих
оно: оно
опасность: опасность
операция: операции
оптический: оптические оптической
опубликовать: опубликована опубликованы
оранжевый: оранжевого
орбита: орбите
органический: органических
орион: ориона
основа: основе
основать: основан
особенно: особенно
особенность: особенностей
особый: особая
острота: острота
ответственный: ответственную
отметить: отметить
относительно: относительно
отобрать: отобрано
отчётливый: отчетливым
охватывать: охватывает
оцениваться: оценивается
оценка: оценки
очень: очень
параметр: параметры
пау: пау
первоначальный: первоначальный
первый: первой первые
перегрев: перегрева
передать: передал
переменный: переменных
период: период
персея: персея
песочный: песочные
пик: пиком
плавный: плавной
планета: планет
планировать: планируют
плоский: плоском
плотность: плотность
площадь: площади
повернуть: повернув
поверхность: поверхности поверхность
повторный: повторная повторной повторными
поглощать: поглощает
подготовить: подготовленный
подобный: подобного подобных
подтвердить: подтвержденных
подтверждать: подтверждает подтверждают
подход: подхода
подходить: подходит
пока: пока
показать: показал
показывать: показывающая
покрывать: покрывавшего
полагать: полагают
поле: поле
полициклический: полициклических
получать: получают
получить: полученным полученных получены получившая
получиться: получилась
полюс: полюсах
полярный: полярная
попадать: попадает
попасть: попала
попасться: попавшейся
поразительный: поразительный
последний: последний
постоянно: постоянно
построить: построенная
поступать: поступать
поступление: поступлении
потеря: потеря
потребовать: потребует
почему: почему
появиться: появились появится
правильность: правильность
практически: практически
превосходить: превосходить
превращать: превращает
превращаться: превращается превращаются
предел: предела
предельный: предельной
предоставлять: предоставляют
представить: представила представленный
представление: представление представлениям
представлять: представляет представляющих
прежде: прежде
привести: привести
приводить: приводит
приливный: приливное
примерзать: примерзают
прислать: пришли
присутствие: присутствия
причина: причина
причём: причем
проблема: проблем проблема проблему проблемы
проверка: проверок
проверять: проверяя
провести: провести
прогноз: прогнозам
программа: программа
программный: программного
продолжить: продолжит продолжить
проект: проектах
производиться: производится
происходить: происходит
происхождение: происхождение
пройти: пройдет
промежуточный: промежуточной
пронаблюдать: пронаблюдать
просвет: просветы
простираться: простирается
процент: процент процентов
пузырь: пузыри
путь: пути
пять: пяти
работать: работающая
рабочий: рабочая
развитие: развития
различить: различить
размер: размера
разработать: разработанного
разрушение: разрушение
район: районе
ранний: раннем ранние ранних
расположение: расположение
расположить: расположена расположенная
распределение: распределение распределении распределения
расстояние: расстоянии расстояния расстояниях
расширение: расширении
расширяться: расширяются
реакция: реакция
реализовать: реализует
реализоваться: реализуется
реальный: реальное
регион: регионами
редкий: редкое
результат: результате результатом результаты
ресурс: ресурс
рефсдать: рефсдала
решить: решили
роль: роль
руководитель: руководитель
сам: сами
самый: самое самые самых
сбивать: сбивали
сверхмассивный: сверхмассивной
сверхновый: сверхновой
свет: свет света
светимость: светимость
световой: светового световых
свечение: свечение
свод: своде
свой: своей своем
свыше: свыше
связать: связанная
сгусток: сгустки
сделать: сделанных
сдуваться: сдувается
себя: собой
северный: северная северное северной
сенсор: сенсоры
сентябрь: сентябрь
середина: середине
система: систем система системах систему
сияние: сияние
сказываться: сказываться
скачок: скачком
скопление: скоплении
скрываться: скрывается
слегка: слегка
след: следы
следить: следим
сливаться: сливаются
слово: словам
сложный: сложное
слой: слое
случай: случае случай
случиться: случится
смещение: смещений смещения
смотреть: см смотрим
смочь: смогли
сначала: сначала
снимка: снимок
снимок: снимки снимков
событие: событие
современный: современным
согласно: согласно
содержать: содержит
созвездие: созвездие созвездии
солнечный: солнечную солнечные
солнце: солнца
соответствовать: соответствует
сорок: сорок
составить: составлено
составлять: составляет
состоять: состоит
сохраниться: сохранится
союз: союз
спасение: спасению
спектр: спектра спектров
спектральный: спектральных
спектрограф: спектрографом
спектроскопический: спектроскопических
специалист: специалистов специалисты
спиральный: спиральная
список: списка
сравнение: сравнение
сравнимый: сравнима
среда: среда среде
среднее: среднего
стабилизироваться: стабилизируется
становиться: становятся
старт: старту
стать: стал станет
статья: статья
столь: столь
строгий: строгую
строго: строго
структура: структур структуре
сублимация: сублимации
сутки: суток
существовать: существовали
существующий: существующих
сфера: сферы
счастливый: счастливый
считаться: считается считаются
сырой: сырые
также: также
такой: такая такое
телескоп: телескоп телескопа телескопе телескопом
теоретически: теоретически
термоядерный: термоядерная
теряться: теряется
тесный: тесной
толк: толку
тонкий: тонких тончайшем
тот: тому
точнее: точнее
точность: точности
точный: точного
требоваться: требовалось
треугольник: треугольника треугольнике
три: трех
туманность: туманности туманность
тщательно: тщательно
тщательный: тщательной
тяжёлый: тяжелый
тёплый: теплый
увидеть: увидеть
углеводород: углеводородов
удачно: удачно
улетать: улетает
уровень: уровнем
усилие: усилия
условие: условиях
успешный: успешные
уступать: уступающие
утверждать: утверждает утверждают
учёный: ученые ученых
уэбба: уэбб уэбба
февраль: февраля
финальный: финальная
фон: фоне
формирование: формировании формирования
формироваться: формируется
фотометрический: фотометрических
фотон: фотонов
фрагмент: фрагмент
хаббл: хаббл
характер: характер
характеризоваться: характеризуется
ход: ходе
холодный: холодный
хороший: лучшие
хотя: хотя
хьюстон: хьюстон
цвет: цвета
целое: целом
чандрасекар: чандрасекара
часть: части часть
часы: часы
человек: человек
человеческий: человеческой
чистый: чистую
чрезвычайно: чрезвычайно
чёрный: черной
шум: шума
эволюция: эволюции
экстремальный: экстремальными
эпоха: эпохи
эрг: эрг
этап: этапах
этот: эта этими этих
южный: южного
явление: явление явления
являться: является являются
ядро: ядер ядра
яркий: яркая ярких ярче
ярко: ярко
яркость: яркости яркость
