абабаба: абабаб
абиогенный: абиогенному
автор: автором
адаптер: адаптера адаптеры
аденин: аденин аденинов аденины
адениновое: адениновые
адениновый: адениновой
азотистый: азотистое азотистыми
активировать: активировало
активность: активности активность активностью
активный: активного активном активный активным
акцепторный: акцепторного акцепторный акцепторным
аланин: аланин аланина аланином
александр: александром
алфавит: алфавит алфавита алфавите
альпина: альпина
альтернативный: альтернативные
альтштейн: альтштейн
альфа: альфа
амид: амиды
амидный: амидную
амилоидный: амилоидного
аминоацил: аминоацил
аминогруппа: аминогруппа аминогруппами аминогруппу
аминокислота: аминокислот аминокислота аминокислотам аминокислотами аминокислоте аминокислотой аминокислоту аминокислоты
аминокислотный: аминокислотного аминокислотное аминокислотном аминокислотный
аммиак: аммиака
амфибия: амфибий
анализ: анализ
аналог: аналогов
аналогично: аналогично
англоязычный: англоязычной
анемия: анемия
антибиотик: антибиотиков
антикодон: антикодон антикодонов антикодону
антикодоновое: антикодоновые антикодоновыми
антикодоновый: антикодоновая антикодоновой антикодоновую
аппарат: аппарата
аптамер: аптамеров аптамеры
аптамерный: аптамерный
аргинин: аргинин аргинина аргинином
аргумент: аргументов
ароматический: ароматические
архея: архей
аспарагин: аспарагин
аспарагиновый: аспарагиновая аспарагиновой
аспартат: аспартат аспартата аспартатом
атмосфера: атмосфере
бактерия: бактерий
безбелковый: безбелковой
безопасный: безопасна безопаснее
безусловно: безусловно
белка: белке белки
белков: белковым белковых
белковый: белковая белкового белковой белковом белковому белковую белковые белковый
белозерский: белозерского
белок: белка белкам белками белках белков белок
беседа: беседы
бета: бета
беть: бето
биография: биография
биолог: биологи биологом биологу
биологический: биологические биологических
биология: биологии биология
биосинтез: биосинтеза биосинтезе
биосфера: биосферы
биохимия: биохимии
благоприятствовать: благоприятствовала
ближний: ближний
близкий: близки близких
близко: близко
богатый: богаты
боков: боковой
больший: большая больших большую
большинство: большинства большинство
большой: большой велика
борис: борис бориса
брать: берет
бывать: бывает бывают
быстрый: быстрые
быть: будем будут будучи будь
важно: важно
важный: важен важная важнее важнейшим важные важный
валин: валин валина
вариант: вариант варианте вариантов варианты
ваш: ваши
введение: введению
вдоль: вдоль
ведать: ведая
великолепно: великолепно
вернуться: вернулись
вероятно: вероятно
вероятность: вероятность
версия: версии
весь: всей всем вся
весьма: весьма
веточка: веточке
взаимодействие: взаимодействие взаимодействий взаимодействия
взаимодействовать: взаимодействовать взаимодействующая взаимодействующие
взяться: возьмется
вид: виде видов
видеозапись: видеозапись
видимый: видимых
видно: видно
видный: видны
википедия: википедия
вироида: вироидами вироиды
вирус: вируса вирусам вирусов вирусы
вирусология: вирусологии
вич: вич
включать: включают
включая: включая
включение: включение
включить: включены
вместе: вместе
внесение: внесению
внимание: внимание внимания
вновь: вновь
внутренний: внутренним внутренняя
вода: воды
водород: водорода
водородный: водородные
воззрение: воззрения
возможно: возможно
возможность: возможность
возможный: возможного
возникать: возникает
возникновение: возникновение возникновения
возникнуть: возникла возникли возникнут возникнуть
возраст: возраст
возродить: возрожденную возрожденные
вокруг: вокруг
вообще: вообще
вооружение: вооружений
вопрос: вопрос вопросы
восемь: восемь
воскресить: воскресить воскрешенный
воспроизводимость: воспроизводимость
воспроизводить: воспроизводимого воспроизводимое воспроизводимые воспроизводят
восстанавливать: восстанавливают
восстановительный: восстановительной
вписываться: вписывается вписывались вписываются
вплоть: вплоть
вполне: вполне
впоследствии: впоследствии
врезка: врезку
время: времени время
вроде: вроде
вряд: вряд
вселенная: вселенной
всепланетный: всепланетной
вспомогательный: вспомогательными
вставить: вставленные
встречаться: встречаются
встроить: встроить
всё: всё
вторичный: вторичной
второе: второе
второй: втором вторых
вход: входа
входить: входили входить входят
входящий: входящих
вхождение: вхождения
выбрасывать: выбрасывая
выбрать: выбрала
выглядеть: выглядит
выделить: выделена
вызвать: вызвать
вызывать: вызывать
выкинуть: выкинуть
вымереть: вымершая
вымирание: вымирание
вынести: вынесена
выпадать: выпадать
выполнять: выполнять
выпуск: выпусках
высказаться: высказался
высокий: высоким высоких
вытеснить: вытеснены
выход: выходе
газ: газа
галактика: галактиках
гемоглобин: гемоглобин гемоглобине
генетический: генетическим генетического генетической генетическом
геном: геномы
геномика: геномикой
геотермальный: геотермальные
гибкий: гибкая
гигантский: гигантским
гидроксильный: гидроксильными
гидролиз: гидролиза
гидрофобный: гидрофобная гидрофобного гидрофобные гидрофобных
гипертермофил: гипертермофилом
гипертермофильный: гипертермофильных
гипотеза: гипотез гипотеза гипотезу гипотезы
гистидин: гистидин
главное: главного
главный: главная главную главный главными
глаз: глаза
глицин: глицин глицина глицинам глицином
глобула: глобулы
глубина: глубину
глубокий: глубже глубокие
глутамат: глутамат глутамата
глутамин: глутамин
гнуться: гнется
говорить: говорил говорили говорить говоря
год: году годы лет
голый: голая
гомополимерный: гомополимерные
гонка: гонка гонке гонки
гораздо: гораздо
горячий: горячих
готовый: готовые
группа: группами группой группу
гуанин: гуанин
давать: давайте давать дает
давление: давлением
далеко: далеко
дальнейший: дальнейшие
далёкий: дальше подальше
данные: данным
дарвин: дарвину
дарвиновский: дарвиновской
дать: дали
два: две двумя двух
двигаться: двигается двигаться
двойной: двойная двойной
двуспиральный: двуспирального двуспиральной двуспиральные двуспиральный двуспиральных
девять: девять
дезаминироваться: дезаминироваться
действительно: действительно
декодировать: декодирующем декодирующий декодирующим
делать: делавшего делает делала делать делают делая
дело: деле
держаться: держатся
десятка: десятки
десяток: десятков
десять: десяти
деталь: деталей
диаминомасляный: диаминомасляная
диаминопропионовый: диаминопропионовая
дисульфидный: дисульфидные
длина: длине длины
длинный: длинная длинной длинные длинными
днк: днк
добавить: добавить
добавлять: добавлять
добавляться: добавлялись
довольно: довольно
должный: должен должны
дополнительный: дополнительные дополнительными
достаточно: достаточно
достижение: достижение
доступный: доступного
доходить: доходить
древний: древней древние древних древняя
друг: друг друга другом
другой: другие другим другими других другого другое
думать: думаю
дупликация: дупликации дупликация
евгений: евгением евгений евгения
единичный: единичный
единственный: единственная единственное
естественно: естественно
естественный: естественный естественным
железо: железа
живой: живой живых
жизнь: жизни жизнь
жить: жил
журнал: журнале
жёсткий: жесткая
жёстко: жестко
забавный: забавное
заболевание: заболевания заболеваниях
заведомо: заведомо
завершить: завершим
зависимый: зависимой зависимых
заглянуть: заглянуть
заканчиваться: заканчивается заканчивающегося
заклинить: заклинив
заключаться: заключалась
закодировать: закодированные
закончиться: закончилось
замена: замена
заменить: заменив
замениться: заменились
заметить: заметить
заметный: заметной
заниматься: занимавшиеся занимается заниматься
заново: заново
запомнить: запомнил
запретить: запретить
заражение: заражению
заря: заре
заряд: заряд заряда зарядом
зарядить: заряжен заряженная заряженное заряженной заряженные заряженными заряженных заряжены
зафиксировать: зафиксирована
звезда: звезд
звено: звено
здравствуйте: здравствуйте
земля: земле земли
знак: знаками
знаменитый: знаменитым
знать: знаем знали знать
значит: значит
зоолог: зоологу
зрение: зрения
идея: идея
идти: шел шло
избежать: избежать
известно: известно
известный: известном известный известных
изложить: изложить
изменение: изменения
изменчивость: изменчивость
изолейцин: изолейцин
изучать: изучают изучающих
изучение: изучения
именно: именно
иметь: имеет имела имели иметь имеют
имидазольный: имидазольной
имитировать: имитировало
иммунодефицит: иммунодефицита
иначе: иначе
инвариантный: инвариантные
иной: иного ином иные
инструмент: инструментов инструменты
интервью: интервью
интересный: интересная интересном
интуитивно: интуитивно
инфляция: инфляции
информация: информации
ион: иона ионы
исключить: исключено
искусственный: искусственному искусственным
использовать: использованную использовать используя
использоваться: использовался
исправить: исправить
история: историю
источник: источниках
каждый: каждой каждом каждую каждый
казаться: кажется
какой: какие каким каких какого какое каком какому какую
калий: калий
кальций: кальций
катализ: катализ катализа
катализатор: катализатор катализаторы
катализировать: катализировать катализирует
каталитический: каталитический каталитических каталитической
катион: катионы
кафедра: кафедре
кипяток: кипятке
кислород: кислород
кислота: кислота кислотами кислотах кислоты
кислотный: кислотно
кислый: кислых
кишечный: кишечной
клеверный: клеверного
клетка: клетках клетке клетки клеток
клеточный: клеточная клеточными клеточных
клубок: клубка клубке клубки клубок
книга: книге книги
код: код кода коде кодов кодом коду
кодировать: кодируемого кодируемому кодируемые кодируемый кодируемым кодируют кодирующим
кодон: кодон кодонами кодонов кодоном
количество: количество количеством
колыбель: колыбель
комментарий: комментария
компактно: компактно
компактный: компактный
компенсация: компенсации
компенсировать: компенсировать компенсирующий
комплементарность: комплементарности
комплементарный: комплементарное комплементарные комплементарных
компонент: компонент компонентами
конец: конца конце концов концом
конечность: конечности
конкретно: конкретно
консенсус: консенсуса
контакт: контакт контакта контактам контактов контакты
контактировать: контактируют
контекст: контексте
контролировать: контролирует
контроль: контролем контроля
копирование: копирования
копировать: копировал копировать
копия: копий копия копиями
коротенький: коротенькие коротенький коротеньких
короткий: короткие короткий коротких
короче: короче
космологический: космологической
космология: космологии
который: которая которого которое которой котором которую которые который которыми которых
край: крае
красный: красным
кратко: кратко
криковский: криковских
кристалл: кристаллы
кристаллизация: кристаллизации
кристаллизоваться: кристаллизоваться кристаллизуются
кроме: кроме
кружка: кружками
крупный: крупные крупными крупных
крыло: крыла крыло
ксенонуклеиновый: ксенонуклеиновых
кто: кого
кунин: кунин кунина куниным
курица: курицы
кусочек: кусочке
ле: ле
лейцин: лейцин
лента: ленты
либо: либо
лизин: лизин лизина лизином
линия: линиям линиями
лист: листа
литература: литературе
лишний: лишним
логика: логика
ломаться: ломается
луковица: луковицы
любой: любой любых
лёгкий: легче
магний: магний магния
максимальный: максимального
максимум: максимум
маленький: маленькие маленькими меньше
мало: мало
маловероятный: маловероятным
малый: малая малой
марков: марковым
матрица: матрица матрице
матричный: матричная матричной
машина: машин машина
мгу: мгу
медленно: медленно
медь: меди
менее: менее
менять: меняли
меняться: меняется
мера: мере
место: местами местах месте место
металл: металлов
метан: метана
метеоритный: метеоритной
метод: методами
механизм: механизм механизмами механизмы
мечтать: мечтали
микроб: микробов
микробный: микробной
миллер: миллер миллера
миллиард: миллиарда миллиарды
минимальный: минимальном
минорный: минорные минорный минорным минорных
мир: мира мире миру
михаил: михаил михаилом
многие: многие
многий: многих
множество: множество
модель: модель
мой: моего моему
молекула: молекул молекула молекулами молекулах молекуле молекулу молекулы
молекулярный: молекулярная молекулярными молекулярных
молния: молнии
молодой: молодые моложе
момент: момент момента
мост: мостами
мостик: мостики
мотивировка: мотивировка
мочь: мог могла могли могут можем можете
мутагенез: мутагенезу
мутация: мутации мутаций
мы: нам
мягкий: мягче
набор: набор набора наборе
наверное: наверное
наделить: наделившая
надеяться: надеюсь
наземный: наземных
называть: называемая называемые
называться: называются
наиболее: наиболее
найти: найти
накопить: накоплено
накопиться: накопились
накопление: накопления
наложить: наложить
наоборот: наоборот
напоминать: напоминает
направить: направленные
направление: направлению
напрашиваться: напрашивается
например: например
наработать: наработанный
нарушать: нарушает
нарушить: нарушить
насколько: насколько
наслать: нашли
наследственность: наследственность
натяжка: натяжкой
наука: наука науках науке
научий: науч
научно: научно
научный: научной
находиться: находится находятся находящиеся
начало: начала начале начало
начальный: начальные
начаться: началось начаться
начинать: начинает начиная
наш: наша
неблагоприятный: неблагоприятных
невозможный: невозможен
недостаток: недостатков
независимый: независимую
незаряженный: незаряженные
неизбежно: неизбежно
неинтересный: неинтересно
нейродегенеративный: нейродегенеративных
некодировать: некодированного некодируемый
некоторый: некоторая некоторые некоторый некоторыми некоторых
немножко: немножко
немой: нем
необходимый: необходимы
неорганический: неорганические неорганических
неправильный: неправильный
неразгибать: неразгибаемые
несвободный: несвободными
несимметричность: несимметричности
несимметричный: несимметричный
несколько: нескольким нескольких несколько
несложный: несложными
несомненно: несомненно
нести: несут
неструктурированный: неструктурированными
несущий: несущей несущие
нетермостойкий: нетермостойкие
неудобный: неудобными
неуязвимость: неуязвимость
неуязвимый: неуязвимы
неферментативный: неферментативная
нии: нии
никакой: никаких
никитин: никитин никитиным
никто: никто
нить: нити
ничтожно: ничтожно
ничуть: ничуть
нм: нм
новшество: новшеств новшество
новый: новое новой новую новых
номер: номера
нона: нон
носитель: носителе носители носителю носителях
нравиться: нравится
нужно: нужно
нужный: нужна нужное нужны
нуклеазам: нуклеазам
нуклеиновый: нуклеиновой нуклеиновыми
нуклеотид: нуклеотида нуклеотидам нуклеотидами нуклеотидов нуклеотиды
нуклеотидный: нуклеотидные
обеспечивать: обеспечивает обеспечивать обеспечивающая
обеспечиваться: обеспечивается
обмануть: обмануть
обнаруживаться: обнаруживаются
обозначить: обозначены
обозримый: обозримой
образ: образом
образование: образование образованию образования
образовать: образовав образован образует образуют
образоваться: образуются
образовывать: образовывать
обрасти: обросла
обратить: обратите
обратный: обратное обратную
обслуживающий: обслуживающей
общепринятость: общепринятости общепринятость
общий: общий
объяснить: объяснить
объёмный: объемная объемные
обязательно: обязательно
обязательный: обязательна
ограничение: ограничение
огромный: огромное
один: одна одним одно одного одной одном одному одну
одинаковый: одинаковых
однако: однако
однозначный: однозначного
односпиральный: односпиральный
означать: означает
оказаться: оказались оказалось
окислительный: окислительно
окончание: окончании
они: ними
оно: оно
опасный: опасен
опознание: опознания
опознать: опознает
определение: определение
оптимизировать: оптимизированная
опубликовать: опубликована
опыт: опыта опытах опыте опыты
организм: организмов организмы
организовать: организует
органика: органике
органический: органические
оригинальный: оригинальном
орнитин: орнитин
оружие: оружием
осадка: осадок
основа: основу
основание: основание оснований основания основаниями
основной: основной
основный: основная основного
особенно: особенно
особый: особых
остальной: остальные
остаток: остатка остатками остатки остатков
остов: остова
осуществлять: осуществляющий
ось: ось
отбор: отбор отбором
ответ: ответа ответов
ответить: ответить
отдел: отдела
отдельно: отдельно
отдельность: отдельности
отдельный: отдельная отдельного отдельными
открытие: открытия
откуда: откуда
отличие: отличие
отлично: отлично
отличный: отличный
отобрать: отобранные
отодвинуть: отодвинута
отражать: отражает
отрицательно: отрицательно
отрицательный: отрицательный отрицательным
отталкивание: отталкивание
оттенок: оттенком
оценивать: оценивая
оценить: оценить
очень: очень
очередной: очередное
очередь: очередь
ошибка: ошибку ошибок
пазл: пазл
палочка: палочке
пара: пар парам пары
парадокс: парадокс
паразит: паразит паразитов паразиты
паразитизм: паразитизм
паразитировать: паразитируют
парный: парные
пептид: пептид пептида пептидов пептиды
пептидилтрансферазный: пептидилтрансферазная пептидилтрансферазного пептидилтрансферазном пептидилтрансферазную пептидилтрансферазный
пептидный: пептидного пептидной пептидных
первый: первого первом первому первую первые первый первым первых
переделать: переделанные
передний: переднем передние
переживание: переживание
перейти: перейти
перекосить: перекошен
перемешать: перемешаны
перенос: перенос переносу
переносить: переносить
переноситься: переносится
переход: переходе
переходить: переходя
периодический: периодические периодическими периодических
периферия: периферией
петлить: петля
петля: петле петлей петли петлю петлями
пиримидиновый: пиримидиновое
плавать: плавают
плавник: плавники
плазмида: плазмиде
план: плане
плотный: плотного
плохо: плохо
плохой: худших хуже
плюс: плюс
поверхность: поверхности
повод: поводу
поворот: повороты
повреждение: повреждения
повтор: повторам
повторить: повторенной повторить
повторный: повторного
повышать: повышает
повышаться: повышается
поглощать: поглощает
подавать: подавать
поддержать: поддержан поддержаны
поддерживать: поддерживать
поддерживаться: поддерживался
подобный: подобное подобном подобных
подсоединяться: подсоединяться
подсунуть: подсунуть
подтвердить: подтвержденные
подумать: подумаем
подход: подход
подходить: подходят
позвать: позвали
позволять: позволяет позволяют
позвоночный: позвоночных
поздний: поздних позже
позировать: позирует
позиция: позиции
поискать: поискать
пойти: пошло
показать: показано показаны
показывать: показывает показывают
полезный: полезен полезна полезного полезной полезные полезным полезными полезных
полиаланин: полиаланин
полиамин: полиамины
полиглицин: полиглицин
полимер: полимерах
полимераза: полимераз полимераза полимеразам полимеразах полимеразы
полностью: полностью
полноценный: полноценная
полный: полная полного полной
положительно: положительно
положительный: положительный положительным
поломать: поломав поломать
получать: получаем
получаться: получается получалась получаться
получение: получения
получить: получен полученных получены получить
получиться: получилось получится
польза: польза пользу
полярный: полярные
полёт: полета
помогать: помогает помогало помогать помогают помогающие
помощь: помощью
понадобиться: понадобились
понятно: понятно
понять: понял
пополам: пополам
попробовать: попробовать попробуем попробую
популярный: популярной
попытка: попытке
пора: пор
порассуждать: порассуждать
порядок: порядка
последний: последнее последние последний последними
последовательность: последовательности последовательность последовательностью
последовательный: последовательных
посмотреть: посмотреть посмотрим
поспорить: поспорить
постепенный: постепенной
построить: построить
потенциал: потенциал
потерять: потеряна
потомок: потомков потомок
поучаствовать: поучаствовал
похожий: похожи
почему: почему
пошаговый: пошагово
поэтому: поэтому
появиться: появившийся появилась появились появился появиться
появление: появление появлением появлении появления
правдоподобие: правдоподобия
правило: правило
правильно: правильно
правильный: правильное правильным
практически: практически
превращаться: превращаться
предел: пределах
предложить: предложили
предок: предок
предоставлять: предоставляя
предполагать: предполагаю
предположить: предположить
представить: представить
представлять: представляет представлял представляют представляющий
предшественник: предшественник предшественники предшественников
предыдущий: предыдущем предыдущие
преимущество: преимущество
прекрасно: прекрасно
прекращаться: прекращается
преодолеть: преодолеть
приводить: приводящих
придумать: придумать
прикрепить: прикреплены
прилипнуть: прилипнут
приложить: приложило
применить: применил
применять: применяемого
пример: пример примере
примерно: примерно
примитивный: примитивной
принимать: принимает
приносить: приносят
принцип: принципе
принципиально: принципиально
принципиальный: принципиальную
принять: примет принятая принять
приобретение: приобретение
припоминать: припоминали
присоединить: присоединенной
присоединять: присоединял присоединять
присоединяться: присоединяется
присутствие: присутствии
присутствовать: присутствующий
притягиваться: притягиваться
причина: причинам
пробирка: пробирке
проблема: проблемы
проверить: проверить
проверка: проверку
проверять: проверяет проверяют
проводить: проводят
проговаривать: проговаривать
продвижение: продвижение
продолжение: продолжение
продукт: продукта продуктом
продуцировать: продуцировать
производить: производил производить
производный: производные
произвольный: произвольной произвольных
произойти: произошла произошло
происходить: происходил происходила происходит
происхождение: происхождение происхождении
пройти: прошла прошло
проконтролировать: проконтролируете
пролин: пролин пролина пролином
пронумеровать: пронумерованы
пропускаться: пропускались
простенький: простенькие
просто: просто
простой: простейшем простого простое простые простым простыми простых проще
пространственно: пространственно
противоион: противоионы
противоречивый: противоречивых
противоречить: противоречу
протометаболический: протометаболических
проторибосома: проторибосом проторибосома проторибосомы
прототранспортный: прототранспортных
проходить: проходят
процесс: процессе процессов процессы
процессинг: процессинге
прочитать: прочитать
прошлое: прошлого прошлое
прошлый: прошлых
прямой: прямого
псевдоуридина: псевдоуридин
птица: птиц
птичий: птичьего
публикация: публикации публикаций
пуриновый: пуриновое
путь: пути путь
путём: путем
пытаться: пытались
работа: работа работах работы
работать: работает работают работающими
рабочий: рабочего рабочем рабочий рабочим рабочих
равновесие: равновесие
ради: ради
разбираться: разбираться
развернуть: развернутая
развивать: развивать
развивающийся: развивающегося
развитие: развития
различный: различных
размер: размере
размножаться: размножаться
разнообразие: разнообразием разнообразия
разноцветный: разноцветными
разный: разные разных
разрушать: разрушают
разрушение: разрушения
разрушить: разрушить
разряд: разряды
рамка: рамках
ранний: ранних раньше
рано: рано
распад: распад
распознавать: распознающие
рассказ: рассказа
рассказать: расскажу рассказал рассказали рассказать
расстояние: расстоянии
раствор: раствор растворе
расти: растут растущего растущей
расходиться: расходится
расширение: расширение
реакция: реакции реакций реакцию реакция
регулярный: регулярным
редактор: редактора
результат: результате
репликатор: репликатор репликатора репликаторе репликатором репликаторы
репликация: репликация
реплицироваться: реплицирующихся
рептилия: рептилий
рибоза: рибозу рибозы
рибозим: рибозимов
рибозима: рибозимам рибозимами
рибозимый: рибозим рибозима рибозимы
рибосома: рибосом рибосома рибосоме рибосомой рибосому рибосомы
рибосомный: рибосомная рибосомной рибосомную рибосомные рибосомным рибосомных
рис: рис
рнк: рнк
роль: роли
ррнк: ррнк
рука: руку
русский: русском
рыба: рыб
рыбообразный: рыбообразных
рядом: рядом
сайт: сайте
сам: самими самого самой самом самому
самосборка: самосборка самосборкой
самостоятельно: самостоятельно
самый: самая самое самую самые самый самым самыми самых
сборка: сборке сборки
свернуться: свернуться
светлый: светлым
свидание: свидания
свидетельство: свидетельств
свобода: свобода свободы
свободный: свободен
свой: своей своих свой своя
сворачивание: сворачивание сворачиванию
сворачивать: сворачивать
сворачиваться: сворачиваются
связанный: связанные
связать: связанная связать
связывание: связывание связывании
связывать: связывает связывать связывают связывающий
связываться: связываться
связь: связей связи
сдвигать: сдвигают
сделать: сделает сделанное сделать
себя: собой
сегодня: сегодня
сей: сих
семейство: семейства
сердцевина: сердцевина
серин: серин
серосодержать: серосодержащая
серповидный: серповидно
сила: силами
сильно: сильно
сильный: сильная
синий: синим
синтаз: синтаз синтаза синтазы
синтез: синтез синтеза синтезом синтезу
синтезировать: синтезировать
синтетаз: синтетазы
синтетический: синтетические
система: система системами системах системе системы
скажем: скажем
сказать: сказал
складываться: складывается
скомпенсировать: скомпенсировать
скорее: скорее
скреплять: скрепляющие
слабо: слабо
слабый: слабую
следующий: следующего следующей следующие следующий следующим следующую
слишком: слишком
слово: слова
слоевой: слоевая слоевого слоевой слоевую слоевыми
сложить: сложенной
сложно: сложно
сложность: сложности сложность
сложный: сложная сложное сложные сложный сложным сложными сложных
слой: слоев слои слой слоями
сломать: сломано сломать
случай: случае случая
случайно: случайно
случайный: случайная случайное случайной случайные случайный случайным случайными
слушатель: слушателям
смена: смену смены
сменный: сменная
смесь: смеси
смотреть: см смотрел смотреть смотрите
смочь: смогу
смягчить: смягчил
собирать: собирать
собрать: собрать
собраться: собрались
собственно: собственно
собственный: собственной
событие: события
совершенный: совершенном совершенные
совместимый: совместимы
совпадать: совпадает совпадая
совпадение: совпадение
современный: современного современной современном современную современные современных
соединение: соединение
соединиться: соединилась
соединять: соединять
соединяться: соединяться
сожаление: сожалению
создавать: создавать
создание: создания
сократить: сократить
солевой: солевые
соль: солей
соображение: соображение
соответствие: соответствие соответствия
соответствовать: соответствуют соответствующей
соответствующий: соответствующие соответствующими
соседний: соседними
состав: состав составе
состояние: состоянии
состоять: состоит состоят состоящие состоящий
сотня: сотни
сотр: сотр
сохраниться: сохранилось сохранится
сохранять: сохраняют
сохраняться: сохраняется
спасибо: спасибо
спикер: спикеры
спираль: спиралей спирали спираль
спиральный: спиральная спиральную спиральные
спиртовой: спиртовой
список: списком
спонтанно: спонтанно
спорить: спорить
способ: способ
способность: способности способность
способный: способные способных
справиться: справиться
спрашивать: спрашиваю
сравнение: сравнение сравнению
сравнимый: сравнимой
сравнительный: сравнительной сравнительный
сразу: сразу
среда: среде
среди: среди
средний: средними
средство: средств средства
стабилизация: стабилизации
стабилизировать: стабилизировало
стабильность: стабильности стабильность
стабильный: стабильного стабильны стабильных
стадия: стадии стадий
стандартно: стандартно
становиться: становится
старший: старше
стать: стал стала стали стало
статья: статьи
стебель: стебель стеблем стебля
степень: степень
сторона: сторону стороны
стохастический: стохастические
страдать: страдает
строго: строго
структура: структур структурами структуру структуры
стыд: стыда
стэкинг: стэкинг
стэнли: стэнли
субъединица: субъединиц субъединица субъединице субъединицей субъединицу субъединицы
судить: судя
существо: существ
существовать: существует
схема: схема схему
сходиться: сходятся
считать: считает считать
счёт: счет
съесть: съел
сыграть: сыграл
также: также
таки: таки
таков: таковы
такой: такая такие таким такими таких такого такое таком
тело: тело
тема: тему
температура: температурам температурах
тенденция: тенденции
теория: теории теорий теория
тепло: тепло
термофил: термофилом
тимин: тимин
тип: типа типами типов
типичный: типичная типичных
тирозин: тирозин
тонкий: тонкие
торчать: торчащим
тот: та те теми тех той тому ту
точка: точками
точность: точность
точный: точное
транспортный: транспортная транспортной транспортную транспортные транспортных
трв: трв
третий: третий
треть: трети
три: трем трех
трилистник: трилистника
триплет: триплетами
трипликаз: трипликаза
триптофан: триптофан
трнк: трнк
троицкий: троицком
тройка: тройками
трудно: трудно
трудовой: трудовая
трёхмерный: трехмерной трехмерный
туда: туда
туманность: туманности
тысяча: тысяча
тёмный: темным
убрать: убрать
уверенный: уверен
увидеть: увидеть
угарный: угарного
угол: углом
удаться: удалось
уделить: уделено
удлинение: удлинение
удлинять: удлиняет
удобный: удобные
узкий: узкие
узнавать: узнают
узнать: узнаем узнает
указать: указаны
указывать: указывает
укладка: укладка укладки укладкой укладку
укоротить: укоротить
ультрафиолет: ультрафиолет
уменьшение: уменьшения
уметь: умеют
универсальный: универсальная универсальное
уотсон: уотсон
упомянуть: упомянул
упорядочить: упорядочена
упрощённый: упрощенные
ускорять: ускоряют
условие: условий
усложнение: усложнения
устойчивость: устойчивость
устойчивый: устойчивы
уступать: уступая
уточнить: уточню
участвовать: участвует
участие: участие
участок: участка участкам участки участков участок
учиться: учившийся
учёный: ученые ученым ученых
факт: фактов
фенилаланин: фенилаланин
фермент: ферментах ферментов ферменты
ферментативный: ферментативного
физико: физико
фикшн: фикшн
форма: форм формах форме формы
формироваться: формировалось
фотокатализ: фотокатализе
фотолиаза: фотолиазе
фрагмент: фрагмент фрагменты
фундаментальный: фундаментальное
функциональность: функциональность
функциональный: функциональной
функция: функцией функции функций функцию функция
характерный: характерных
химически: химически
химический: химическая химическим химических химическое химической химическую
химия: химией
ход: ходе
хозяин: хозяев хозяин
хороший: лучшая хорошая хороший хороших
хотеться: хочется
хотя: хотя
цвет: цветом
центр: центр центра центре центром
цепочка: цепочек цепочка цепочке цепочки цепочку
цепь: цепи
цик: цик
цикл: циклах
цинк: цинк цинка
цистеин: цистеин
цитидина: цитидин
частично: частично
часто: часто
часть: частей части часть
человек: человека
чередование: чередование чередованием
чередовать: чередуемых чередуя
чередоваться: чередуются
четыре: четыре четырех
чинить: чинящим
число: числе
чудовищно: чудовищно
чёткий: четких
шаг: шаг шагами шаге шаги шагов шагом
шесть: шести шесть
шпилька: шпилек шпильки
штерн: штерн штерна
шум: шума
щелочной: щелочной
щель: щели
эволюционно: эволюционно
эволюционный: эволюционной эволюционному эволюционные эволюционный эволюционным эволюционных
эволюция: эволюции эволюция
эксперимент: эксперимент экспериментах эксперименте эксперименты
экспериментально: экспериментально
электрический: электрические электрический электрического
электростатически: электростатически
электростатический: электростатическое
этап: этапе этапов
это: этим
этот: эта этими этих этому
эукариот: эукариот
юри: юри
являться: являются
явно: явно
ядро: ядра
язык: языке
яйцо: яйца
