абрахамса: абрахамса
автопротокол: автопротокол
автор: автор авторами авторы
аквариум: аквариуме
аксон: аксон аксонам аксонов аксоны
акт: актах
активность: активности активность активностью
алиперо: алипера
амакринов: амакриновыми амакриновых
амакриновый: амакриновые
амплитуда: амплитудой
аналогичный: аналогичные
аналоговый: аналоговым
андреевич: андреевичем
аномалокарис: аномалокариса
ансамбль: ансамблей
аппаратура: аппаратуры
арена: арене
артропод: артропод
база: базе базу
безболезненный: безболезненного
белые: белые
белый: белого белому
бентосный: бентосных
беспозвоночный: беспозвоночных
бесчелюстной: бесчелюстных
бинокулярный: бинокулярное
биол: биол
биолог: биологи
биостанция: биостанции
биофак: биофака
биофизик: биофизика
биполяра: биполяр
биполярный: биполярная биполярные биполярным биполярными биполярных
биполяров: биполяров
благодаря: благодаря
близкий: близка близкие близкого
блок: блока
бодрствование: бодрствовании
бок: бокам
больший: большие
большой: большого большое
борк: борке
британский: британский
быть: будучи
бёрджес: бёрджеса
важно: важно
ваня: ваню ваня
вверх: вверх
ввести: введенных
вводить: вводят
вегетарианец: вегетарианцев
век: века
великий: великий
величина: величина
вентральный: вентральной
верный: верна вернее
вертикально: вертикально
вертикальный: вертикального
вести: ведут
весь: весь всем всеми
ветвиться: ветвящийся
взаимодействие: взаимодействие
взаимодействовать: взаимодействуют
взаимосвязь: взаимосвязей
взгляд: взгляд
взор: взора
взрослый: взрослая взрослого взрослом взрослых
взрыв: взрыва
вид: вид виде видов
видеокамера: видеокамере
видимый: видимого
видообразование: видообразования
виртуоз: виртуоз
виртуозный: виртуозному
висцеральный: висцеральная висцеральной
включение: включение
внесение: внесении
внешний: внешнего
вниз: вниз
внимание: внимания
внутренний: внутреннего внутреннем внутренних
внутриклеточный: внутриклеточными
вовсе: вовсе
возбуждать: возбуждающих
возбуждаться: возбуждающихся
возбуждение: возбуждение возбуждению
возможно: возможно
возможный: возможная
возникать: возникает возникала
волга: волге
вопрос: вопрос
воспринимать: воспринимающий
восприниматься: воспринимается
восприятие: восприятия
воспроизвести: воспроизвел
впервые: впервые
вперёд: вперед
впечатление: впечатлением
впечатлять: впечатляет
временно: временно
время: время
врождённый: врожденные
вскоре: вскоре
всс: всс
всё: всё
второй: вторые вторых
входной: входное входной
выбирать: выбирать
выбор: выбор
выборочный: выборочное
выбрасывать: выбрасывает
вывод: выводу
выдвинуть: выдвинутой
выделение: выделением выделении
выделять: выделяемого
вызывать: вызывал вызывают
выключение: выключение
выполнить: выполненных
выпускник: выпускник
выражаться: выражается
выразительный: выразительной
высокий: высокую высшей
выстилать: выстилающая
выход: выхода
выходной: выходного выходной выходных
выше: выше
вышеописанный: вышеописанные
ганглий: ганглиях
ганглиозный: ганглиозная ганглиозные ганглиозным ганглиозными ганглиозных
генерировать: генерируемые генерируют
генетика: генетики
генетический: генетические генетических
гетерострак: гетеростраков
гиперполяризоваться: гиперполяризуются
гипотеза: гипотезу гипотезы
гк: гк
главное: главного
главный: главной главном главный главным
глаз: глаз глаза глазами глазу
глазков: глазков
глазница: глазницах
глазной: глазное
глиальный: глиальные
глубина: глубин глубинах глубине
глубокий: глубокий
глютамат: глютамат
говорить: говоря
говориться: говорилось
год: года годами годов году годы лет
голова: голове голову головы
головоногий: головоногих
голубеть: голубей
гольджи: гольджи
горизонт: горизонте
горизонтально: горизонтально
горизонтальный: горизонтального горизонтальной горизонтальные горизонтальным горизонтальными
градуальный: градуально
граница: границ границы
грех: грехи
громкоговоритель: громкоговоритель
группа: группа группе группы
губчатый: губчатой
давать: давало дает
дальнейший: дальнейшем
дальний: дальнем
далёкий: дальше
данио: данио
данные: данным данных
два: двух
двигательный: двигательной
двигаться: двигались движется движущиеся
движение: движение движения движениям
двнц: двнц
двумерный: двумерное
делиться: делятся
демонстрировать: демонстрировала
дендрит: дендрит дендрита дендритами дендритов
деполяризация: деполяризации
деполяризовать: деполяризованы
деполяризоваться: деполяризуются
десяток: десятков
деталь: детали деталями
детектирование: детектирование
детектировать: детектирующих
детектор: детектор детекторами детекторов детекторы
детекторный: детекторная детекторные
детектрами: детектрами
деятельность: деятельности
джерри: джерри
ди: ди
диаметр: диаметром
диморфизм: диморфизма
дирекциональный: дирекционально
длиться: длиться
доказать: доказал доказано
доклад: докладом
докт: докт
долгий: долгий долгое
должный: должен
доминировать: доминируют
дорзальный: дорзальной
дорога: дороге
достаточно: достаточно
доступный: доступны
др: др
древний: древней древних
дрозофила: дрозофилы
друг: друг друга другом
другой: другим других
думать: думали
единица: единице
единообразный: единообразных
единство: единство
единый: единая единой едином единую
елена: елена
жаба: жаба
желудок: желудка
жертва: жертва
живой: живое живых
животное: животного животное животные животным животных
животный: животном
жизнь: жизни жизнью
жить: живших жила
жук: жука
журнал: журнал
зависеть: зависящие
зависимость: зависимости
зависимый: зависимых
завораживать: завораживает
задача: задача задачи
задний: заднюю
закрепить: закреплена
закрывать: закрывала
замечать: замечали
занимать: занимают
заниматься: занимаются
записывать: записывают
запуск: запуска
заранее: заранее
зарегистрировать: зарегистрировать
засыпать: засыпала
затаиться: затаившейся
защитный: защитных
звенигородский: звенигородской
звено: звеном
звучание: звучание
зеленушка: зеленушки
зенкин: зенкин зенкиным
знак: знак
знаменитый: знаменитой
знание: знание
значимый: значимых
значит: значит
зона: зон
зоолог: зоолог
зрачок: зрачки
зрение: зрение зрением зрению зрения
зрительно: зрительно
зрительный: зрительного зрительной зрительную зрительные зрительный зрительным зрительных
иван: иван
игнобелевский: игнобелевской
игорь: игорем
играть: играет
идейно: идейно
избегание: избегание избегания
избирательный: избирательные избирательных
известно: известно
известный: известного известны известных
изготовить: изготовить
изменение: изменение изменению
измениться: изменился
изображение: изображение изображении изображения
изолировать: изолированной изолированных
изучать: изучал изучали
изучение: изучение изучения
иллюминация: иллюминации
имаджинга: имаджинга
иметь: имеет иметь имеют
иммунохимия: иммунохимия
импульс: импульсов импульсы
иначе: иначе
инвертировать: инвертирована инвертированное
институт: института институте
интактный: интактных
интернейрон: интернейроны
интерпретироваться: интерпретируются
информационный: информационное
информация: информации
иппи: иппи
искать: искать
ископаемое: ископаемого
испанский: испанский
использовать: используемых используют
использоваться: используются
исследование: исследование исследовании исследований исследования
исследовать: исследовал исследованных исследуем
история: истории
итак: итак
итог: итоге
итого: итого
каждый: каждого каждой каждый
какой: каким каких
камерный: камерного камерные камерный
канада: канаде
канд: канд
карась: карасей карась карася
карликовый: карликовый
карп: карпа
карта: карт карте карту карты
картина: картина картину картины
картинка: картинки картинку
кафедра: кафедры
кафель: кафелем
кахаля: кахаль кахалю
квант: кванта
кембрий: кембрия
кембрийский: кембрийский
кисточка: кисточек
кишка: кишок
клетка: клетка клеткам клетками клетки клеткой клеток
клеточный: клеточных
ключевой: ключевой ключевых
книжка: книжке
коготь: когтей
колбочка: колбочек колбочки
количество: количеству
коллега: коллег коллеги коллегой
коллекция: коллекции
командировка: командировке
комната: комнате комнаты
комплект: комплект
компьютер: компьютерами компьютером
компьютеризовать: компьютеризованные
конец: конца конце
конечный: конечном
константность: константность
конструкция: конструкции
контакт: контакт
контактировать: контактируют
контраст: контраста
контрастный: контрастная контрастные
контроль: контролем
конфокальный: конфокальные
концепция: концепция
кора: кора коры
коралловый: коралловых
корковый: корковых
коробка: коробку
короткий: короткий
котик: котики
который: которой котором которому которую которые который которых
кошка: кошка кошки
край: края
крайний: крайней
краситель: красителей красители
кратко: кратко
крепление: крепления
кролик: кролика
крошечный: крошечный
крупный: крупных
курс: курс
лаборатория: лаборатории
летвин: летвин летвина
летие: летие
линия: линий
липкий: липкий
литература: литературе литературы
лоренц: лоренца
луч: луч луча
лягушка: лягушка лягушке лягушки
маккалох: маккалох
максим: максимов
максимов: максимова максимовым
маленький: маленькое
малое: малого
малый: малых меньшие
малёк: мальками мальках мальков
марк: марка
мастерство: мастерству
математика: математики
матрица: матрицу
матуран: матурана
мгновение: мгновение
мгновенно: мгновенно
мгу: мгу
медленный: медленные
мелководье: мелководье
мембрана: мембраной
менее: менее
месторождение: месторождения
месяц: месяцами
металлический: металлические
метод: метод методам методами методом методы
методика: методика методике методику
механизм: механизмах
мешать: мешает
микровольт: микровольт
микроманипулятор: микроманипулятор микроманипулятора
микроскоп: микроскопы
микроскопия: микроскопия
микроэлектрод: микроэлектроды
мимо: мимо
минога: миноги
минута: минутами
мир: мир мира мире
мировой: мировым
михаилович: михайловна
мкм: мкм
млекопитающее: млекопитающих
многий: многих
многое: многом
многообразие: многообразии
многослойный: многослойная
множество: множества множество
модельный: модельное модельном модельным модельных
модифицировать: модифицировали
мозаика: мозаики
мозг: мозг мозга мозгу
молекула: молекулой
молекулярный: молекулярной
моллюск: моллюсков
молодой: молодого молодой
молчать: молчат
монитор: монитора
море: морей моря морях
морской: морских
морфо: морфо
морфолог: морфолог морфологи
морфологический: морфологических
морфология: морфологии
морфофункциональный: морфофункциональных
мощный: мощная мощное мощный
муха: мухи
мы: нам
мышь: мышей мыши
мюллеровский: мюллеровские
наблюдать: наблюдали
наблюдаться: наблюдаются
наблюдение: наблюдение
набор: набор наборе наборы
наварить: наваренной
навестить: навестил
назад: назад
название: название
назвать: назвали
называть: называемый называли называют
найти: найти
накапливаться: накапливались
накопление: накоплением
наоборот: наоборот
направление: направление направлении направления
например: например
напротив: напротив
наркоз: наркозом
наружное: наружном наружным
наружный: наружных
насекомое: насекомого
настоящий: настоящее
насчитывать: насчитывающей
наука: наук
научно: научно
научный: научной
находиться: находился находится
начало: начале
начальный: начальным
наш: наша наше нашего нашей
невероятно: невероятно
недавно: недавно
недоставать: недостающим
недоумение: недоумение
неизменный: неизменными
неимпульсный: неимпульсным
нейромедиатор: нейромедиатора нейромедиаторов нейромедиатором
нейроморфолог: нейроморфолог
нейрон: нейрон нейрона нейронам нейронами нейронах нейронов нейроны
некоторый: некоторые некоторыми
ненаркотизировать: ненаркотизированной
необходимый: необходимые
неповреждённый: неповрежденными
неподвижный: неподвижные неподвижный
непрерывный: непрерывной
нерв: нерв
нервный: нервная нервной нервные нервными нервных
несколько: нескольких несколько
низкоомный: низкоомные
николаевич: николаевич
новаторский: новаторской
новый: нового
нормальный: нормальной нормальными
обездвиженный: обездвиженными обездвиженных
обезьяна: обезьян обезьяны
обеспечивать: обеспечивают
обзор: обзор обзора
обладать: обладающих
область: области
обнадёживать: обнадеживали
обнаруживать: обнаруживали
обнаруживаться: обнаруживались
обнаружить: обнаруженного обнаружены
обозначить: обозначен
оборонительный: оборонительный
обострение: обострение
обработка: обработка обработки обработкой обработку
образ: образа образом
образовать: образуют
обратно: обратно
обратный: обратном
обсуждаться: обсуждается
обусловить: обусловленного обусловленных
обучить: обучить
общий: общего общее общие общих
объединить: объединены
объект: объекта объекте объекты
обычно: обычно
один: одни одних одной одном
одинаково: одинаково
одинаковый: одинаковых
оказаться: оказалось
око: ока
около: около
окончание: окончаний окончания
окраска: окрасок
окрашивание: окрашивание окрашивания
он: нему
они: ими
онлайн: онлайн
описание: описаний
описать: описали описана описанный описанных описано описаны
описывать: описывает описывают
определение: определение
определять: определяем
определяться: определяется
опровергать: опровергающие
оптика: оптика оптикой
оптикума: оптикум
оптический: оптическая оптическом
оптомоторный: оптомоторная
опыт: опыт опыта опытах опыте опытов опыты
орган: органов
организация: организации
организовать: организуют
ордовик: ордовика
ориентационный: ориентационно
ориентация: ориентации ориентация
ориентировать: ориентированные ориентированных
орлов: орлов орловым
ортогональный: ортогональной
освещение: освещении освещения
оснастить: оснащена
основание: основании
основатель: основателя
основное: основном
основный: основных
особенность: особенность
осока: осоке
оставаться: остается остаются
остаться: осталась
острота: остроту
осциллограф: осциллографе
отведение: отведения
отверстие: отверстие
ответ: ответ
ответный: ответная ответные
отводить: отводимых отводящей
отдел: отделов
отдельный: отдельных
открыть: открыта открыты
отличаться: отличающихся
отличный: отличные
отметить: отметили
относительно: относительно
отношение: отношений
отпечаток: отпечатки
отпугивать: отпугивающих
отросток: отростками отросток
отсюда: отсюда
отшельник: отшельников
охотничий: охотничье охотничьего охотничьем
оцифрованный: оцифрованные
очень: очень
палеонтолог: палеонтологи
палеонтологический: палеонтологического
палочка: палочки
панцирь: панцирей
паркер: паркер
паук: пауки
пелагический: пелагических
первичный: первичная первичные первичный
первый: первые первый первым первых
передаваться: передаются
передать: передать
передача: передача передачи
переключаться: переключаются
переключение: переключение переключения
переключиться: переключился
период: период
периферия: периферию
пигарёв: пигарёв пигарёва
пигмент: пигмент пигмента
питтс: питтс
пищевой: пищевом пищевые
плавать: плавающей плавающими
план: плане планов
платина: платины
плотва: плотвы
поведение: поведение поведении поведения
поведенческий: поведенческих поведенческом
поверхностно: поверхностно
поверхность: поверхности поверхность
повлиять: повлияло
поворачиваться: поворачивается
поглощение: поглощение
погружение: погружении
подвижный: подвижное подвижны подвижные
подводный: подводная
поддерживать: поддерживает
поддерживаться: поддерживалась
подкорковый: подкорковых
подобно: подобно
подобный: подобный
подтип: подтипов
подходить: подходит
позволять: позволяет позволяла
позвоночный: позвоночных
показать: показано
показывать: показывают
покой: покоя
покровительственный: покровительственных
покрывать: покрывают
полагать: полагая
поле: поле полей
полезный: полезные
полностью: полностью
половой: полового
полоса: полосы
полоска: полоски полоску
полусфера: полусферу
получать: получает получая
получить: получил получили
помочь: поможет
помощь: помощи помощью
понятно: понятно
понять: понять
попросить: попросила
популярный: популярной
популяция: популяций
пора: пор
порадовать: порадовал
поровну: поровну
порядок: порядка
поскольку: поскольку
последний: последние
последовательность: последовательностей
послужить: послужил
постепенно: постепенно
постичь: постигли
постсинаптический: постсинаптической
поступать: поступают
потенциал: потенциал потенциала потенциалы
похожий: похожие
почему: почему
появление: появление появлению
практикум: практикум
практически: практически
превышать: превышающие
предложить: предложил
предметный: предметное
предпочитать: предпочитающих
предпочтительный: предпочтительной
представитель: представителя
представление: представление
представлять: представляет
предъявлять: предъявляют
предыдущий: предыдущих
прекращаться: прекращается
премия: премии
препарат: препарат
пресноводный: пресноводных
прибрежный: прибрежной
привести: привело
приводить: приводит
придаваться: придается
признак: признака признаки признаков
признать: признана
прийти: пришел
примат: приматов
пример: примеры
принимать: принимает принимать
принципиально: принципиально
природа: природе
приходить: приходит
причина: причиной
проблема: проблем
проводиться: проводятся
проецировать: проецируемое
прозрачный: прозрачную прозрачны прозрачных
производить: производят
произвольный: произвольное
происходить: происходит
происхождение: происхождение
пройти: пройти
проплывать: проплывают
пропорциональный: пропорциональна
прослушивать: прослушивали
просто: просто
пространство: пространства
проходить: проходил проходит
процесс: процесса процессе процессы
прочитать: прочитав
проявление: проявления
птица: птиц
путь: путь
пытаться: пытаются пытаясь
пятно: пятен пятна
пятнышко: пятнышка пятнышки пятнышко
рабдом: рабдому
работа: работ работах работы
работать: работаем работает работал работала работали работать работаю работая
развивать: развивал
развиваться: развивается
развитие: развитие развитию
развитой: развитые
раздражение: раздражений
различать: различать
размер: размер размера размеры
разнообразный: разнообразные разнообразным разнообразными разнообразных
разноцветный: разноцветной
разный: разной разные разными разных
разработать: разработаны
разработка: разработки
разрешать: разрешающую
разум: разума
рамон: рамон
ран: ран
ранний: раннего раньше
располагаться: располагаются
расположить: расположенный расположенных расположены
распространяться: распространяется
рассказать: рассказав
рассказывать: рассказывает
рассматривать: рассматривать
расстояние: расстоянию
растение: растений
растр: растр растре
реагировать: реагировали реагируют
реакция: реакции реакций реакцию реакция
реальный: реальным
регистрация: регистрации регистрация
регистрировать: регистрировали регистрируем регистрируют
регистрироваться: регистрируются
результат: результатами результаты
ретинотектальный: ретинотектальную
ретинотопический: ретинотопические
рефлекс: рефлекс
рецептивный: рецептивных
рецептор: рецептор рецепторами рецепторов рецепторы
рецепторный: рецепторной
решить: решили
рис: рис
роговица: роговица
родственник: родственника
роль: роли роль
русский: русское
рыба: рыб рыба рыбах рыбе рыбы
рыбка: рыбка рыбки
рыть: роющего
са: са
сам: самой
самоконтроль: самоконтроль
самостоятельно: самостоятельно
самый: самый
сантъяго: сантъяго
сантьяго: сантьяго
сверху: сверху
свет: света свету
светлый: светлому светлых
световой: светового
светочувствительность: светочувствительность
светочувствительный: светочувствительной светочувствительные
свободно: свободно
свободный: свободное
свой: своей своем своим своя
свойство: свойств свойства свойствам
свыше: свыше
связь: связей связями
сделать: сделал
себя: собой
севастополь: севастополе
сегмент: сегментам сегментов
секунда: секунд
семинар: семинаре
сенсорный: сенсорной
серебрение: серебрения
сетчатка: сетчатка сетчатках сетчатке сетчатки сетчаток
сетчатый: сетчатых
сеть: сетью
сигнал: сигнал сигнала сигналов сигналы
сигнализировать: сигнализируют
сила: силы
синапс: синапс
синаптический: синаптическими синаптических синаптического синаптической синаптическом
система: система системе систему системы
сквозь: сквозь
скрытный: скрытного
сланцевый: сланцев
слева: слева
следование: следования
следовать: следует
следующий: следующей
слово: слово
сложный: сложная сложнее сложный
слоистый: слоистую
слой: слое слоев слой слоя слоях
служить: служит
слушатель: слушатели
смертный: смертные
смонтировать: смонтировал
смотреть: см смотрела смотрит
снизу: снизу
снос: сноса
сносить: сносит
совершенствование: совершенствованию
совершенствоваться: совершенствовалась
советский: советской
современный: современного современным современных
содержание: содержании
сон: сна сне
сообщать: сообщает
сообщество: сообществом
соответственно: соответственно
соответствие: соответствие
соответствовать: соответствует
соответствующий: соответствующих
соседний: соседней
состав: составу
составлять: составляют составляющих
состояние: состоянии
состоять: состоит
сотня: сотен
сотрудник: сотрудник сотрудника сотрудники сотрудником
сохраняться: сохраняются
спереди: спереди
специализиовать: специализиованных
специализированный: специализированных
специализировать: специализированный
специально: специально
специальный: специальном специальные
специфика: специфике специфику
специфический: специфическими
способ: способов способом
способность: способность
способствовать: способствовало
справа: справа
справедливо: справедливо
сравнивать: сравнивать
ставрида: ставриды
стандартный: стандартном стандартный
станок: станке
старое: старого
старый: старейший
стать: стала стали стало
статья: статье статьи статью
стебель: стебли
стекло: стекле
стенка: стенку
стимул: стимул стимула стимулов стимулы
стопка: стопкой
сторона: стороны
страна: стране
стратификация: стратификации
стрекоза: стрекозы
стрелка: стрелкой
строение: строение строения
структура: структур структурах структуру
студент: студентов
существовать: существует
схема: схема
считать: считал
считаться: считается считалось
сша: сша
съесть: съесть
также: также
такой: такие таким таких такого такую
таксон: таксонов
тектум: тектум тектуме тектумом
тело: тел тела тело
тема: тема
темнота: темноте
тенденция: тенденция
теоретически: теоретически
теория: теории теорию теория
терминальный: терминальных
течение: течение течением
тинберген: тинбергена
тип: тип типа типами типов
ткань: ткань тканям
толчок: толчком
том: томах
тонкий: тонкие
тормозиться: тормозится
тормозной: тормозных
тот: те тех тому
точно: точно
трава: трава
традиционный: традиционная
транскриптомный: транскриптомных
трансформироваться: трансформируется
трейсера: трейсеры
третий: третьи
три: тремя
трилобит: трилобитов
тринадцать: тринадцати
трифонов: трифонов трифоновым
тёмный: темному темные темных
уверенность: уверенностью
увидеть: увидев увидели
увлечённо: увлеченно
угловой: угловому
углубление: углублениях
удивительный: удивительная
удобный: удобное удобном удобны
узел: узлы
узнать: узнать
ультрамикротом: ультрамикротомы
уменьшить: уменьшенное
умный: умнее умный
управляемый: управляемые
уровень: уровне уровню
усач: усача
услышать: услышали
успеть: успеть
устанавливаться: устанавливается
установка: установка
устроить: устроены
устройство: устройство
участвовать: участвует
участие: участие
ученик: учениками
фазовый: фазово
фазоконтрастный: фазоконтрастные
факт: факт
фасетка: фасеток
фасеточный: фасеточные фасеточный
фауна: фауны
физиолог: физиологи
физиологический: физиологических
физиология: физиологии
фиксация: фиксации
флуоресцентный: флуоресцентных
флюоресцентный: флюоресцентные
фокусировать: фокусирует
фон: фона фоне фону
фоновый: фоновой
форма: форм формы
формирование: формирование формирования
формировать: формируют формирующих
формироваться: формируются
фото: фото
фоторецептор: фоторецептора фоторецепторов фоторецептором фоторецепторы
фоторецепторный: фоторецепторный
фототаксис: фототаксис
фронтальный: фронтально
функционально: функционально
функциональный: функциональных
функция: функции
характер: характер
харкевич: харкевича
хвост: хвоста
хищник: хищник хищника
хищный: хищных
ход: ход
холоднокровный: холоднокровные
хороший: хорошим
хрусталик: хрусталик
цвет: цвет
цветной: цветные
цветовой: цветовое цветовым
цветооппонентный: цветооппонентными цветооппонентных
целое: целом
целый: целой
центр: центр центра центре центры
цепь: цепи
цнс: цнс
цыплёнок: цыпленка
частенько: частенько
частично: частично
частичный: частичную
часть: части
человек: человека
человекообразный: человекообразные
челюсть: челюстей
череп: черепа черепе
черепаха: черепахи
черепной: черепную
черно: черно
черта: чертах
четвероногий: четвероногие
четыре: четыре
четырёхдневный: четырехдневных
число: числе
читать: читала
чёрный: черного черное
шесть: шесть
шляпка: шляпкой
щука: щук щука щуке щуки
эволюционист: эволюционисты
эволюция: эволюции
экология: экологией
экран: экран экрану
экранный: экранную
экспедиция: экспедициях
эксперимент: эксперимент эксперимента эксперименте
экспериментально: экспериментально
экспериментальный: экспериментальная
экстерорецептор: экстерорецепторов
экстраклеточный: экстраклеточно экстраклеточного
электрический: электрические электрических электрического
электрод: электрод электрода электродами электроды
электролитичёска: электролитически
электронный: электронные
электрофизиологический: электрофизиологическим электрофизиологическими
элемент: элементов
эндрю: эндрю
энцефалограмма: энцефалограмма
этаж: этажей
этап: этапы
это: этим
этология: этологии
этот: эта этих
южный: южных
юрий: юрием юрий
яблоко: яблоко
являться: является являются
ядерный: ядерных
ядро: ядра ядром
язык: язык языка
