абиотический: абиотическое
австралийский: австралийских
автотрофия: автотрофией
автотрофный: автотрофным
адф: адф
активироваться: активировался
активный: активное активные активный
актуальный: актуальная
акционный: акционных
альтернатива: альтернатива
альтернативный: альтернативная альтернативной
альфа: альфа
американский: американских
анализ: анализ
ангстрем: ангстрем
армен: армен арменом
архейной: архейной
архейный: архейная
асгардархея: асгардархеи асгардархей асгардархея
аста: аст
астрофизик: астрофизика
атмосфера: атмосфере атмосферу атмосферы
атом: атома атомами атомов атомы
атф: атф
бактериальный: бактериальная бактериальной бактериальные бактериальных
бактерио: бактерио
бактериохлорофилл: бактериохлорофилла
бактерия: бактерией бактерии бактерий бактерию бактериям бактериями
баланс: баланса
без: безо
безвредный: безвредной
безмитохондриальный: безмитохондриальных
безъядерный: безъядерных
белка: белки
белковый: белковые белковый
белок: белка белками белках белков белком белок
белые: белые
берег: берегов
беседа: беседа беседы
биол: биол
биолог: биолога
биологический: биологических
биология: биологии
биоплёнка: биопленками
биохимический: биохимических
биохимия: биохимия
биоэнергетика: биоэнергетики
благодаря: благодаря
близкий: ближайшие ближайшими близкая
бо: бо
болезнь: болезни
больший: большая большие большим больших большую
большинство: большинства
большой: большого большое большой
борис: борис бориса
бороться: боремся
брать: берем берет берут
бриколаж: бриколажем
бриколажа: бриколаж
будущее: будущего
будущий: будущей
бутерброд: бутерброд
бывать: бывают
бывший: бывшая бывшие
быстро: быстро
быстрый: быстрее быстрому
быть: будем буду будут
важно: важно
важный: важен важна важная важны
вакансия: вакансия
валюта: валюту
вариант: вариант варианты
вдоль: вдоль
великое: великое
величина: величинам
венера: венеры
вернуться: вернулся
верный: вернее
верхний: верхнем
весомый: весомыми
весь: весь всей вся
вече: вече
вещество: веществ вещества вещество
вещь: вещей вещи
взаимодействие: взаимодействия
взаимодействовать: взаимодействовать
взаимозависимость: взаимозависимость
взаимосвязь: взаимосвязи
взять: возьмем
вид: вид виде видов виды
видеоверсия: видеоверсия
видеть: видел
видимо: видимо
видимый: видимого видимый
викторович: викторович
вирус: вирус
владимир: владимир
влиять: влиять
внешний: внешней
вновь: вновь
внутренний: внутренний
внутри: внутри
внутриклеточный: внутриклеточные
вода: вода воде воду воды
водный: водной водный
водорастворимый: водорастворимые водорастворимым
водород: водорода
водоросль: водорослей водоросли водорослями
водоём: водоеме водоемов водоемы
возбуждение: возбуждения
воздух: воздух воздуха
возможно: возможно
возможность: возможности возможность возможностью
возникать: возникает возникают
возникновение: возникновения
возникнуть: возник возникла возникли возникло возникнув
возраст: возрастом
вокруг: вокруг
волна: волны
вольт: вольта
вообще: вообще
вопрос: вопрос вопросы
восстанавливать: восстанавливать
восстанавливаться: восстанавливается восстанавливаться
восстановитель: восстановителей восстановитель
восстановительный: восстановительная восстановительного восстановительной восстановительную восстановительный восстановительными восстановительных
восстановить: восстановить восстановлены
восстановиться: восстановится
восстановление: восстановлению восстановления
впервые: впервые
вперемешку: вперемешку
вполне: вполне
впоследствии: впоследствии
вред: вред
временной: временной
время: времен времени время
вроде: вроде
вселенная: вселенной
вскоре: вскоре
встраивать: встраивать
встретиться: встретимся
встроить: встроены
всякий: всяких
всё: всё
второй: второго второй второму вторую вторым
вы: вами
выводить: выводить
выглядеть: выглядел
выгодный: выгодная выгодный выгодным
выделение: выделением
выделять: выделять
выделяться: выделяющейся
выдышивать: выдышивали
выживать: выживаешь
выжиматься: выжимается
выжить: выжили
вызывать: вызывают
выйти: выйдут вышел вышла вышли вышло
вымереть: вымерли
выпадать: выпадали
выполнять: выполняет
вырасти: выросло
высвобождаться: высвобождается
высказать: высказана
высказываться: высказывались
высокий: высокий
выходить: выходит выходят
выше: выше
выяснить: выяснить
выясниться: выяснилось
выясняться: выясняется
гадость: гадость
газ: газ
гамма: гамма
гасить: гасили
гелиобактерия: гелиобактерий
ген: генам генами генов гены
генерировать: генерировать
генерироваться: генерироваться
геном: геном геномах геномов геномы
геномный: геномной
геолог: геологов
геологический: геологическом
геология: геология
геотермальный: геотермальные
германия: германия
гетеротроф: гетеротрофом
гидрофобный: гидрофобными
гипотетически: гипотетически
главный: главной главный
глобальный: глобальная
глубина: глубине
глубокий: глубже
говорить: говорил говорит говорить говорю говоря говорят
говориться: говорилось
год: годов году годы лет
гол: голов
гораздо: гораздо
градиент: градиентами
график: график
грубо: грубо
грубый: грубом
группа: групп группа группам группами группе группы
губчатый: губчатая
давать: давайте дает
давний: давнее
давно: давно
дайзенхофер: дайзенхоферу
дальнейший: дальнейшая дальнейшем
дальний: дальнюю
далёкий: дальше
данный: данном
даром: даром
дать: дали
два: две двум двух
двадцать: двадцать
движение: движение
двухвалентный: двухвалентного двухвалентное двухвалентный
двухступенчатый: двухступенчатый
делать: делает делал делать делают делая
дело: дела деле дело
дельта: дельта
день: дне
дерево: деревья
держать: держат
десятилетие: десятилетие
десятка: десяток
десять: десять
джерь: джери
джулия: джулия
диоксид: диоксид
дифракционный: дифракционной
диффундировать: диффундировать
длина: длиной
длинноволновый: длинноволновых
дно: дно
добывать: добывать добывающих
докт: докт
долгий: долгий долгое
долго: долго
должный: должен должно должны
домен: домена
донный: донные
донор: донора
достаточно: достаточно
достигать: достигает
доступный: доступного
доходить: доходит
древний: древнем древние древняя
друг: друг друга
другой: другая другие других другое другую
дружка: дружкой
думать: думаю
дырка: дырка дырки дырку
дыхание: дыхание дыханием дыхания
дыхательный: дыхательная дыхательной дыхательную дыхательных
дышать: дышат дышащей дышим
дэвид: дэвид
евгений: евгением евгений
еда: еда еду
есть: едят ели
железистый: железистыми
железо: железа железо
живой: живые живых
жизнь: жизни жизнь
жирный: жирной жирные жирный жирными жирных
жить: живем живут живущие живущих жили жить
жрать: жрал
жёлтый: желтые
забиваться: забивались
забирать: забирали забирать забирая
забираться: забирается
заболевать: заболевает
заболеть: заболел
забрасывать: забрасывает
забросить: забросить
зависеть: зависит зависящим
заглотнуть: заглотнула
задавать: задавать
задача: задач
задействовать: задействован задействованы
задолго: задолго
задружиться: задружились
зазубрина: зазубринами
заинтересоваться: заинтересовались
заканчиваться: заканчивался
заключаться: заключается
заключение: заключение
закончить: закончим
закончиться: закончились
закристаллизовать: закристаллизовали
залежь: залежам залежи
замораживаться: замораживается
занимать: занимать
заниматься: занимались занимался
заодно: заодно
запасание: запасания
запасаться: запасалась
запасти: запасти
заполнять: заполнять
заполняться: заполняется заполнялась
запускаться: запускается запускаются
зарабатывать: зарабатываешь
заражение: заражения
заразить: заражены заразил
заразиться: заразиться
заразный: заразным
заряд: зарядов
зарядить: заряженные
заставлять: заставляли
застревать: застревает
затем: затем
зато: зато
затухнуть: затухло
затыкание: затыкания
затягиваться: затягиваются
захватить: захваченные
захватывать: захватывают
защита: защита защиты
звучать: звучит
здравствуйте: здравствуйте
зелёный: зеленой зеленые зелеными зеленых
земля: земле земли
земной: земной
зима: зима
знать: знаем знает знать знаю зная
значение: значения
значит: значит
игра: игра
идея: идеи идея
идти: идет идти идут шла
избранный: избранные
известно: известно
известный: известной известных
извлечь: извлечем
изменение: изменения
измениться: изменилась измениться
изотоп: изотопов
изрядный: изрядная
изучать: изучать
изучить: изученной
именно: именно
иметь: имеет имеешь иметь имеют имеющие имеющих
иметься: имелось
иммунный: иммунная
иной: иного иной
интенсивный: интенсивных
интервью: интервью
интересный: интересен интересна интересным
информация: информации
инфракрасный: инфракрасный
иоганн: иоганну
ион: ионы
использование: использования
использовать: использовать использует используют используя
исследование: исследований исследованиями
исследовать: исследовали
история: истории история
исхитриться: исхитриться
исходно: исходно
исходный: исходная
к: ко
каждый: каждого каждый
казаться: кажется
каков: каков
какой: какие каким какими каких какого какое какую
кале: кале
кальвин: кальвина
кальций: кальция
картина: картине
каскад: каскад
каталитический: каталитический каталитическом
катастрофа: катастрофа катастрофы
катион: катионы
качество: качестве
квант: квант кванта квантом кванту кванты
квантовый: квантов
киназа: киназой
кислород: кислород кислорода кислородом кислороду
кислородный: кислородная кислородного кислородное кислородной кислородному кислородный кислородным
кислота: кислот кислота
кластер: кластер
клетка: клетка клетками клетке клетки клеткой клетку клеток
клеточный: клеточных
коала: коал
ковид: ковид ковида
кой: кое
количество: количества количествах количество
коллега: коллег коллегами
колонизация: колонизация
колония: колоний
колоссальный: колоссальный
колыбель: колыбель
комментарий: комментариев
комплекс: комплекс комплекса комплексов комплексы
конец: конце концов
конечный: конечном
конструкция: конструкция
контекст: контексте
концентрация: концентрации концентрация
кончиться: кончился кончится
кора: коры
коричневый: коричневые
кормить: кормят
который: которая которого которое которой котором которую которые который которым которыми которых
край: крае
крайний: крайней
красный: красного красную красные красный красными красных
криоэлектронный: криоэлектронной
кристалл: кристаллов кристаллы
кристаллизовать: кристаллизовать
кристаллизоваться: кристаллизоваться
кровеносный: кровеносные
кстати: кстати
кто: кого
кула: кулы
культура: культуре
кунин: кунин кунину куниным
куча: куча
лагуна: лагун
легко: легко
либо: либо
липид: липидов
лист: листья
лишить: лишить
лишь: лишь
ловить: ловит ловить ловят
ловиться: ловится
луч: лучей лучи
льшуя: льшую
любой: любой любом любых
лёд: льдом
максимальный: максимальное
максимум: максимум максимуму
маленький: маленькие маленький маленьким меньше
мало: мало
малый: меньшей
мантия: мантию
марганец: марганец марганца
марганцевый: марганцевая
марс: марса
мат: мата матах маты
матовый: матов
матушка: матушки
мв: мв
мелководный: мелководная
мелководье: мелководье
мембрана: мембран мембрана мембране мембраной мембраны
мембранный: мембранные мембранный мембранным мембранными мембранных
менее: менее
мера: мере
мереть: мрут
место: место
метаболизм: метаболизм
метагеномика: метагеномикой
метан: метан
метиловый: метиловый
метод: метод методу
механизм: механизм механизмы
микробиология: микробиология
микробный: микробного микробных
микроорганизм: микроорганизмами микроорганизмов микроорганизмы
микроскоп: микроскопа
микроскопия: микроскопии
миллиард: миллиарда миллиарды
миллион: миллионов
минерал: минералах
минус: минус
митохондриальный: митохондриальная митохондриальной
митохондрия: митохондрии митохондрий митохондрия
михель: михелю
мнение: мнению
многие: многие
многий: многих
многоклеточный: многоклеточные многоклеточный
многослойный: многослойный
множественный: множественными
молекула: молекул молекула молекуле молекулы
моль: моле
момент: момент
море: море моря
мочь: мог могли могло могут
мощный: мощная мощнейшем
мулкиджанян: мулкиджанян мулкиджаняном
муравьиный: муравьиная
мутно: мутно
мы: нам нами
наблюдаться: наблюдается
наброситься: набросимся
наверное: наверное
назад: назад
назвать: назвать
называть: называемой называют
называться: называется называются
наиболее: наиболее
найтись: нашлась
накапливаться: накапливаться
накачать: накачать
накидать: накидав
накопление: накопление
наложение: наложение
наоборот: наоборот
наполучать: наполучали
напомнить: напомню
направление: направлений
например: например
нарабатывать: нарабатывали
народ: народу
насекомое: насекомые насекомых
насколько: насколько
наслать: нашли
наступать: наступала наступают
наука: наук
научаться: научаются
научиться: научившиеся научились
научн: научн
научный: научному
находить: находят
находиться: находятся
начало: начала начале начало
начать: начал начали начать
начинать: начинает
начинаться: начиналась
наш: нашем нашим
неважно: неважно
недавний: недавнего
недавно: недавно
неделя: неделю
неживой: неживой
независимо: независимо
незнакомый: незнакомый
неизвестно: неизвестно
нейтральный: нейтральный
некий: некая некие некий неких
некоторый: некоторых
немецкий: немецким
немного: немного
немножко: немножко
необратимый: необратимо
необходимость: необходимости
неорганический: неорганических неорганической
неоткуда: неоткуда
неполадка: неполадки
непонятно: непонятно
непростой: непроста
непрямой: непрямо
нерастворимый: нерастворимые
несвязанный: несвязанных
несколько: несколько
несмотря: несмотря
несопряжённый: несопряженное
неспособный: неспособным
нестандартный: нестандартных
нетривиальный: нетривиальная
неудачный: неудачные
нефотосинтезирующий: нефотосинтезирующие
нечто: нечто
ниже: ниже
нижележащий: нижележащим
нижний: нижней нижних
низкий: низкая низкий низким низких
низкопороговый: низкопороговые
никакой: никакого никакому
никто: никого никто
нм: нм
нобелевский: нобелевскую
новый: нового новое
нормальный: нормальным
нужда: нужд
нужно: нужно
нужный: нужен нужна нужны нужные
ныне: ныне
оба: обе
обделить: обделенные
обезвредить: обезвредить
обеспечивать: обеспечивающей
обзорчик: обзорчик
обладать: обладают обладающие обладая
область: область областях
облом: облом
обмен: обмен
обозначать: обозначают
образ: образом
образец: образец
образование: образованием образования
образовать: образован образованных образуемые образуют
образоваться: образовалась образовался образуется образуются образующейся образующийся образуясь
образовываться: образовывались
обратно: обратно
обсудить: обсудить
общий: общем общему общий
объединяться: объединяются
объект: объектов
обычно: обычно
один: одна одно одного одной одном одному одну
озёры: озерах
оказаться: оказавшись оказались оказалось оказался
окисление: окисление окислению окисления
окислитель: окислитель
окислительный: окислительно
окислить: окисленного окисленный окислив окислившие окислил окислить
окислиться: окислилось
окислялять: окислялять
окислять: окисляет окислял окисляли окислять окисляют окисляющего
окисляться: окислявшийся окислялась окисляющегося
окись: окиси
около: около
окружающий: окружающая
он: нему
она: ею
они: ними
оно: оно
описать: описанного
определить: определили определить
определяться: определяется
определённый: определенной определенные
опыт: опыты
организация: организацию
организм: организм организма организмам организмами организмах организме организмов организмом организмы
органика: органики органику
органический: органические органических органической
освещать: освещают
осмыслить: осмысленные
оснабрюкский: оснабрюкского
основание: основания основаниями
основатель: основателей
основное: основном
особенность: особенностям
особый: особом
оставаться: оставалась остается остающаяся
оставлять: оставлять
остаться: оставшийся остались
осуществлять: осуществлял
осуществляться: осуществляется
отбирать: отбирали отбирают
отбираться: отбирается отбираются
ответить: ответил
отдалить: отдаленное
отдельный: отдельных
откладываться: откладывалось
открытие: открытии
открытый: открытом
откуда: откуда
отлагаться: отлагалось
отличаться: отличаются
отложение: отложений
отмечаться: отмечалось
относительно: относительно
относить: относят
относиться: относится относящиеся
отношение: отношении отношения
отобрать: отобрать
оторвать: оторвать
отправлять: отправляют
отправляться: отправляется
отрицательный: отрицательные отрицательный
отряд: отряда
оттащить: оттащить
оттуда: оттуда
очень: очень
падать: падает
панель: панели
панспермия: панспермия
пара: пар
парочка: парочка
первый: первого первой первому первую первые первый первых
переварить: переварили
передавать: передают
передать: передали
передаться: передалась
передача: передачи
переделка: переделок
передний: переднем
перемежаться: перемежающиеся
перенестись: перенеслась
перенос: перенос переноса переносе переносы
переноситься: переносятся
переносчик: переносчиком
перехватить: перехватили
перечисленный: перечисленные
период: период
петрович: петрович
писать: писали пишут
пить: пить
плавать: плавает
плавный: плавный
пласт: пласты
плита: плит
плоскость: плоскость
плотно: плотно
плохой: плохого хуже
плюс: плюс
побочный: побочный
поверить: поверите
поверхность: поверхность
повод: поводу
повсюду: повсюду
повторимый: повторим
повышение: повышении
погибнуть: погибли
поглотить: поглощенному
поглощать: поглощать поглощают
поглощаться: поглощается
поглощение: поглощения
подвергаться: подвергается
подготовить: подготовил
подготовка: подготовки подготовку
подобный: подобное подобную
подойти: подойдет
подохнуть: подохнуть
подъём: подъем
поздний: позже
поискать: поискали
пойти: пойдет
пока: пока
показать: показанными показаны
показывать: показывающая
покрываться: покрывались
покрыть: покрыты
полагать: полагал
полезный: полезна полезное
ползать: ползают
полноценный: полноценные
полный: полная полной полную
положение: положение
положительно: положительно
получать: получать получают
получаться: получается получалось
получение: получением получения
получить: получили получить
получиться: получилось получится
помимо: помимо
помнить: помню
помощь: помощью
понемножку: понемножку
понятие: понятие
понятно: понятно
понять: понять
поперёк: поперек
попробовать: попробуем
популяция: популяции
порог: порог
порода: пород породах
порция: порциями
порядок: порядки порядку
поскольку: поскольку
послать: пошли
последний: последнее последние последний
последовательно: последовательно
последовательность: последовательность
посмотреть: посмотрели
посредством: посредством
построить: построены построили
потенциал: потенциал потенциала потенциалов потенциалом
поток: потоке
потреблять: потребляют
похожесть: похожести
похожий: похожего похожи похожий похожими
почему: почему
поэтому: поэтому
появиться: появившейся появились появилось появился появиться
появление: появление появления
появляться: появлялись появлялось
правда: правда
правдоподобно: правдоподобно
превратить: превратим превратить
превратиться: превратилась
превращать: превращает превращали превращая
превращаться: превращается
предел: предел пределе
предок: предкам предками предку предок
предотвращать: предотвращать
предположить: предположить
представитель: представителем
представлять: представляет
предшественник: предшественниками предшественники предшественником
предшествовать: предшествующей
предыстория: предысторию
прежде: прежде
премия: премию
преобразование: преобразования
препринт: препринта
прибегать: прибегая
привести: привести
придумать: придумали придумать
признак: признаки признаков
прийти: пришла
прилегать: прилегающим
прилично: прилично
примерно: примерно
примитивный: примитивной примитивный
принести: принести
принять: примут
приобрести: приобрела
приобретение: приобретение приобретения
природа: природа природе природу природы
приспособление: приспособлению
приступить: приступить
присутствовать: присутствующие
причём: причем
пробегать: пробегает
проблема: проблем проблема проблемы
продиффундировать: продиффундирует
продолжать: продолжаем
продукт: продукт
проект: проектах
произвести: произведенной
производить: производить
производство: производство
произойти: произойти произошедшее произошел произошла произошли произошло
проинтерпретировать: проинтерпретировать
происходить: происходил происходили происходило происходит происходят
происхождение: происхождение происхождении
пройтись: пройдемся
промежуточный: промежуточная промежуточные промежуточный
проникать: проникает проникать
пропускать: пропуская
прорыв: прорыв
проследить: проследить
простейшее: простейшие
просто: просто
простой: простейших простому простые проще
протеобактерия: протеобактерии протеобактерий протеобактерия
протон: протона протонов протоны
проходить: проходит
процедура: процедура
процесс: процесс процесса процессах
прочесть: прочли
прошлый: прошлом
проэукариот: проэукариота
проэукариотический: проэукариотической
проясниться: прояснилась
пустой: пустой
путешествовать: путешествует
путь: пути путь
пучок: пучком
работа: работ
работать: работает работать работают работающие
равно: равно
раз: раза
развитие: развития
развить: развитая
развиться: развилась
разговор: разговор
разделение: разделение разделении
разлагать: разлагает разлагать разлагают разлагающая разлагающий
различный: различных
разложение: разложения
разный: разная разному разные разный разными разных
разобраться: разобраться
ранний: ранние раньше
расположение: расположение
расположить: расположены
распределение: распределение
распространение: распространении
рассеиваться: рассеиваются
рассказать: рассказать
рассказывать: рассказывал
рассматриваться: рассматриваться
расстояние: расстояние
раствор: раствор
растворить: растворенные
растворяться: растворяются
растение: растений растения
растить: растить
реагировать: реагировал
реакционный: реакционными
реакция: реакции реакций реакция реакциях
реальный: реальными
редокс: редокс
режим: режиме
резко: резко
результат: результате
реконструкция: реконструкции
рентгеновский: рентгеновских
рентгеноструктурный: рентгеноструктурный
репликатор: репликаторы
речь: речь
решить: решила
рикк: рикке
риккетсиоз: риккетсиозы
риккетсия: риккетсией риккетсии риккетсий риккетсия риккетсиями
рис: рис
рисунок: рисунке
роберт: роберту
родственник: родственниками родственники
ромбик: ромбики
рост: роста
рука: рук
ряд: ряду
рядом: рядом
сайт: сайте
сам: сами самого самом
самый: самая самое самые самый самых
сахаров: сахаров
сбалансировать: сбалансированы
сбрасывать: сбрасывает
сваливаться: сваливается
свежий: свежие
сверху: сверху
свет: свет света светом свету
световой: светового
светопередавать: светопередающим
светособирать: светособирающих
свидание: свидания
сводиться: сводилась
своеобразный: своеобразный
свой: своих свой
свойство: свойствами
связанный: связанные
связать: связан связано
связывание: связывание
связываться: связывались связываются
связь: связи
сделать: сделаем сделал сделать
сдохнуть: сдохли
сдружиться: сдружились
себя: собой
сегодня: сегодня
семейство: семейства семейству
сепсис: сепсис
сера: сера серу серы
середина: середине
сернистый: сернистые сернистых
серный: серное серной серные серных
сероводород: сероводород сероводорода
си: си
сила: сила силой силу
сильно: сильно
сильный: сильная сильного сильной сильный сильным сильных
симбиоз: симбиоз симбиоза симбиозов симбиозы
символ: символов
синий: сине синего синие синий
синтаза: синтазой
синтез: синтез синтеза синтезом
синтезировать: синтезировать
система: систем система систему системы
ситуация: ситуации ситуация
сказать: скажите сказали сказано сказать
скачок: скачка
скорее: скорее
скот: скота
скотина: скотине
скулачёв: скулачёв
след: следов
следующий: следующие следующий
слияние: слиянием
словарь: словарь
слово: слово
сложиться: сложившейся
сложно: сложно
сложность: сложности
сложный: сложная сложные сложный сложных
слоистый: слоистая
слой: слое слои слой слоям слоях
случай: случае случаев случаи
случиться: случился
смертельный: смертельные
смерть: смерти
сместить: смещенных
смотреть: см
смочь: смогла сможет
смысл: смысл смысле
снаружи: снаружи
сначала: сначала
снова: снова
соавтор: соавторами
собираться: собираясь
собраться: собраться
собственно: собственно
событие: событие событий
совершенно: совершенно
современный: современной современных
содержание: содержание содержания
содержать: содержат содержащие
соединение: соединение соединений соединения
создать: создала
солнечный: солнечного
соль: соли
сообщение: сообщения
соответственно: соответственно
соответствие: соответствии
соответствовать: соответствующий
соотноситься: соотносятся
соотношение: соотношении
сопрячь: сопряжено
соседский: соседские
составлять: составляющей
сосуд: сосуды
сотня: сотен сотни
сотр: сотр
сохраниться: сохранился
социологический: социологический
спасибо: спасибо
спастись: спасутся
спектр: спектр спектра
сперва: сперва
специальный: специальная специальные специальными
спирт: спирт
способность: способность
способный: способны способные способным способных
справа: справа
справляться: справляется
спросить: спроси
сразу: сразу
среда: среду среды
среди: среди
ставить: ставить
стадия: стадию
старый: старые старых
стать: стал стали статей
статья: статьи статья
степень: степени степень
стимул: стимулом
столь: столь
сторона: стороне сторону стороны
стрелка: стрелками стрелки
структура: структур структура структурами структурой структуру структуры
структурный: структурной структурную
судить: судя
сульфат: сульфаты
супермарс: супермарс
суперпозиция: суперпозиция
суша: суше
существенно: существенно
существование: существования
существовать: существует существуют
схема: схема
схлопнуться: схлопнулись
сходство: сходство
сценарий: сценариев
считать: считать считают
считаться: считается считалось
счёт: счет счете
съесть: съел съели
сэндвич: сэндвич сэндвиче
сэндвичный: сэндвичной
также: также
таки: таки
таков: такова
таковой: таковыми
такой: такая такие таким таких такого такое
тандем: тандеме
тектоника: тектоника
тело: теле
тема: тема темой
темно: темно
тепло: тепла тепло
термодинамика: термодинамика
термодинамически: термодинамически
термодинамический: термодинамический
теряться: теряется теряются
течение: течение
тип: типа типов типу
толковый: толковый
тот: те тех той
точно: точно
тратиться: тратится
требовать: требует
трехвалентный: трехвалентного трехвалентное
трудность: трудности
тсия: тсии
тысяча: тысяч
увеличение: увеличения
увеличить: увеличенном
увеличиться: увеличилось
углекислота: углекислоту
углекислый: углекислый
углерод: углерод углерода
углеродный: углеродно
удаваться: удается
удаться: удалось
удовольствие: удовольствием
узнать: узнать
уйти: уйти ушедший ушло
ультрафиолет: ультрафиолет
умереть: умер умерли
умирать: умирает умирал умирали умирают
университет: университета
уничтожать: уничтожает
уноситься: уносится
упаковать: упакованные
упасть: упало
употребляться: употреблялся
упрощённый: упрощенная
уровень: уровень
условно: условно
усложнение: усложнения
усложняться: усложнялась
успеть: успели
установиться: установился
устойчивый: устойчивы устойчивые
устроить: устроена
устройство: устройство
уходить: уходил уходит
участвовать: участвует участвующих
участие: участию
учёный: ученым
ущерб: ущербу
фантазировать: фантазировать
фермент: ферментами ферментов ферменты
ферментный: ферментные ферментных
физико: физико
физически: физически
физический: физическому
фиксация: фиксации
филогенетический: филогенетические
филум: филума
фиолетовый: фиолетовые
фокус: фокус
фон: фоне
форма: формы
фотон: фотон фотоны
фотор: фоторе
фотореакционный: фотореакционного фотореакционные фотореакционный фотореакционных
фотосинтез: фотосинтез фотосинтеза фотосинтезе фотосинтезу
фотосинтезировать: фотосинтезируют
фотосинтезирующий: фотосинтезирующие фотосинтезирующими фотосинтезирующих
фотосинтетический: фотосинтетическая фотосинтетические фотосинтетических
фотосистема: фотосистем фотосистема фотосистемам фотосистемами фотосистемой фотосистему фотосистемы
фототрофа: фототрофы
фототрофный: фототрофным
фотохимический: фотохимическими фотохимической
фрц: фрц
функция: функцию
хартмут: хартмуту
хватать: хватает хватать
хватить: хватить
хемосинтез: хемосинтеза
химера: химеры
химически: химически
химический: химические химическими химических химическое
хитрость: хитростей хитростями
хлоропласт: хлоропласт хлоропластами хлоропласты
хлорофил: хлорофилом
хлорофилл: хлорофилла хлорофиллов
ход: ходе ходу
хозяин: хозяева хозяин хозяина хозяину
хозяйский: хозяйский хозяйской
хороший: хорошего хороший
хотеть: хотите хотят
хотя: хотя
хубрать: хуберу
целый: целому целые
центр: центр центра центрами центров центры
цепочка: цепочке
цепь: цепи цепь цепью
цианобактерия: цианобактерией цианобактерии цианобактерий цианобактерия цианобактериям цианобактериях
цикл: цикл циклом
цинобактерия: цинобактерии
частность: частности
часть: часть частями
человек: людей люди человек человеку
чересчур: чересчур
четвёртый: четвертый
четыре: четыре четырех
число: числа числе
чистый: чистой
читать: читать
член: члены
членистоногий: членистоногие
чрезвычайно: чрезвычайно
чрезмерный: чрезмерная чрезмерные
чужой: чужие
чётко: четко
шкала: шкале шкалы
штерн: штерн штерна
эв: эв
эволюционировать: эволюционируют
эволюционно: эволюционно
эволюционный: эволюционная эволюционного эволюционной эволюционный эволюционными
эволюция: эволюции эволюция
экзопланета: экзопланет
электрический: электрический
электрон: электрон электрона электронов электроном электроны
электронвольт: электронвольт
электронный: электронная электронного
элементарный: элементарной
энергетический: энергетический энергетических энергетическую
энергия: энергии энергию энергия
этакий: этаких
этап: этап
это: этим
этот: эта этих этому
эукариот: эукариот эукариоты
эукариотический: эукариотическая эукариотические эукариотических эукариотической
эфир: эфире
эффективность: эффективность
эффективный: эффективная
явление: явление
явно: явно
яд: яд
ясно: ясно
