автор: автор авторы
авторство: авторством
альтернативный: альтернативную
аннигилировать: аннигилировать аннигилирует аннигилирующей
аннигиляция: аннигиляции аннигиляцию аннигиляция
астрофизический: астрофизическими
аукнуться: аукнутся
бедный: беднее
безусловно: безусловно
белый: белых
бессмертие: бессмертие
бессмертный: бессмертные бессмертных
благодарить: благодарит
благодаря: благодаря
бозонный: бозонные
больший: большая большей
большой: большое большом
борис: борис
броский: броскому
будущее: будущее
будущий: будущие
быть: будучи
вариант: варианте
вводить: вводить
век: веков
ветвь: ветвь
вещество: веществом
взаимодействие: взаимодействию взаимодействия
взрываться: взрываться
взять: взяли
вид: виде
видно: видно
видный: видна
вкратце: вкратце
внимание: внимание
внутри: внутри
возлагать: возлагают
возможно: возможно
возможный: возможны
вообще: вообще
вопрос: вопросов вопросом вопросы
вроде: вроде
вселенная: вселенной
вскоре: вскоре
второй: вторых
выборка: выборку
выглядеть: выглядит
выдвинуть: выдвинуть
выделить: выделить
вызвать: вызвало
вызывать: вызывает
выйти: вышла
газета: газета
галактика: галактики
гамма: гамма
герой: героев
главное: главное
главный: главной главную
год: года лет
государственный: государственная
грозить: грозит
гэв: гэв
данные: данным данных
дать: данная данной данному данные
действие: действием
диапазон: диапазоне
дмитрий: дмитрия
довольно: довольно
догадаться: догадаться
должный: должна должно должны
дополнительный: дополнительную
достаточно: достаточно
друг: другом
дыра: дыр дыры
жизнь: жизнь
журналист: журналисты
зависеть: зависящее
завысить: завышена
загадка: загадка
заголовок: заголовки
задаваться: задаваться задаваясь
заложиться: заложились
заметить: замеченного
заметка: заметки
заняться: заняться
запретить: запретить
зарегулировать: зарегулированы
засветка: засветки
застревать: застревать
звезда: звезд звезда звездами звездах звезде звезды
звучать: звучат
знать: знаем
значимость: значимость
зрение: зрения
игнорировать: игнорировать
идея: идеи идею идея
известный: известных
изобретательский: изобретательская изобретательскую
изыскание: изыскания
иметь: имеет
иметься: имеется имеющиеся
инструмент: инструменты
интересно: интересно
интересный: интересна
инфракрасный: инфракрасного инфракрасном инфракрасный
испариться: испарятся
история: истории
исчерпываться: исчерпывается
ияи: ияи
к: ко
какой: каких
карлик: карликов
квазар: квазаров
кеплеровский: кеплеровским
класс: класса
количество: количестве
коллапс: коллапс
комментарий: комментарий комментария
компонент: компоненту
конец: конец
косвенный: косвенные
космический: космических космического
космология: космологии
космос: космос космоса
который: которая которые который которых
краткий: краткий
критика: критика
курс: курс
лазейка: лазейка
левкова: левкова
лежать: лежит
либо: либо
линия: линии линия
любой: любыми
лёгкий: легкого
маленький: меньше
мало: мало
малый: меньших
масса: масса
материя: материи материя
мать: матери
метод: методах
мир: мире
млечный: млечного
мозаика: мозаика
монохроматический: монохроматической
мочь: могут
мощный: мощного
мэв: мэв
наблюдательный: наблюдательным
наблюдать: наблюдать
наблюдаться: наблюдается наблюдаться
навеки: навеки
наглотаться: наглотаются
нагрев: нагрев
надежда: надежды
наедаться: наедаются
назад: назад
название: названию
назвать: назвали
найти: нашла
направление: направлении
например: например
насквозь: насквозь
натягивать: натягивать
натяжка: натяжек
наука: наука
научный: научного
находить: находят
начинать: начинают
нашуметь: нашумевшая
небольшой: небольшим
недра: недрах
нейтрон: нейтрон
нейтронный: нейтронными нейтронных
некий: некий некоего
некоторый: некоторые
несколько: несколько
несложно: несложно
несмотря: несмотря
нобелевский: нобелевское
новость: новостей
новый: новую новые новый
нужный: нужны
нуклон: нуклонами
область: область
обнаружить: обнаружить
обогащать: обогащает
образ: образом
образовать: образуют
обратный: обратном
обсерватория: обсерватория
объект: объектами
объяснение: объяснения
обыкновенный: обыкновенной
обычно: обычно
ограничение: ограничения
ограничить: ограничен
один: одном
оказаться: оказавшись
окружающий: окружающем
они: ими
оно: оно
опровержение: опровержением
орбита: орбитам
основать: основана
основный: основная
оставаться: остаются
остывать: остывая
ответить: ответить
открыть: открыли
отсюда: отсюда
охарактеризовать: охарактеризовал
очень: очень
очередной: очередная
падать: падает
параметр: параметр
первый: первых
перейти: перейдут
пик: пиком
писать: пишут
планета: планете
плотность: плотности плотность
поверхность: поверхности
повод: поводу
повторять: повторяют
поглощение: поглощения
подкачать: подкачали
подобный: подобное подобные подобный
подразумевать: подразумевая
подтверждаться: подтверждается
поедание: поедания
покрывать: покрывает
пол: пола
поле: поле поля
полезно: полезно
получить: получили
польза: пользу
посвятить: посвященных
последний: последние
последовательность: последовательности последовательность
похожий: похожими
почему: почему
право: право
превратиться: превратятся
превышать: превышает
предположение: предположения предположениями
прежде: прежде
премия: премия
прибавлять: прибавляя
привлечь: привлекла
признак: признаки
признание: признание
прийтись: пришлось
принцип: принципов
принять: приняв
проблема: проблема проблемы
прозрачный: прозрачней
произойти: произойдет
прорисоваться: прорисовалась
просто: просто
пространство: пространстве
противоречить: противоречит
протозвезда: протозвезды
прохладный: прохладные прохладных
прошивать: прошивать
пусть: пусть
путь: пути
пыль: пыли
работа: работ работа работы
равновесный: равновесному
размер: размером размеру
разработать: разработанных
район: районе
рамка: рамках
ран: ран
ранний: ранних раннюю
распухать: распухая
распухлый: распухла
рассосаться: рассосалась
рассчитать: рассчитали
реализовать: реализовать
реализоваться: реализовалась
реальность: реальностью
рентгеновский: рентгеновских
решить: решена
ру: ру
светимость: светимости светимостью
светить: светить
световой: световых
свой: своей своему своих
связь: связи
сель: сели
серьёзный: серьезных
сечение: сечение сечении
сжаться: сжались
сжиматься: сжимается
скалярный: скалярного
скептический: скептический
слабо: слабо
слишком: слишком
смотреть: см
снимок: снимков
соответственно: соответственно
состояние: состоянии
сотня: сотен
сотрудник: сотрудника
спина: спина
спитцер: спитцер
становиться: становится становятся
старший: старшего
статистический: статистическая статистической
статья: статья
стейнхардт: стейнхардта
стокгольмский: стокгольмская
столь: столь
стэнфордский: стэнфордский
существование: существование
сходить: сходят
сценарий: сценарий сценарию
считать: считать считаю
счёт: счет
также: также
такой: таким такое таком
телескоп: телескопа телескопов телескопы
темп: темп темпом
температура: температурах
термоядерный: термоядерное
тип: тип типа
тон: тон
топливо: топливо
требовать: требуемого требует
требоваться: требуется
трек: трек
тридцатиметровый: тридцатиметрового
трудно: трудно
туманный: туманное
тяжело: тяжело
тёмный: темная темной темную темных
увеличение: увеличения
увлекательный: увлекательному
университет: университет
упоминать: упоминая
учёный: ученые
фантазия: фантазия
ферми: ферми
физика: физику
физический: физических физического
флуктуация: флуктуацией
фон: фон фона фоне
фотон: фотона
хаббл: хаббл
характерный: характерную
хитроумный: хитроумный
хотя: хотя
ценный: ценный
центр: центр центра центре
частица: частиц частицы
часть: часть
число: числе
чёрный: черные черных
штерн: штерн
шум: шум
эволюция: эволюцию
экспериментальный: экспериментальные экспериментальным
экстремальный: экстремальные экстремальный экстремальными
энергия: энергия
энерговыделение: энерговыделение
этот: эта
эффект: эффекты
явление: явления
явно: явно
яркий: яркие
