август: августа
ави: ави
австралия: австралии
адрон: адронами
аксиный: аксино
аксион: аксионов аксионы
акт: актов
алексей: алексей
алфавит: алфавита
американский: американский
анахронизм: анахронизмом
английский: английском
англоязычный: англоязычной
аннигиляционный: аннигиляционные
античастица: античастицей античастицы
аппаратный: аппаратные
аппаратура: аппаратуры
апрель: апрель
аргон: аргон
аргумент: аргументы
ассоциация: ассоциация
астрономия: астрономии
астрофизик: астрофизик астрофизика астрофизике
астрофизический: астрофизических
атом: атом атомами атомов
атомный: атомным атомными атомных
баксанский: баксанской
барий: бария
барионный: барионной
безнейтринный: безнейтринные
безрезультатно: безрезультатно
бенджамин: бенджамин
бета: бета
благодаря: благодаря
благородный: благородные благородных
боз: бозе
бозон: бозон бозона бозонами бозонов бозоны
больший: большая больших
большой: большого большой велика
будущее: будущего
будущий: будущих
булбить: булби
бывший: бывшем
былой: былую
быть: буду будут
вадимович: вадимовича
важно: важно
важный: важная важнее важные важными
вайнберг: вайнберг
вариант: варианты
вблизи: вблизи
вверху: вверху
век: века
векторный: векторных
великобритания: великобритании
великое: великое
вернуться: вернемся
вероятно: вероятно
вероятность: вероятности вероятность
версия: версии версий версия
верхний: верхний
вес: весом
вестись: ведутся
весьма: весьма
вещество: веществ вещества
взаимодействие: взаимодействие взаимодействий взаимодействия
взаимодействовать: взаимодействовать
взрыв: взрыва
вильчек: вильчек
вимп: вимпам вимпов вимпом вимпы
вимпами: вимпами
вимпах: вимпах
вимповый: вимповая
виспам: виспам
виток: виток
включая: включая
влезть: влезла
вместо: вместо
вмещать: вмещающий
внешний: внешних
вновь: вновь
воздействие: воздействий
возможность: возможностей
возможный: возможной возможных
возникать: возникает
возникновение: возникновение
возникнуть: возникла
возраст: возраст
вопрос: вопрос
впервые: впервые
вплоть: вплоть
вполне: вполне
впятеро: впятеро
время: времени время
вселенная: вселенная вселенной
вскоре: вскоре
встреча: встрече
всякий: всякая
всё: всё
второе: второе
второй: втором вторых
вуалировать: вуалировать
входить: входят
выглядеть: выглядели выглядит
выдать: выдали
выдвинуть: выдвинутой
выделять: выделяемая
выпуск: выпуске
высказать: высказанная высказанные
высказаться: высказался
высокий: высокое высокой
высокочувствительный: высокочувствительных
высота: высоты
вытекать: вытекает
выявить: выявлены
выявление: выявления
газ: газах
газа: газы
газовый: газового газовых
газообразный: газообразной
галактика: галактик
галактический: галактических
гало: гало
гамов: гамов
ганна: ганн ганна
гарвардский: гарвардского
гипотеза: гипотезы
гипотетический: гипотетическая гипотетических
главное: главного
главный: главным главными
глубина: глубине
го: го
говориться: говорилось
год: года годах годов году годы лет
гора: горами
гораздо: гораздо
город: города
горячий: горячих
гостевой: гостевом
гравитационный: гравитационные
гравитино: гравитино
гравитон: гравитонов
графство: графстве
грозить: грозит
гэв: гэв
давно: давно
дакота: дакота дакоте
далее: далее
далёкий: дальше
дать: дала
два: две двух
двигаться: двигаться движутся движущихся
двойной: двойные
двухфазный: двухфазной двухфазный
деактивировать: деактивирован
девять: девять
действительно: действительно
действовать: действующая
дело: дело
день: дней
десятилетие: десятилетий десятилетия
десятка: десятками десятки
десять: десять
деталь: детали
детектирование: детектирование
детектор: детектор детектора детекторах детекторе детекторов детектору детекторы
детекторный: детекторный
дефицит: дефицит
джеймс: джеймс
диаметр: диаметра
диапазон: диапазоне
дипольный: дипольного
доверие: доверие
доверительный: доверительном
довести: довести
довольно: довольно
довольный: довольной
дойти: дойдут дошел дошли
доказательство: доказательств доказательством
долго: долго
долгожданный: долгожданная
долгоживущий: долгоживущего
долгошеин: долгошеин
должный: должен должно должны
доложить: доложили
доминировать: доминировать
достигнуть: достигнут
достоверность: достоверностью
друг: друг другом
другой: другие других
дух: духе
дыра: дыры
единица: единицы
единственный: единственного единственный
естественность: естественности
естественный: естественные
живой: жива
жидкий: жидким жидкого жидкой жидком
загадка: загадок
задача: задачи
заключительный: заключительном
закончить: закончить
закрытие: закрытию
закрытый: закрыты
закрыть: закрыла
заложить: заложено
заметка: заметку
заметно: заметно
замолвить: замолвите
заниматься: занимается
заново: заново
занятой: занятой
занять: заняли
заполнить: заполнена
заполняться: заполнялся
заработать: заработают
зарегистрировать: зарегистрировать
заряд: заряда зарядов
затем: затем
заточить: заточены
затрагивать: затрагивать
затруднять: затруднять
защитить: защищен
звание: звание
звезда: звезд
земной: земной земных
зеркальный: зеркальная зеркальное
знаменитый: знаменитый
знать: знаем
значительный: значительной
золото: золотом
идея: идея
идти: идет идут
известно: известно
известный: известный
излучаться: излучаться
излучение: излучения
измерение: измерений
измерительный: измерительной
измеряться: измеряться
изначальный: изначальная
изотоп: изотопа
именно: именно
иметь: имел
иметься: имеются
индуцировать: индуцируют
инженер: инженеров
иной: иных
институт: института институтов
интенсивный: интенсивной
интерес: интерес
интересненький: интересненькое
интересоваться: интересовались
интернет: интернете
интерпретировать: интерпретировать
информация: информацию информация
ион: ион
ионизационный: ионизационных
ионизация: ионизации
искать: искали искать ищут
исключить: исключена
использовать: использован
использоваться: использоваться используются
испускание: испусканием
исследование: исследований исследования
исследовательский: исследовательская исследовательский исследовательском
исходный: исходного
италия: италии
итальянский: итальянского
итог: итог итоги
июль: июле
ияи: ияи
йоркшир: йоркшир
каждый: каждой
камера: камера
кандидат: кандидатами кандидатов кандидатом
качество: качестве
квазимонополия: квазимонополию
квант: кванты
квантовый: квантовой квантовую квантовый
квинна: квинн
кг: кг
километр: километров
кинетический: кинетической
китайский: китайского
классик: классиков
ключевой: ключевых
коллаборация: коллаборации коллаборация
коллайдер: коллайдера
коллега: коллегами
колодец: колодцы
команда: команды
комментарий: комментариев
комплекс: комплекс
композиция: композиция
компонент: компонента компонентах
конец: конца конце
конкурент: конкуренты
конструирование: конструирование
контекст: контекстах контексте
конференция: конференциях
концентрация: концентрации
концепция: концепции концепция
корея: кореи
корреспондент: корреспондента
космический: космическими
космолог: космолог космологи
космология: космологии
космос: космос космоса космосе
который: которая которого которое которой котором которые который которых
край: крае
красивый: красивую
краткий: краткой
криостат: криостат
кристаллический: кристаллические
кроме: кроме
крупномасштабный: крупномасштабного
крупный: крупная
ксенон: ксенон ксенона ксеноне ксеноном
ксеноновый: ксенонового ксеноновом ксеноновый ксеноновых
кубический: кубическом
лаборатория: лаборатории лаборатория
лаконичный: лаконичнее
лебеденко: лебеденко
левин: левин
лептон: лептон лептонами лептоны
лептонный: лептонных
либо: либо
лидировать: лидируют
ликвидировать: ликвидировать
литература: литературе
лишь: лишь
ложный: ложных
лофтус: лофтус
луч: лучами
любой: любом
лёб: лёб
лёгкий: легкая легким легких легчайший легче
магнитный: магнитных
максимальный: максимальной
маленький: мала меньше
малый: меньших
март: марта
масса: масс масса массами массах массой массу массы
массивный: массивные массивных
материя: материей материи материю материя
медленный: медленней
международный: международная международной международном
менее: менее
менять: меняет
метод: метод
метр: метре
микромир: микромира
минимум: минимум
мир: мире
мистер: мистер
мнение: мнения
многий: многих
многоканальный: многоканальной
многотонный: многотонными
многочисленный: многочисленных
множество: множество
модель: моделей модели модель моделью моделями
мой: мою
момент: момента
мотивация: мотивация
мотивировать: мотивировано
мочь: могло могут
мыслимый: мыслимых
набирать: набирает
наблюдать: наблюдаемый
наблюдаться: наблюдается
наблюдение: наблюдений наблюдения наблюдениях
наверняка: наверняка
навроде: навроде
надежда: надежда
надёжность: надежностью
назад: назад
назвать: названы
называть: называемая называемого называемые называемый называемых называют
называться: назывался называться называются
наиболее: наиболее
найти: нашел
накапливаться: накапливаются
намерить: намерены
намного: намного
написать: написал
напомнить: напомнить
направление: направлении
например: например
нарушение: нарушение
наследник: наследником
настоящий: настоящее настоящему
наука: наук науки
научный: научного научной научных
находиться: находится
начало: начала начало
небо: небесах
небольшой: небольшая небольших небольшом
неверно: неверно
невозможно: невозможно
недавний: недавнем
независимо: независимо
нейтрализация: нейтрализации
нейтралиный: нейтралино
нейтральный: нейтральные нейтральных
нейтринный: нейтринного нейтринной нейтринный нейтринным
нейтрино: нейтрино
нейтрон: нейтрон нейтрона
некоторый: некоторые
немало: немало
ненайденный: ненайденные
ненулевой: ненулевой
неподтверждённый: неподтвержденной
неприятный: неприятную
нераспадаться: нераспадающихся
нерелятивистский: нерелятивистскими нерелятивистских нерелятивистской
несколько: нескольких несколько
несохранение: несохранения
нестабильный: нестабильного
нести: несут
ниже: ниже
низкий: низкие низкий
низкоэнергетический: низкоэнергетической
никак: никак
никакой: никаких
новость: новости новость
новый: новейшие нового новое новый
норт: норт
нужный: нужной нужные
нулевой: нулевой
ныне: ныне
нынешний: нынешнего нынешней нынешняя
область: области областью
обмен: обмена
обнародовать: обнародована
обнаружить: обнаруженные обнаружено обнаружены обнаружил
образование: образованию
обсерватория: обсерватории
обсуждаться: обсуждается
общий: общей общем общую
объединить: объединили
объединять: объединяющая
объяснить: объясню
обычный: обычной
обязать: обязана обязаны
ов: ов
ограничиться: ограничусь
один: одни одними одной одном одному
однако: однако
одновременно: одновременно
оказаться: оказалась оказалось оказаться
около: около
они: ими
оно: оно
опасность: опасность
описание: описанию
описываться: описываются
опробовать: опробовали
оптимум: оптимум
опубликовать: опубликованные
осколок: осколками
оснастить: оснащен
основа: основе основой
основать: основана
основное: основном
основный: основная основного основное основную основных
особенно: особенно
особо: особо
остаться: осталась
осуществлять: осуществляет
отдавать: отдают
отделить: отделить
открытие: открытие открытием
открытый: открытый
отличаться: отличается
отличие: отличие
отличный: отличные
отлов: отлова
отметить: отмечу
относительно: относительно
относиться: относится
отнюдь: отнюдь
отработать: отработаны
отражение: отражение
отскок: отскоке
отсутствие: отсутствие отсутствии
охота: охоте
оценивать: оценивать
оценить: оценили оценить
оценка: оценкам оценки
очень: очень
парадигма: парадигм парадигма парадигмой
паразитный: паразитных
параметр: параметров параметры
пауло: пауло
первоначально: первоначально
первый: первого первое первые первым первых
передний: переднем
перейти: перейдем
переносчик: переносчиками
период: период
периферийный: периферийных
печчей: печчеи
планета: планете
планировать: планируют
плодотворный: плодотворной
плотность: плотности
плюс: плюс
поверхность: поверхности поверхность
повысить: повысило повысить
подвести: подвели
подводить: подводя
подготовка: подготовки
подземный: подземная подземной
поднять: поднят
подобно: подобно
подходить: подходят
пожалуй: пожалуй
позволить: позволил
позволять: позволяет
поздний: позднее позднейших позже
поиск: поиск поиска поисках поиски поиском поиску
поистине: поистине
пока: пока
показать: показали показало показано
поколение: поколения
пол: полом
поле: поля полях
полураспад: полураспада
полутораметровый: полутораметрового
полуцелый: полуцелым
получить: получена получены
польза: пользу
поместить: помещенный
помочь: помочь
помощь: помощью
понимание: понимания
попадать: попадал
попросить: попросил
популярность: популярность
популярный: популярной популярные популярных
пора: пор
порезать: порезано
порождать: порождать
португалия: португалии
порядок: порядка порядки порядков
последний: последние последних
посредством: посредством
поставить: поставил
постепенно: постепенно
построить: построен построенном
потерять: потеряла потерять
поток: потоки
потребовать: потребует
почивший: почивший
поэтому: поэтому
появиться: появившемся появиться
появление: появлению появления
правдоподобный: правдоподобных
практически: практически
превратиться: превратиться
превращение: превращение превращений превращения
превышать: превышает превышать превышающей превышающими
предел: предел пределов
предложить: предложены предложили
предложный: предложен
предназначить: предназначенной предназначенные предназначенными
предполагать: предполагающий
предположение: предположении
предположить: предположено
предпочитать: предпочитали
предпочтительный: предпочтительных
предсказать: предсказанного предсказанные
представлять: представляет
предусмотреть: предусмотренных
предшественник: предшественника предшественникам предшественниками
предшествовать: предшествующего
предыдущий: предыдущих
прежний: прежнему
преобладать: преобладающей
претендент: претендентами претенденты
преувеличение: преувеличением
приблизительно: приблизительно
прибор: прибор прибора
приборный: приборный
привести: привели
привлекательно: привлекательно
приводить: приводить приводящие
придумать: придумали
приемлемый: приемлемыми
применение: применение
применить: применен
применяться: применяться
примерно: примерно
принстонский: принстонского
принцип: принципах принципе
природа: природу
причина: причине причиной
пришествие: пришествие
проблема: проблема проблему
проверить: проверить
проводиться: проводился
прогресс: прогресса
продвинуться: продвинуться
продолжительность: продолжительность
проект: проект проекта проектов проекты
происходить: происходить
прокомментировать: прокомментировать
промежуточный: промежуточных
пропасть: пропала
прорабатывать: прорабатывать
просто: просто
простой: простой
пространство: пространства
противный: противном
противоречие: противоречие
протон: протона
протяжённый: протяженных
профессор: профессор
прошлое: прошлого прошлое
прошлый: прошлом
прямой: прямой прямому
публикация: публикациях
публицистика: публицистики
путь: путь
пытаться: пытались
пять: пяти пять
работа: работа работы
работать: работали работают
рабочий: рабочая рабочего рабочее рабочих
равный: равна равны
радионуклид: радионуклидов
раздел: разделе
различный: различные различных
размер: размеров
разрабатываться: разрабатываются
разрешить: разрешить
разумеется: разумеется
район: районе
рамка: рамках
ран: ран
ранний: ранней раньше
распад: распада распады
распадаться: распадаться
распадный: распадные
расписаться: расписались
расположить: расположена расположенной
рассказывать: рассказывать
рассматривать: рассматривают
рассмотреть: рассмотрели
рассчитать: рассчитан
раунд: раунда раундов
реагировать: реагируют
реакция: реакциях
реальность: реальность
регистрация: регистрации
редкий: редкие
результат: результат результатам результатах результатов результаты
релевантный: релевантные
реликтовый: реликтовые
репрезентативный: репрезентативного
речь: речь
решать: решают
решётка: решетки
роберто: роберто
родионов: родионов
родить: рожденных
родиться: родиться
рождение: рождение рождении рождения
роль: роли роль
рудник: руднике
сайт: сайте
сам: самом
самый: самая самые самый самым самых
сан: сан
сверхмассивный: сверхмассивные
сверхтяжёлый: сверхтяжелые
свет: свет света свете
свидетельство: свидетельство
свой: свое своей своим
свойство: свойствами
свыше: свыше
сделать: сделаны сделать
семейство: семейства семейству
семинар: семинаре
сентябрьский: сентябрьском
сергей: сергей сергея
середина: середине середины
серьёзный: серьезные
сечение: сечений
сигнал: сигналов сигналы
сила: силы
сильно: сильно
сильный: сильных
симметрия: симметрии
система: системой
скажем: скажем
сказать: сказать
скачок: скачок
сконструировать: сконструировали
скопление: скопления
скорость: скорости скоростью скоростями
скромный: скромной
скрытый: скрытых
слабо: слабо
слабовзаимодействующий: слабовзаимодействующим слабовзаимодействующих
слабый: слабого слабое
след: следов следы
следовательно: следовательно
следовать: следует
слово: слов слово
сложность: сложности
сложный: сложный
служить: служит
случай: случае
смесь: смесь
смонтировать: смонтирован
смотреть: см
смысл: смысл смысле
снабдить: снабжен
снимать: снимающую
соавтор: соавторов
собрат: собрата
собственный: собственного собственной
событие: события
советский: советские
современный: современное современной современные современных
согласно: согласно
содержаться: содержаться
создавать: создавать
создать: созданная
солнечный: солнечных
солнце: солнце
сомнение: сомнение
соображение: соображения
сообщаться: сообщается
сообщение: сообщении сообщения
соответственно: соответственно
соответствовать: соответствуют
сопровождаться: сопровождающиеся
сорок: сорок
состояние: состояние
состоять: состоит состояла состоять
состояться: состоявшемся
сосуществование: сосуществование
сотня: сотен сотни сотнями
сотрудник: сотрудника
сохранение: сохранение
специалист: специалисты
спин: спин спином
способ: способа способы
способный: способны
способствовать: способствуют
сравнение: сравнению
сравнительно: сравнительно
стабилизировать: стабилизируют
стабильный: стабилен стабильной стабильные стабильных
стадия: стадии
стандартный: стандартной стандартных
статистический: статистической
статус: статус статуса
стать: стал стала стало
статья: статье статья
степень: степени степенью
стивен: стивен
сто: сто
столкновение: столкновении столкновений столкновения столкновениях
страна: стран
странно: странно
структура: структуры
субатомный: субатомных
суперпартнёр: суперпартнер суперпартнерами суперпартнеров суперпартнеры
суперсимметричный: суперсимметричными
суперсимметрия: суперсимметрии
суперсовременный: суперсовременный
суперчастица: суперчастицы
сутки: сутки
существование: существование существования
существовать: существовавших существовать существуют
схема: схемы
схожий: схожих
сцинтилляционный: сцинтилляционные
сцинтилляция: сцинтилляция
считать: считали считаю
считаться: считается считались
сша: сша
сэнфордский: сэнфордский сэнфордском
также: также
таки: таки
таковой: таковые
такой: такая такие такими таких такого
текущий: текущий текущих
тело: тела тело
теоретик: теоретики
теоретически: теоретически
теоретический: теоретические теоретическим теоретических теоретической
теория: теории теория
тепловой: теплового
термин: термин
терминологически: терминологически
термоядерный: термоядерных
терять: теряют
технология: технологии технологиям технологиях
течение: течение
титановый: титановый
тонна: тонн
тот: те тех той тому
точно: точно
требовать: требуемые
троицкий: троицкий троицкого
туман: туман тумана
тысяча: тысяч
тяготение: тяготением тяготения
тёмный: темная темной темную
увеличение: увеличению
удаться: удалось удастся
удобный: удобнее
уйти: ушла
указать: указаны
улавливаться: улавливаются
уменьшиться: уменьшилось
университет: университета
унизительно: унизительно
употреблять: употребляли
уравнение: уравнение
уровень: уровне
усилие: усилиям
ускоритель: ускорителях
успех: успехи успехов
установить: установил установленном
установка: установка установках установку
утверждать: утверждает утверждают
участник: участники участников
учесть: учесть
учёный: ученые
фаза: фаз фазе
фактически: фактически
фермион: фермионам фермионы
физик: физиков
физика: физика физики
физический: физическая физических физического
фиксироваться: фиксируются
фильтр: фильтрами
фон: фон фона
формирование: формировании
формировать: формировать формируют
формулировка: формулировке
фотон: фотона фотонов фотоны
фотоумножитель: фотоумножителей фотоумножителями
фрэнк: фрэнк
фундаментальный: фундаментальным
хиггс: хиггса
холодный: холодная холодными
хороший: лучшим наилучшие хорошим
хотя: хотя
хоумстейк: хоумстейк
хромодинамика: хромодинамики
целый: целым
цементировать: цементировать
центр: центр центре центров
цилиндр: цилиндр
частица: частиц частицам частицами частицах частицы
частность: частности
частый: чаще
часть: часть
чей: чей чье
четверо: четверо
четверть: четверть
четыре: четыре
четырнадцать: четырнадцати
чикаго: чикаго
число: число числу
чистый: чистая
член: члена члены
чрезвычайно: чрезвычайно
чувствительность: чувствительности
чувствительный: чувствительней чувствительном
чёрный: черные
швейцария: швейцарии
эв: эв
эдвард: эдвард
экзотика: экзотика
эксперимент: эксперимент эксперимента экспериментах эксперименте экспериментов эксперименту эксперименты
экспериментальный: экспериментальном
экспериментатор: экспериментаторы
эксперт: экспертов
экспозиция: экспозиции
экспонироваться: экспонируется
электрически: электрически
электрический: электрических электрического
электромагнитный: электромагнитного электромагнитных
электрон: электрон электрона электронами электронов электроны
электронвольт: электронвольт
электронный: электронными
элементарный: элементарных
элен: элен
энергия: энергии энергия
этап: этапе
это: этим
этот: эта этих
этюд: этюды
южный: южная южной
юный: юная
являться: является являются
ядерный: ядерного ядерных
ядро: ядер ядра ядрами ядро
