агентство: агентства
активный: активным
алексей: алексей
аминокислота: аминокислот аминокислоты
аминокислотный: аминокислотных
аммиак: аммиака
анализ: анализа
аналогичный: аналогичные
аппарат: аппарат
аро: аро
астероид: астероид астероида астероиде
астероидный: астероидной
астроновость: астроновости
астроном: астрономам астрономами астрономов астрономы
астрономический: астрономических
астрофизик: астрофизики
атакама: атакама
бактерия: бактерию
бедный: бедные бедный
белок: белков
белый: белый
бенна: бенну
биология: биологии
благодаря: благодаря
близкий: ближайшей
блок: блоками
богатый: богатой
больший: большей больших
большой: большого большое большой велика
бросить: брошенный
будущее: будущем
будущий: будущих
буря: бури
быстрый: быстрый
быть: будут
важный: важным
ван: ван
вариант: варианта
величина: величине
вероятно: вероятно
вероятность: вероятность вероятностью
вести: ведет
весь: всей вся
весьма: весьма
ветер: ветер
вещество: вещества вещество
взаимодействие: взаимодействие
взаимодействовать: взаимодействует
взрыв: взрыва
вид: вида
видеть: видеть видим
видимый: видимом
видный: видна видны
видоизменение: видоизменения
визуальный: визуальный
включая: включая
вместе: вместе
вода: вода воду воды
водород: водорода
возможно: возможно
возможность: возможность
возникать: возникают
возникнуть: возникших
вокруг: вокруг
волна: волн волны
волнообразный: волнообразное
вопрос: вопрос
восемь: восемь
воскресить: воскрешенного
впервые: впервые
вполне: вполне
впоследствии: впоследствии
вращаться: вращается вращающейся
вращение: вращение вращению
время: временем времени время
вселенная: вселенной
встречаться: встречаются
второй: второй
входящий: входящем
выброс: выбросам выбросами
выглядеть: выглядеть
вызвать: вызвало
высвобождать: высвобождать
высокий: высокую
вытянутый: вытянутых
выявить: выявить
выяснить: выяснить
выясниться: выяснилось
газ: газа
газовый: газовый газовым
газопылевой: газопылевым
галактика: галактик галактика галактике галактики галактикой галактику
гелий: гелия
глаз: глазах
глина: глиной
глэвино: глэвином
год: года годах году лет
годдард: годдарда
голубой: голубая
гораздо: гораздо
гравитационный: гравитационные
гравитация: гравитация
грейс: грейс
грунт: грунта
группа: групп группами группы
гудинга: гудинг
далеко: далеко
дальнейший: дальнейшие
далёкий: дальше
данные: данным данными
дать: дало данные даст
два: две двух
двигаться: движутся
движение: движение движению
двойной: двойная двойную двойных
дворкино: дворкином
девять: девять
делать: делает
дело: деле
демиург: демиурга
десятый: десятое
десять: десять
джеймс: джеймс
джейсон: джейсоном
диаметр: диаметр
диапазон: диапазоне
диск: диск диска дисками дисках диски дисков диском
днк: днк
доказательство: доказательств
доккума: доккум
должный: должен
дополнительный: дополнительным
дополнить: дополнил
доставить: доставлен доставленный
доставка: доставка
достаточно: достаточно
достигать: достигает
достижение: достижение
древний: древняя
друг: друг друга
другой: другие другими других
дыра: дыр дыра дырами дыре дырой дыру дыры
дэн: дэном
евклид: евклид
европа: европе
европейский: европейского европейской
жидкий: жидкая жидкой
жизнь: жизни жизнь
журнал: журнале
жёлтый: желтый
загадка: загадка
загадочный: загадочной
заготовка: заготовки
загрязнение: загрязнение
заключаться: заключается
заметный: заметен
замёрзлый: замерзла
заработать: заработать
заря: заре
зафиксировать: зафиксировать
защита: защитой
звезда: звезд звезда звездах звезду звезды
звёздный: звездная звездную звездные звездный звездных
земля: земли землю
земной: земного
зеркальный: зеркальные
зерно: зерна
значительно: значительно
значительный: значительное
зрение: зрения
игла: иглах иглы
известный: известной известны известный
измерить: измерить
изображение: изображение
изучать: изучать
изучение: изучении изучения
изучить: изучить
имад: имад
иметь: имеет имеют
индивидуальный: индивидуальных
инертный: инертного
иной: иной
институт: институт
интересный: интересная интереснейших интересны
интерферометр: интерферометре
инфракрасный: инфракрасные
ио: ио
искать: ищут
исключительный: исключительным
испариться: испарилась
использовать: использовала использовали используемых
исследование: исследование исследования
исследователь: исследователей исследователи исследователям
исследовать: исследуя
история: истории
йельский: йельский
каждый: каждый
кальсад: кальсада
каменистый: каменистых
камень: камень
карбонат: карбоната карбонаты
карлик: карлик
карликовый: карликовая
карта: карта
картина: картину
каталог: каталог
квазар: квазаров
кек: кека
кирпичик: кирпичиков
китаец: китайцами
класс: класса
ключевой: ключевые
колебаться: колеблющемуся
количество: количестве количество
коллаборация: коллаборация
коллапс: коллапса
кольцо: колец кольца кольцами кольцах кольцо кольцом
комета: комет комета
компаньон: компаньона
компаньонка: компаньонок
комплекс: комплекс
компонент: компонент компонентов
компьютерный: компьютерное компьютерные
конструктор: конструктор
контейнер: контейнер
концентрация: концентрацию
концентрический: концентрические
корона: короне
коротковолновый: коротковолновые
космический: космические космический космических космического космическому
космос: космос космоса
который: которая которой которые который которым которых
кроме: кроме
круг: круги
крупный: крупное крупные крупный
кудрить: кудря
кусочек: кусочки
лаборатория: лаборатории
лавовый: лавовые
лебедь: лебедь
левовращающий: левовращающие левовращающих
левый: левые
лежать: лежат
либо: либо
лишь: лишь
луна: луны
магнетар: магнетара
макка: маккой
маленький: меньше
мало: мало
марковица: марковица
масса: масс масса массой массу массы
массивный: массивнее массивную массивные массивных
материал: материал материала
материя: материей материи
матрица: матрицами
мелкий: мелкие мельчайшие
менее: менее
металл: металлами металлов
метр: метра
мигрировать: мигрируют
микроскопия: микроскопия
миллиард: миллиарда
миллиметр: миллиметра
миллион: миллионов
миллионный: миллионную
минерал: минералах минералов
минь: мини
мир: мира
миссия: миссией миссии
мишень: мишень
млечный: млечном млечный
многозвёздный: многозвездных
множественный: множественных
моделирование: моделирование
молекула: молекул молекулами молекулы
молекулярный: молекулярного
молодой: молодых
момент: моменту
мочь: могла могли могут
мощный: мощными
мы: нам нами
наблюдать: наблюдаемые наблюдать
наблюдаться: наблюдается
наблюдение: наблюдений наблюдения
назад: назад
название: названием
назвать: назвали
наземный: наземных
называть: называемые называемый
найти: найденную найдены
наклонить: наклоненных
напоминать: напоминающие
направление: направлении
например: например
насколько: насколько
наслать: нашли
настоящий: настоящее
насчитать: насчитать
натрий: натрий натрия
научный: научном
находиться: находилось находится находятся находящейся
начало: начала
наш: наша нашего нашей
небольшой: небольшие небольшим небольшими
невидимый: невидимого
недавний: недавней
некоторый: некоторые
немного: немного
необычный: необычному необычных
нептун: нептуна
несколько: нескольких несколько
ниже: ниже
низкий: низким
нн: нн
новообразовавшийся: новообразовавшихся
новость: новостей
новый: новая новое новые новый новых
номер: номера
нуклеотид: нуклеотиды
нэнси: нэнси
оба: оба обоих
обзор: обзор
обладать: обладает обладала
облако: облака облаках облаке
область: области
обнаружение: обнаружение обнаружению обнаружения
обнаружить: обнаружена обнаружено обнаружены обнаружила обнаружили
обозначение: обозначение
образец: образец образцах образцов образцы
образование: образованием образованию образования
образовать: образуют образуя
образоваться: образовавшиеся образовались образоваться образуются
образовываться: образовываться
обратный: обратной
обращаться: обращающихся
обсерватория: обсерваторией обсерватории обсерваторий обсерватория
общий: общего общий
объединить: объединенных объединив
объединяться: объединяться
объект: объект объекта объектам объектов
огромный: огромным
один: одна одной одну
однако: однако
ожидать: ожидают
озеро: озера
означать: означает
оказаться: оказалась
оказываться: оказываются
около: около
околоземный: околоземного
окончание: окончание
окружающий: окружающего окружающей окружающий окружающих
окружение: окружения
окружить: окружена
окружный: окружен
оно: оно
описать: описаны
определить: определена
определиться: определились
опубликовать: опубликованное опубликованных опубликовано
орбита: орбитах орбиты
органический: органические органическими органических органической
орион: ориона
орёл: орла
осаждаться: осаждаются
освещать: освещает
оседать: оседают
особенно: особенно
особый: особую
оставаться: остается
ответ: ответ ответа
отдельный: отдельный отдельных
открывать: открывают
открытие: открытие
открыть: открыта
отметить: отметили
относительно: относительно
относиться: относится
отражение: отражения
очень: очень
очерёдность: очередность
пара: пары
паша: паша
первоначально: первоначально
первый: первые
перемещаться: перемещаться перемещаются
период: периодом
песочный: песочные
питер: питер
пк: пк
план: план
планета: планет планета планете планеты
планетезималь: планетезимали
плоскость: плоскостях
плотность: плотности
плотный: плотные плотным плотных
поведение: поведения
поверхность: поверхности поверхностью
поглощение: поглощением
подобно: подобно
подобный: подобные подобных
подтвердить: подтвердить
подтверждение: подтверждения
позволить: позволили позволило
позволять: позволяют
поистине: поистине
пока: пока
показать: показал показала показали показало показаны
показывать: показывают
покой: покоя
полмиллиона: полмиллиона
полноценный: полноценные
половина: половиной
получить: получены получившая получившей получила получили получить
полёт: полетов
помогать: помогают
помочь: помочь
помощь: помощью
понять: понять
поперечник: поперечнике
пора: пор
порода: породе породы
посвятить: посвящено
посетить: посетил
поскольку: поскольку
построение: построения
потускнеть: потускнеть
почему: почему
поэтический: поэтическое
поэтому: поэтому
появиться: появилась
правовращающий: правовращающим
прародитель: прародитель
превышать: превышает
предел: пределами
предотвратить: предотвратить
предполагать: предполагают
предполагаться: предполагается
предположить: предположить
предпочитать: предпочитает
представить: представлены
представление: представление
представлять: представляет
предыдущий: предыдущая
препринт: препринтов
препятствовать: препятствует
приблизительно: приблизительно
прибор: прибор
приливный: приливное
пример: примером примеры
примерно: примерно
принцип: принципе
приобрести: приобрела
присутствовать: присутствовала
причина: причине
проблема: проблемы
провести: проведенное
продемонстрировать: продемонстрировали
прожилка: прожилку
происходить: происходить
промежуточный: промежуточной
простираться: простирается
противоположный: противоположном
протозвезда: протозвезды
протопланетный: протопланетного протопланетные протопланетный протопланетными протопланетных
процесс: процесс процессы
проявлять: проявляет
прямой: прямых
пустыня: пустыне
путь: пути путь
пылевой: пылевые
пыль: пыли
пятно: пятна
пять: пяти пять
работа: работы
равный: равное
радиотелескоп: радиотелескопов
раз: раза
различный: различных
размер: размером
разместить: размещенной
разный: разное разными
разрушение: разрушение
ранее: ранее
располагаться: располагается
расположить: расположен расположенная
распределение: распределение
распределить: распределен
распространить: распространены
рассказать: рассказать
рассол: рассолах
расстояние: расстоянии
раствор: растворах растворы
расходиться: расходящимися
расчёт: расчетам
ребро: ребра
реголит: реголита
результат: результат результате результаты
рекорд: рекорд
рекордный: рекордной
рекордсменка: рекордсменка
рисунок: рисунке
рнк: рнк
роба: роб
роберт: роберта
родительский: родительском
рождение: рождение
роман: роман
рукав: рукава рукавами
рядом: рядом
сам: самой самом саму
самый: самое самую самый самым самых
сахаров: сахаров
свежий: свежие
сверхгигант: сверхгигант
сверху: сверху
сверхчистый: сверхчистой
светиться: светятся
световой: световых
свой: свое своего своей свои своих свой
свойство: свойства
связывать: связывающих
сделать: сделанном
себя: собой
северный: северной
сей: сих
сентябрь: сентября
сервер: сервере
сильно: сильно
симуляция: симуляции
система: систем система системах системе систему системы
сканировать: сканирующая
сконцентрировать: сконцентрированы
скорее: скорее
скрытый: скрыта
слева: слева
след: след
следовательно: следовательно
следующий: следующая
сливаться: сливающиеся
слипнуться: слипнется
сложный: сложную сложные сложных
слой: слои
служить: служить
смерть: смерти
сместить: смещенными
смитсоновский: смитсоновский
смотреть: см
смочь: смогли
сначала: сначала
снимка: снимок
снимок: снимке снимки снимков
собранный: собранным
собственный: собственным
событие: событий
согласно: согласно
содержание: содержанием
содержать: содержат содержащего содержащие содержит
соединение: соединения
соединять: соединяет
соединяться: соединяться
созвездие: созвездии
создавать: создавая создает
солевой: солевых
солнечный: солнечной
солнце: солнц солнца
соляный: соляных
соседний: соседних
сосредоточить: сосредоточенные
состав: состав составе составов
составлять: составляет
состояние: состоянии
состоять: состоит
спать: спящую
спектр: спектр
спектральный: спектрального
спектрограф: спектрограф
специалист: специалистам
спиральный: спиральные
способный: способен
способствовать: способствовать
спутник: спутники
сразу: сразу
среднее: среднем
стадия: стадии
стать: стал стало стать
статья: статье статьях
стереоизомер: стереоизомеры
столкновение: столкновение столкновения
столкнуться: столкнулась
сторона: стороны
строительный: строительными
структура: структуру структуры
существование: существования
существовать: существует
сформировать: сформировал
сформироваться: сформировалась
считать: считают
считаться: считается
сюрприз: сюрпризы
тадзак: тадзаки
также: также
такой: таких такого такое
твёрдый: твердой
телескоп: телескоп телескопа телескопом телескопу
тело: теле
тельце: тельца
терять: теряют
течение: течением
тим: тим
тип: типов
тонкий: тонкий
тот: те тому
точка: точки
точно: точно
точный: точным
три: тремя трех
триллион: триллионы
тройной: тройной тройную тройных
туманность: туманность
тяжёлый: тяжелее тяжелые
тёмный: темного темном
увидеть: увидеть
ударный: ударных
удаться: удалось
узкий: узкой
ультрафиолетовый: ультрафиолетовый
университет: университет
уникальность: уникальность
уникальный: уникальный
уорделла: уорделл
успеть: успело
учитывать: учитывая
учёный: ученые ученых
уэбба: уэбб уэбба
формальдегид: формальдегида
формирование: формирование формирования
формировать: формируют
формироваться: формироваться формируются формирующиеся
фосфат: фосфаты
фото: фото
фрагмент: фрагментами
хаббл: хаббл
хаббнуть: хаббла
характерный: характерного
хербиг: хербига
химический: химическом
химия: химии
хиральность: хиральности
ход: ходе
хотеть: хотели
хотя: хотя
художник: художника
ценность: ценность
центавро: центавра
центр: центра
центральный: центральной
частица: частицы
частично: частично
частность: частности
частый: чаще
часть: частях
часы: часы
чилийский: чилийской
число: числе
чёрный: черная черной черную черные черными черных
шаг: шагом
широкий: шире широкий
эволюция: эволюцию
электронный: электронная
элемент: элементов
этот: эта этих
эшелл: эшелле
южный: южной
юнона: юнона
юпитер: юпитера
явление: явление
являться: является
яркий: яркая
