автономный: автономный
активно: активно
активный: активного
альбин: альбин
американский: американская
анимационный: анимационного
аппарат: аппарат аппарата аппаратов
базироваться: базирующаяся
бизнес: бизнеса
борт: борту
будущее: будущее
важный: важные
вдвоём: вдвоем
век: века
вернуться: вернулись
версия: версию
включать: включает
вода: воды
воздействие: воздействия
возможность: возможности
время: время
вселенский: вселенского
второй: второй
вызывать: вызываемыми
выпустить: выпущена
газ: газа
генберг: генберга
глобальный: глобального глобальной
глубина: глубине
глубокий: глубоком
год: год года году
гора: горой
государственно: государственно
граница: границ
груз: грузов
грунт: грунт
данные: данных
датчик: датчик
дать: данные
двигаться: движущихся
демонстрация: демонстрации демонстрацию
денис: денис
день: день дней
деятельность: деятельности
долл: долл
дом: дома
доставка: доставка доставки доставку
дракон: дракон дракона
занять: займет
западный: западного
запустить: запущены
затаиться: затаившийся
затмение: затмение
земля: земли землю
земной: земной
изготовить: изготовлен
измерение: измерения
изучать: изучать
изучение: изучения
инвестиция: инвестиции
инженерия: инженерии
инициатива: инициатива
институт: института
инструмент: инструмент инструменты
интеграл: интеграл
инфраструктура: инфраструктуры
использование: использованию
исследование: исследований исследования исследованиям
исследовательский: исследовательского
исследовать: исследовать
камера: камера камере камерой
кафедра: кафедрой
кеннеди: кеннеди
клиент: клиентам
ключевой: ключевая
ковш: ковшом
коммерческий: коммерческим коммерческой коммерческую
компания: компанией компании компания
компетенция: компетенции
компьютер: компьютер
контракт: контракта
космический: космическими космических космического
космонавтика: космонавтики
космос: космос космоса космосе
который: которая которой который
кризис: кризисов
кроме: кроме
крупный: крупным
латрей: латрей
логистика: логистика логистики
луна: луна луне луну луны
лунный: лунная лунного лунной лунный лунным лунных
луч: лучами
лёгкий: легкого
магнитный: магнитного
маневрирование: маневрирование
мантия: мантии
марс: марсе
маск: маск
материал: материалам
международный: международное
место: место
месяц: месяцев
микаэль: микаэля
микроровер: микроровер
мир: мир
миссия: миссией миссии миссий миссия
модель: модель
модернизировать: модернизировала
модуль: модуль модуля
монтана: монтаны
море: море моря
мотив: мотивам
мочь: могут
мэрилендский: мэрилендским
наблюдать: наблюдает
навигация: навигации
нагрузка: нагрузка нагрузки
надёжность: надежность
наука: наук науки
научный: научной научных
национальный: национального
небо: небес
недреманный: недреманное
необходимый: необходимых
несколько: нескольких
нестыковка: нестыковки
неудача: неудачу
неутомимый: неутомимый
новый: новые новых
носитель: носитель
оба: обе
обеспечивать: обеспечивая
область: области область
оборудование: оборудование
образец: образцов
обратно: обратно
обсерватория: обсерватория
объект: объектом
один: одной
око: око
околоземный: околоземной
окололунный: окололунную
определение: определения
определять: определять
орбита: орбите орбиту
освоение: освоения
оснастить: оснащен
оставаться: оставаться
отработать: отработать
ошибка: ошибки
памятный: памятная
партнёрство: партнерства
первый: первого первым
передавать: передавать
перелёт: перелет
пища: пищи
план: план
планировать: планирует
планироваться: планируется
пластина: пластина
платформа: платформой платформу
площадка: площадки
пневматический: пневматического
поверхность: поверхностей поверхность
повысить: повысив
поддержать: поддержать
подход: подход
поле: поля
полезный: полезная полезной полезные
получение: получения
получить: получен
полёт: полет полета
посадка: посадка посадки посадку
посадочный: посадочного посадочный
потерпеть: потерпел
потерять: потеряли
поток: поток потоков
правительство: правительствам
предлагать: предлагать
предназначить: предназначен предназначенный
предоставить: предоставлен предоставлено
предоставленный: предоставленны
представлять: представляет представляют
приближаться: приближается
прибор: прибор прибором
прилипать: прилипать
прилунение: прилунения
пример: пример примерами примером
примечательно: примечательно
приповерхностный: приповерхностном
проба: проб
программа: программе
проект: проектом
производство: производству
просматривать: просматривать
просто: просто
профиль: профиле
пусковой: пусковой
путь: пути
путём: путем
пыль: пыли
пытаться: пытался
работа: работы
радиация: радиации
развивать: развивает
развитие: развитие развитию
разместить: размещены
разный: разным
разработать: разработан
разработка: разработке разработкой
район: районе
ракета: ракета ракете
рамка: рамках
расстояние: расстояние
реголит: реголит реголита
рентгеновский: рентгеновских
ровер: ровер ровере
рядом: рядом
сбой: сбоям
сбор: сбора
свой: свои
себя: собой
сериал: сериала
серия: серии
система: систем системе системы
слой: слое
смотреть: см
снимок: снимков
собирать: собирать
совершить: совершит совершить
совместный: совместной
создавать: создавая
создание: созданию
создать: создан создана
сокол: соколу
солнечный: солнечное солнечной
сортировка: сортировки
сотрудничество: сотрудничество
спереди: спереди
специализироваться: специализируется
способность: способности
способствовать: способствовать
спускать: спускаемых
срок: сроком
старт: старта
стартовать: стартовала
стать: стал станет
стимулировать: стимулировать
струя: струя
стыковка: стыковки
сумма: сумма
существование: существования
сша: сша
тайвань: тайваня
также: также
тепловой: тепловых
техас: техасе
технология: технологий
течение: течение
тренд: тренда
тяжёлый: тяжелому
удаление: удалению
университет: университета университетом
ускорить: ускорить
услуга: услуги
усовершенствовать: усовершенствованную
успех: успех
успешно: успешно
успешный: успешного
установить: установлен установлена
установленный: установленной
устойчивый: устойчивый
учесть: учтя
фиксация: фиксации
флорида: флорида
фотоальбом: фотоальбом
хартия: хартии
хаябуса: хаябуса
холод: холода
художник: художника
цель: цель
центр: центра
центральный: центрального
чанъэ: чанъэ
частное: частного
частный: частная частной частных
часть: частей часть
четырнадцатидневный: четырнадцатидневным
четырёхдневный: четырехдневный
шаг: шаги
шведский: шведского
экономика: экономики
эксперимент: эксперимент
электролиз: электролиза
электромагнитный: электромагнитные
эпоха: эпохе
этот: этих
юго: юго
являться: является являются являющиеся
январь: января
японский: японский японской
яркий: яркими
