академия: академии
апрель: апреля
астрономия: астрономии
астрофизик: астрофизики
астрофизический: астрофизических
байкал: байкал байкале
байкальский: байкальский
белолаптик: белолаптиков
берег: берега
благодаря: благодаря
ближний: ближнего
большой: большой
будущий: будущей
важный: важным
ввести: введено
ведущий: ведущей
вертикальный: вертикальных
ветвь: ветвь
владимирович: владимирович
внутри: внутри
возможность: возможности
время: время
вселенная: вселенной
второй: второй
входить: входит
выделение: выделением
вынужденный: вынужденным
выполнить: выполнить
выполнять: выполняемых
высокий: высоких
галактика: галактик
галлий: галлий
германиевый: германиевого
гирлянда: гирлянд гирлянда гирлянде гирлянды
глобальный: глобальную
глубина: глубине
глубоководный: глубоководного
говорить: говорит
год: года году годы
григорий: григорий
далёкий: далеком
данные: данных
дать: данные
два: две двух
девять: девяти
действовать: действующих
день: день
детектор: детектор детектора
джелепов: джелепова
должный: должен
домогацкий: домогацкий
донный: донных
доступный: доступные
друг: друг друга
дубна: дубна
дыра: дыр
заведовать: заведующий
завершение: завершению
завершиться: завершилась
задача: задачи
замещение: замещением
замолвить: замолвите
запустить: запустили
зимний: зимней
игорь: игорь
известный: известных
изучать: изучать
инженер: инженеров
институт: институт института институтом
инструмент: инструментом
инфраструктура: инфраструктуры
использование: использование
испытание: испытания
исследование: исследований исследования
исследовательский: исследовательских
источник: источниками источников
ияи: ияи
кабель: кабеля
каждый: каждой каждый
казахстан: казахстана
калибровочный: калибровочными
канал: каналов
качественный: качественной
километр: километра
китайский: китайскими
кластер: кластер кластера кластеров
км: км
коллаборация: коллаборации коллаборация
коллега: коллегами
команда: команды
комплектация: комплектации
корреспондент: корреспондент
который: которые которых
крупномасштабный: крупномасштабных
кубический: кубического
курчатовский: курчатовский
лаборатория: лабораторией лаборатории
лазерный: лазерными
ледовый: ледового
линия: линиям
ловец: ловцы
лёд: льду
масштаб: масштаба
международный: международной
межкластерный: межкластерные
метод: метода
механизм: механизмы
мир: мире
многое: многом
многоканальный: многоканальной
модернизация: модернизацию
модуль: модули
море: море
москва: москва
мощный: мощного
мы: нам
набор: набора
надеяться: надеемся
наметить: намеченный
направление: направления
нарушение: нарушением
наряду: наряду
настоящий: настоящее
наука: наук науки
научный: научная
начальник: начальник
нейтринный: нейтринного нейтринной нейтринную нейтринный нейтринных
нейтрино: нейтрино
немногое: немногим
необходимый: необходимой
непредвиденный: непредвиденным
неуловимый: неуловимого
нивелировать: нивелированы
ниц: ниц
новость: новости
новый: новая нового новые
нужно: нужно
обращение: обращение
общий: общий
объединить: объединенного объединенным
объём: объем объема
огромный: огромным
один: одного
озеро: озера озере
оияй: оияи
оптический: оптические оптическим
опыт: опыту
организация: организацией
организовать: организована
основоположник: основоположника
особенность: особенностью
осцилляция: осцилляциям
отмечать: отмечает
оценить: оценить
очередной: очередная
очередь: очередь
пекин: пекин
первый: первые
передача: передачи
пилотный: пилотная
план: план
планировать: планируют
подводный: подводная
подготовка: подготовке
позволить: позволило позволят
поиск: поисках
поколение: поколения
покров: покрова
полный: полный
получить: полученные
полушарие: полушарии
полюс: полюсе
помощь: помощью
понять: понять
порядок: порядка
последний: последнего последние
поставить: поставлены
поток: потоков
превысить: превысил
предназначить: предназначен
представлять: представляет
пресс: пресс
привести: привело
принимать: принимают
присоединение: присоединения
причина: причин
проблема: проблем проблемам проблемами
провести: проведенных провела
продолжительность: продолжительность
продолжить: продолжила
проект: проекта проекте проекту
происходить: происходили
проложить: проложила
против: против
прототип: прототипа
профессиональный: профессиональному
процесс: процессы
прочный: прочного
прошлый: прошлом
работа: работ работы
работать: работают
развернуть: развернула развернута
развитие: развитию развития
развёртывание: развертывание развертыванию
разговорить: разговорить
размер: размеру
разместить: размещены
рамка: рамках
ран: ран
ранний: раннее
расположить: расположенный расположенных
расстояние: расстоянии
регистрация: регистрации
режим: режиме
результат: результаты
релиз: релиз
ремонт: ремонт
рождаться: рождаются
роль: ролью
российский: российские российской
россия: россии
руководитель: руководитель
самостоятельный: самостоятельный
самый: самый
сбор: сбора
сверхвысокий: сверхвысоких
сверхмассивный: сверхмассивных
свет: света
связанный: связанными
сделать: сделан
себя: собой
северный: северном
сегодняшний: сегодняшний
сердце: сердце
сеть: сеть
сила: силами силу
система: системой системы
следующий: следующего
словакия: словакии
слово: слово
сложиться: сложившихся
смотреть: см
совет: совета
совместно: совместно
содержать: содержит
создание: созданию
составить: составить
составлять: составляющие
справиться: справиться
средиземный: средиземном
строительство: строительству
строиться: строится
строй: строй
структура: структура
также: также
телескоп: телескоп телескопа телескопами телескопов
течение: течение
трезво: трезво
три: трех
трудозатрата: трудозатратам
тёмный: темной
увеличить: увеличить
уникальный: уникальная
ускорение: ускорения
установить: установила установлен
установка: установка установки
установленный: установленного установленных
устойчивый: устойчивого
участие: участие
учёный: ученого ученые ученых
физика: физики
физический: физические
формирование: формирование
фотоприёмник: фотоприемников
характерный: характерной
хороший: хороший
центр: центров
частица: частиц
чехия: чехии
член: член
чёрный: черных
шаг: шаг
эволюция: эволюцию
экспедиционный: экспедиционных
экспедиция: экспедиции экспедицию экспедиция
эксперимент: эксперимента
элемент: элементами элементов элементы
энергия: энергии энергий
этап: этапа
этот: эта
эффективный: эффективного
южный: южном
являться: является
ядерный: ядерных
ядерщик: ядерщики
япония: японии
