август: августа
автоматический: автоматическая
автономный: автономном
агентство: агентства
азот: азотом
академия: академии
акацук: акацуки
активный: активного
алексей: алексей
амс: амс
анализ: анализом
аналогичный: аналогичный
андреа: андреа
аппарат: аппарат аппаратом
ассоциация: ассоциации
астероид: астероид астероида астероиде
астероидный: астероидного
астроновость: астроновости
астроном: астрономам астрономов
атмосферный: атмосферных
атом: атом
аэрокосмический: аэрокосмических
баланс: баланса
бассейн: бассейне
безопасный: безопасного
бенна: бенну
беспилотный: беспилотной
биохимия: биохимии
ближний: ближнем
близкий: ближайшее
богатый: богата богатого богатые
больший: большая большую
борт: борту
буря: бури
быть: будем
важный: важные важными
вверх: вверх
вдоль: вдоль
величина: величина
верхний: верхней
вершина: вершин
весь: всей
ветер: ветер ветров
ветеран: ветеран
вещество: вещества
взаимодействие: взаимодействие
взлётный: взлетная
взрыв: взрывах
вид: виде
видимый: видимого видимой
включить: включена
внешний: внешний
вниз: вниз
внутренний: внутреннюю внутренняя
вода: вода водой
водород: водород водорода
возбуждать: возбуждает
возвратный: возвратный
возвращение: возвращению
возле: возле
возможный: возможных
возникновение: возникновения
вопрос: вопрос
воскресить: воскрешенного
вперёд: вперед
вращаться: вращающимися
время: время
вселенная: вселенная
встречаться: встречается
всё: всё
вулканически: вулканически
вулканический: вулканических
вырываться: вырывается
выход: выхода
выходить: выходит
газ: газ газа
газовый: газового газовом
газопылевой: газопылевых
галактика: галактика галактике
ганимед: ганимеда
геохимический: геохимических
гигант: гиганта
гидратировать: гидратированных
гипотеза: гипотезе
гироскопический: гироскопических
глина: глины
глинистый: глинистые
глубина: глубинах
год: года лет
голова: головы
горизонт: горизонтом
горячий: горячим горячих
готовиться: готовясь
гравитация: гравитации
граница: границах
грива: гривы
груз: груз
грунт: грунт грунта
группа: группа группы
давать: дает
давний: давнего
данные: данных
датчик: датчиков
дать: данные
движение: движения
двойной: двойная
дева: девы
действие: действием
действительно: действительно
демонстрировать: демонстрируют
день: дней дня
десять: десять
детектор: детектор
деформироваться: деформируется
джеймс: джеймс
диапазон: диапазоне
динамический: динамических
диск: дисками
дистанционный: дистанционного
дно: дно
добыть: добытый
доломит: доломита
дом: дом
доставить: доставила доставлен доставленного доставленном доставлены
доставка: доставка
др: др
другой: другие других
евклид: евклид
европа: европы
единый: единая
железо: железа
жизнь: жизни жизнь
журнал: журнале
забор: забор
завершить: завершена
задача: задач задача
заканчивать: заканчивают
заключить: заключить
занятой: занятая
запечатлеть: запечатлел
заполнить: заполнены
запустить: запущенная запущенный
заставлять: заставляя
затем: затем
звезда: звезд звезду звезды
звёздный: звездная звездных
земля: земле земли землю
земной: земной
зерно: зерен зерна
знаменовать: знаменует
знать: знаем
значительный: значительной
зонд: зонда
зондирование: зондирования
извергнуться: извергся
известный: известна известной известных
извлечь: извлекли
излучать: излучать
излучение: излучение излучения
изменение: изменения
изначально: изначально
изображение: изображение изображения
изучение: изучение изучения
имя: имени
ингредиент: ингредиенты
инопланетянин: инопланетяне
инструмент: инструментами
информация: информации
инфракрасный: инфракрасного инфракрасной инфракрасном инфракрасные
ио: ио
ион: ионами
ионизированный: ионизированный
ионизировать: ионизирующее
использовать: использовала
испускать: испускают
исследование: исследование исследований исследования
исследователь: исследователи
исследовательский: исследовательской
исходный: исходные
итог: итоге
июль: июля
июнь: июня
каждый: каждая
какой: каком
каллисто: каллисто
кальцит: кальцита
канаверал: канаверал
капсула: капсула капсулы
карбонат: карбонатов карбонаты
карта: карта карты
касаться: касается касающиеся
китаец: китайцами
китай: китаем китая
китайский: китайская китайские китайских китайской китайском
км: км
кнр: кнр
кокон: коконе
кольцо: колец кольцо кольцом
команда: команда
комета: комета
компонент: компонентами
конец: конца
конечный: конечном
конский: конской
контейнер: контейнер контейнера
концентрироваться: концентрировались
координата: координаты
кора: кора корой коры
корка: корку
корма: кормы
космический: космический космическим космическом
космос: космос космоса
который: которая котором которые который которых
кпк: кпк
край: краю края краям
красный: красное
кратер: кратере
круг: круги
крупный: крупнейшей
кудрить: кудря
лава: лава лаву лавы
лавовый: лавового лавовое лавовые лавовых
ладный: ладно
лак: лак
лата: лат
либо: либо
лишь: лишь
лишённый: лишенной
луна: луне луны
лунный: лунного лунной лунную лунных
магма: магма магмы
магнезит: магнезит
магнетар: магнетара
магний: магния
май: мая
мантия: мантии
марс: марсе
масса: масса
массивный: массивны массивные массивных
материал: материал материалом материалы
межпланетный: межпланетная
менее: менее
менять: меняя
метеорит: метеорит
метеоритный: метеоритными
миллион: миллионов
минерал: минералах минералов минералы
мир: мир миром
миссия: миссией миссии миссия
многочисленный: многочисленных
множество: множества множество
модель: модели
модуль: модуль
молекулярный: молекулярного молекулярные молекулярных
молодой: молодой молодых
момент: момент
монголия: монголия
море: морей
мочь: мог могла могло
мощный: мощные
мпк: мпк
мск: мск
мы: нам
мыс: мыса
мягкий: мягкое
наблюдать: наблюдать
наблюдение: наблюдений
надежда: надежда
наесться: наедятся
называть: называемую
наличие: наличие
напоминать: напоминает
направиться: направился
направление: направлении
наслать: нашли
настоящий: настоящий
натрий: натрия
наука: наук
научный: научных
находиться: находился находится находятся
национальный: национальном
начало: начало
наш: нашего нашей нашу
недра: недр
необходимый: необходимым
неожиданность: неожиданностью
неожиданный: неожиданным
непосредственно: непосредственно
непрерывный: непрерывная
непрозрачный: непрозрачны
нептун: нептуна
несколько: нескольких
неудача: неудачи
ниже: ниже
новый: нового новые
номер: номера
оба: оба
обещать: обещают
облако: облака облаках облаков
область: области область
облик: облик
облёт: облет
обнажать: обнажая
обнаружение: обнаружение
обнаруживаться: обнаруживалось
обнаружить: обнаружен обнаруженной обнаруженные обнаруженный обнаружила
обозначение: обозначением
обработка: обработка
образец: образец образцами образцах образце образцов образцы
образование: образование образованию образования
образовать: образовать образует
обратно: обратно
обратный: обратной
объединить: объединенные
объект: объектов
объектив: объективах
обычный: обычный
ограничивать: ограничивает
один: одним
ожидаться: ожидается
озеро: озер озера озеро
означать: означает
озёрный: озерными
океанический: океанических
около: около
окрестность: окрестностей окрестности
окружающий: окружающих
окружить: окруженные
оксид: оксидов
он: нему
операция: операций
оправиться: оправился
оптический: оптической
опубликовать: опубликовали
опускаться: опускается
орбита: орбите орбиту
орбитальный: орбитальный
органический: органическими
ориентация: ориентации
особенно: особенно
особенность: особенностями
оставаться: оставались
остаток: остатков
остаться: оставшаяся
отдельный: отдельные
отколоться: отколоться
открытие: открытием открытиях
открытый: открытый
отличаться: отличается отличаются
отсутствие: отсутствием
официальный: официальной
первый: первый
передать: переданы
перемещаться: перемещается
перемычка: перемычкой
планета: планетой
поверхностный: поверхностная
поверхность: поверхности
поднимать: поднимает
подниматься: поднимается поднимающихся
подобный: подобные
подповерхностный: подповерхностную
подразумеваться: подразумевается
подробный: подробные
подъём: подъема
позволить: позволит
позволять: позволяет позволяют
поздний: позже
показать: показали
показывать: показывают
покинуть: покинул
покрывать: покрывающей
покрыть: покрыто
полетать: полетать
полмиллиона: полмиллиона
получить: полученные получено
получиться: получится
полюс: полюс
понять: понять
попасть: попал
порадовать: порадовать
порода: породы
порядок: порядка
посетить: посетила
поскольку: поскольку
последний: последних
послужить: послужить
постепенно: постепенно
потерять: потерявший
поток: потоки потоков
почему: почему
практически: практически
прародитель: прародитель
пребиотический: пребиотической
превратить: превратили
предел: пределами
предназначить: предназначенный
преобладать: преобладают
приблизиться: приблизившись
прибор: прибор прибором
прибыть: прибыл
привести: привести
привет: привет
приводить: приводит
придавать: придавая
приземлиться: приземлилась
прилуниться: прилунилась
примесь: примесей
приняться: принялись
присутствие: присутствие
причина: причиной
проба: проб
провести: провести
программа: программы
продолжаться: продолжалась
проект: проект
прозрачный: прозрачны
произвести: произвела
пролетать: пролетая
пролёт: пролетов
протозвезда: протозвезд протозвезда протозвезды
протон: протон
процесс: процессах
прочий: прочими
прошлое: прошлого
прошлый: прошлом
прощать: прощай
публикация: публикацией
публиковать: публиковали
пульсар: пульсары
пыль: пыли пыль
пятно: пятна
пять: пять
различимый: различимые
размер: размером размеры
разойтись: разойдется
разрушаться: разрушается
район: районе
ранее: ранее
расплав: расплава расплавом
расплавить: расплавленной
расположить: расположена
рассеивать: рассеивают
рассмотреть: рассмотреть
расстояние: расстояние расстоянии расстояния
растекаться: растекаясь
реголит: реголит реголита
режим: режима
резко: резко
результат: результате
результирующий: результирующего
рекорд: рекорд
рециркуляция: рециркуляция
решаться: решались
родительский: родительского
рождаться: рождаются
розоватый: розоватое
рыба: рыбах
рюг: рюгу
рядом: рядом
сам: самого самой
самый: самые самым самых
сатурн: сатурн
сведение: сведения
свежий: свежие
сверхновый: сверхновой сверхновых
свет: свет
светило: светила
световой: световых
свечение: свечение
свой: своей своем
сгущение: сгущения
сделать: сделан сделанных сделать
себя: собой
север: севере
сегодняшний: сегодняшний
секрет: секреты
сентябрь: сентября
середина: середине
серпентин: серпентины
сильный: сильное
система: система системе системой систему системы
скалистый: скалистой
скольжение: скольжения
скорость: скорости
сложение: сложением
сложность: сложностей
сложный: сложной
слой: слоев слоя
случай: случае
слышать: слышат
смещение: смещение
смотреть: см смотрим
снимка: снимок
снимок: снимке снимки снимков
собранный: собранные собранный собранными собранных
совершать: совершает
согласно: согласно
содержать: содержать содержит
содержаться: содержатся
соединение: соединения соединениями
созвездие: созвездие созвездии
солнечный: солнечной солнечную
солнце: солнца
сообщить: сообщила
сосед: соседей
составить: составила
состоять: состоит
спектр: спектра
специалист: специалистов
спиральный: спиральная
список: список
спускать: спускаемой
спутник: спутника спутнике спутников
сравнение: сравнении
срединный: срединно
срыву: срыву
ссср: ссср
станция: станция
стать: стало
статья: статью
стенка: стенками стенок
степень: степени
столб: столба
сторона: стороны
ступень: ступень
сульфид: сульфидов
сфотографировать: сфотографировал сфотографированная
считать: считает
сша: сша
сюрприз: сюрпризы
также: также
телескоп: телескоп телескопом
температурный: температурная температурных
технический: технических
течение: течение
тип: тип
толстой: толстой
толстяк: толстяк
тонкий: тонкие
точка: точек
трение: трение
три: трех
туманность: туманности туманность
тёплый: теплый
увеличивать: увеличивает
углерод: углеродом
угловой: угловой угловые
ударный: ударном
удаться: удалось
удерживать: удерживает
указывать: указывает
ультрафиолетовый: ультрафиолетовое
управление: управлении
условие: условиях
успеть: успел успела
успешно: успешно
успешный: успешной
учёный: ученые ученым
уэбба: уэбб уэбба
февраль: февраля
формирование: формирования
формировать: формировавшие
формироваться: формируются формирующиеся
фосфат: фосфат фосфатов фосфаты
функционировать: функционирует
хаббл: хаббл
хабблом: хабблом
хаббнуть: хаббла
химия: химии
хребет: хребтах
царить: царивших
цель: целей целью
ценный: ценные
центральный: центрального центральной
цикличёска: циклически
циркулировать: циркулирует
чанъэ: чанъэ
частица: частице
частность: частности
часть: части часть частью
число: числе
чистота: чистотой
эйткен: эйткен
экспедиция: экспедиция
электрон: электрон
элемент: элементы
эпоха: эпоху
этап: этапах
этот: этих
южный: южный
юнона: юнона юноны
юпитер: юпитера
являться: является являются являющаяся являющимися
язев: язев
японский: японского
яркий: ярких
яркость: яркость
