автор: автор авторов авторы
аккреции: аккреции
активный: активными
алексей: алексей алексея
анализ: анализ
аналогичный: аналогичного
апертура: апертурой
аппаратура: аппаратуры
аспект: аспектов
астероид: астероид
астроновость: астроновости
астроном: астрономам астрономы
астрономический: астрономические
астрономия: астрономии
астроёлочка: астроёлочка
атака: атакой
атмосфера: атмосфере
атмосферный: атмосферными
бабочка: бабочка
бедный: бедных
белый: бело белым
благодаря: благодаря
блеск: блеска
близкий: ближайшее ближе
боде: боде
бок: боку
больший: наибольшим
брильянт: брильянтами
быстро: быстро
быстрорастущий: быстрорастущий
быстрый: быстрыми
быть: буду
вблизи: вблизи
вероятно: вероятно
вероятный: вероятным
весьма: весьма
вещество: вещества
взаимодействие: взаимодействий
вид: вид
видео: видео
видимый: видимом
видный: видны
включая: включая
внешний: внешнее
внимание: внимание
вновь: вновь
внутренний: внутреннее внутреннему
внутри: внутри
возле: возле
возможно: возможно
возможность: возможность
возможный: возможную возможные
возраст: возрастом
вокруг: вокруг
вопрос: вопрос
вояджер: вояджером
впечатляющий: впечатляющими
вполне: вполне
вращаться: вращается вращалась вращаются вращающейся вращающиеся вращающихся
вращение: вращения
время: временем времени время
вселенная: вселенная
встречаться: встречаются
всё: всё
выбор: выбора
выглядеть: выглядел выглядели
выделить: выделили
вызвать: вызванные
газ: газ
газовый: газовые газовых
галактика: галактика галактике галактики
галилеев: галилеевы галилеевых
галька: галька
ганимед: ганимед
геометрический: геометрические
геометрия: геометрию
германский: германские
гершель: гершелем гершель
гигант: гиганта гигантов гиганты
гигантский: гигантские гигантских
гипотеза: гипотезы
глаз: глаз глазами
год: год года годах году лет
голубой: голубой голубые
граница: границы
далёкий: далеких дальше
данные: данным данных
данный: данную
дать: дал данные
два: две двух
двигаться: движутся
движение: движения
двойной: двойных
двуликий: двуликий
двухмикронный: двухмикронного
девять: девять
декабрь: декабря
демонстрировать: демонстрирует
день: дня
дерево: дерева дерево
десятилетие: десятилетия
джеймс: джеймс джеймса
дзета: дзета
диапазон: диапазоне
динамичный: динамичный
диск: диска
дисперсия: дисперсии
дистанция: дистанцию
довольно: довольно
долгопериодический: долгопериодическими
дополнительный: дополнительное
доступный: доступна
др: др
друг: друг друга другом
другой: других другого другую
дыра: дыры
евклид: евклид
европа: европы
единорог: единорога
единственный: единственного
единый: единого
журнал: журнале
завершать: завершает
загадочный: загадочный
задержка: задержку
заняться: заняться
запечатлеть: запечатлеть
запустить: запущен
запутаться: запуталось
затем: затем
заявить: заявил заявили
звезда: звезд звезда звездами звездой звезду звезды
звёздный: звездная звездное звездным звездных
зелёный: зеленым
земля: земли
зима: зиму
знать: знаем знать
зоннебергский: зоннебергской
игла: иглам
идентифицировать: идентифицирован
известный: известна известны известных
излучение: излучения
изменение: изменения
измерять: измеряя
изначально: изначально
изображение: изображение изображения
изучать: изучал
изучение: изучения
изучить: изучил
именно: именно
иметь: имеют
импульс: импульсов импульсы
имя: имени
институт: института
интересно: интересно
интересный: интереснейший интересную интересных
инфракрасный: инфракрасном инфракрасные
ио: ио
использовать: используя
испускать: испускающие испускающий
исследование: исследования
исследователь: исследователи
исчезнуть: исчезли
йорк: йорке
каждый: каждого
казаться: кажется кажутся казалось
каков: какова
каллисто: каллисто
каменный: каменный
кандидат: кандидатов
каникулы: каникул каникулах каникулы
карлик: карлик
каталожный: каталожным
качество: качестве
квазар: квазар
кеплер: кеплер кеплера
китайский: китайский
китта: китт
класс: класса
классифицировать: классифицировали
колесо: колеса
количество: количество количеством
колумбийский: колумбийского
кольцо: колец кольца кольцо
компаньон: компаньона
компонент: компонент
конкретный: конкретный
констатировать: констатировать
конус: конус
конфигурация: конфигурацию
концентрация: концентрацию
космический: космический космического космической
космос: космос
который: которая которые который которыми
край: краев
кривая: кривые
кроме: кроме
крупный: крупнейшие крупнейших
кудрить: кудря
ледяной: ледяного ледяной ледяные
линия: линии линия
лисий: лисий
лишь: лишь
логично: логично
луна: лун луна лунами луну луны
лунный: лунное
луч: лучи
любитель: любителей
любой: любого любой
лёжа: лежа
макс: макса
максимальный: максимального
маленький: маленькие
марс: марс марса
марсианский: марсианский
масса: масс массой
массивный: массивный
медленный: медленный
межзвёздный: межзвездной
менее: менее
менять: менять меняют
мера: мере
мессье: мессье
место: место
металл: металлами
металличность: металличностью
метеорологический: метеорологических
метеорология: метеорология
метод: методом
метровый: метрового
мех: мех
миллисекундный: миллисекундные миллисекундный
минута: минут
мир: мир миров миром
миссия: миссия
млечный: млечном
мнение: мнению
многий: многих
многочисленный: многочисленные многочисленных
множество: множество
моделирование: моделированию
мозг: мозг
молодой: молодые молодых
момент: момент момента
мочь: могли могут
мощный: мощные
мс: мс
мы: нам
наблюдатель: наблюдателей наблюдателю
наблюдательный: наблюдательных
наблюдать: наблюдаемого наблюдаемые наблюдаемый наблюдали наблюдать
наблюдаться: наблюдается
наблюдение: наблюдений наблюдения наблюдениям
название: название
назвать: назвали
наиболее: наиболее
найти: найденных
наклон: наклоном
наличие: наличии
намного: намного
напоминать: напоминающие напоминающим
направить: направленного
например: например
наслать: нашли
настоящий: настоящий
наступать: наступают
научный: научного
находиться: находится
национальный: национального
наш: наш наше нашей нашем
небо: неба
недавно: недавно
нейтронный: нейтронная нейтронную нейтронных
некоторый: некоторые некоторых
немой: нем
необычный: необычную необычный необычным
неподалёку: неподалеку
нептун: нептун
несвязанный: несвязанных
несколько: нескольких несколько
ниже: ниже
новогодний: новогодние новогодний новогодних
новооткрытый: новооткрытые
новорождённый: новорожденные
новый: новая нового новой новом новые новый новых
номер: номером
ночь: ночи ночь
нынешний: нынешний
нью: нью
оба: оба
обеспечить: обеспечено
обзор: обзора
обладать: обладает
облако: облаков
область: область
обнаружение: обнаружения
обнаружить: обнаружена обнаруженные обнаружено обнаружили обнаружить
обозначение: обозначения
оборот: оборот
образ: образом образы
образовать: образуют
образоваться: образовались образуются
обратный: обратное
обращаться: обращается
обращение: обращения
обсерватория: обсерваторией обсерватории обсерватория
обусловить: обусловлено
обходиться: обходящиеся
общество: общества
объединить: объединенные
объект: объект объекта объектов объекты
объектив: объективах
объяснить: объяснить
овен: овна
огонёк: огоньки
огромный: огромная огромной
один: одна одним одно одного одной одном одну
однородный: однородный
оказаться: оказалась оказались
около: около
оливье: оливье
оно: оно
определение: определения
оптический: оптические
опубликовать: опубликовали опубликованной
орбита: орбите
ориентация: ориентации
особенно: особенно
особый: особые
остаток: остаток
отдалить: отдаленных
открытие: открытии открытия открытиях
открыть: открыты
отличаться: отличается
отмена: отмена
отмечаться: отмечались
относительно: относительно
отрываться: отрываясь
оценивать: оценивают оценивая
очередной: очередной
очистить: очистили
первый: первый
передать: передала
передний: переднего
период: периода периодами периодом
периодический: периодические
персея: персея
пик: пик
пингвин: пингвин
пк: пк
план: плана
планета: планет планете планеты
планетный: планетных
планетоид: планетоиду
планк: планка
плотно: плотно
погружать: погружая
подгонка: подгонка
подождать: подождать
подтвердить: подтвердили подтвердить подтвержденных
подходящий: подходящих
подыскать: подыскали
позволить: позволили
поздний: позже
пока: пока
показатель: показатель
показывать: показывает показывают
полигон: полигоном
половина: половину
положение: положение
получить: получены получил получили
полюбоваться: полюбоваться
полюс: полюса полюсом
поляков: полякова
полярный: полярной
полёт: полеты
помочь: поможет
пончик: пончик
понятно: понятно
понять: понять
портрет: портреты
поскольку: поскольку
последний: последние
послужить: послужить
посторонний: постороннего
постоянно: постоянно
потерять: потеряет
похожий: похожие
поэтому: поэтому
появляться: появляются
правдоподобие: правдоподобия
правильность: правильности
правый: правее
превращаться: превращается
предновогодний: предновогодний
предполагать: предполагаемой предполагают
предположительно: предположительно
предположительный: предположительные
предположить: предположить
представить: представленном
представлять: представляет
представляться: представляется
предстоящий: предстоящая предстоящих
предыдущий: предыдущие
прежний: прежнему
прекрасный: прекрасная
препринт: препринтов
приблизительно: приблизительно
прибыть: прибыл
привлечь: привлекут
прийтись: придется
примерно: примерно
принадлежать: принадлежит
принять: принято
пристальный: пристальное
приход: прихода
приходиться: приходится
провести: провел
прогноз: прогноз
программа: программ
продлиться: продлятся
продолжительность: продолжительностью
пролетать: пролетая
пропасть: пропавшие
пространство: пространства
протозвезда: протозвезды
проходить: проходят
прохождение: прохождений прохождения
процесс: процессами
прямой: прямая прямой
пульсар: пульсар пульсара пульсаров пульсары
путь: пути
пять: пять
работа: работа работу работы
радиотелескоп: радиотелескоп
радиус: радиусом
раз: раза
развитие: развития
разлететься: разлетятся
размер: размера
разный: разной разных
раскручиваться: раскручивается
расположить: расположен расположено
распространить: распространенный
рассеивание: рассеивания
рассеянный: рассеянное
рассматривать: рассматривать
расстояние: расстоянии расстояний
рассчитать: рассчитан
рекорд: рекорд
рен: рене
рентгеновский: рентгеновская рентгеновские
ровно: ровно
рождественский: рождественская рождественской рождественскую
рой: рой
рыба: рыбах
рядом: рядом
сам: самому
самый: самое самые самый самых
сатурн: сатурн сатурну
сверхновый: сверхновой
светило: светила
светить: светит
световой: световых
свидетельство: свидетельства
свидетельствовать: свидетельствовать
свой: свое своей своем
свыше: свыше
себя: собой
северный: северного
сезон: сезоны
сезонный: сезонная сезонных
селёдка: селедку
сервер: сервере
середина: середине
серьёзный: серьезные
система: системах системе системы
сиять: сияющими
скопление: скопление скоплением скоплении скоплений
скорость: скоростью
слабый: слабое слабой
следующий: следующее
сложность: сложности
сложный: сложнее
смотреть: см
снежинка: снежинки снежинок
снимка: снимок
снимок: снимке снимки
событие: события
совершенный: совершенных
совершить: совершить
совместно: совместно
современный: современном
согласно: согласно
сожаление: сожалению
созвездие: созвездии
создавать: создавать
солнечный: солнечной
солнце: солнца солнце
сомнение: сомнения
сообщаться: сообщалось
сообщить: сообщили
соответствовать: соответствующим
сопровождение: сопровождении
сосновый: сосновым
составить: составлен
составлять: составляет составляющих
составной: составном
состоять: состоящий
сочетание: сочетанием
спица: спицами
способ: способ
способность: способностью
спутник: спутник спутника спутниками спутники спутников спутником спутнику
сразу: сразу
среда: среды
среди: среди
среднее: среднем
ставить: ставит ставящих
становиться: становится
старый: старейших
статья: статье статьи
стрелка: стрелки
строго: строго
судьба: судьба
существование: существование существовании существования
существовать: существует
сформироваться: сформировались
сходство: сходство
сценарий: сценарии
считаться: считалось
счёт: счет
также: также
такой: такие таким таких такого
твёрдый: твердый
телескоп: телескоп телескопа телескопов телескопы
тень: тень тенями
технология: технологий
толстяк: толстяк
тот: те
транзит: транзита транзитах
требоваться: требуется
третий: третий
треугольник: треугольник
три: трех
туманность: туманностей туманности туманность
тусклый: тусклые
тысяча: тысячи
тёмный: темная темную
тёплый: теплый
уверенно: уверенно
уверенность: уверенности
увидеть: увидеть
увидти: увидем
удаться: удалось
удивительный: удивительной
удивлять: удивляет
узор: узоры
уильям: уильям уильямом
университет: университета
упаковать: упакованных
употреблять: употребляют
уран: уран урана ураном
уранианский: уранианского
уровень: уровне
усеивать: усеивают
устроить: устроены
утверждение: утверждению
учитывать: учитывая
учёный: ученые
уэбба: уэбб уэбба
фон: фона
фонд: фонда
фоновый: фоновой
форма: форме форму формы
хаббл: хаббл
хаббнуть: хаббла
хвойный: хвойное
хеллера: хеллер
хотеть: хотели
цвет: цветов цветом
целое: целого
чандра: чандра чандры
час: час часа
часто: часто
частота: частотах
человеческий: человеческий
четверть: четверть
четыре: четыре четырех
чистый: чистого
чувствительность: чувствительности
чувствительный: чувствителен
чёрный: черной
шанс: шанс
шапка: шапка шапки
шар: шар
шаров: шаровых
шаровой: шаровое
шторм: штормов
шуба: шубой
шум: шума
экзолуна: экзолун экзолуны
экзопланета: экзопланет экзопланеты
экзоспутник: экзоспутника
экстремальный: экстремальные
электромагнитный: электромагнитного
электронный: электронную электронных
эмиссионный: эмиссионной
этот: эта этих этому
эффект: эффектов
южный: южной
юпитер: юпитер юпитера юпитере юпитером
явление: явлений явления
являться: является
язев: язев
яйцо: яйцом
январский: январских
январь: январе января
яркий: яркий
яркость: яркости
ёлка: елкой ёлка ёлки
ёлочка: ёлочки
