абсолютный: абсолютном
адекватный: адекватный
азот: азот азота
активный: активные
амбициозный: амбициозный
аналог: аналога
астероид: астероиды
астрофизик: астрофизика
атмосфера: атмосфера атмосферой атмосферу атмосферы
атмосферный: атмосферная
атом: атомы
барьер: барьеров
безжизненный: безжизненных
белый: белых
биолог: биолога
блеск: блеска
близкий: ближайшие ближе
близко: близко
богатый: богатая
больший: большим
большинство: большинство
большой: большое большой
борис: борис
буйный: буйных
бурлить: бурлит
бурный: бурная
бурый: бурых
быстрый: быстрей быстрое
быть: будь
важный: важнейшая
вариант: вариант
вблизи: вблизи
величина: величины
венера: венеры
вероятность: вероятность
вероятный: вероятен
вертикаль: вертикали
весь: вся
ветер: ветер ветра
вещество: веществ
взаимодействовать: взаимодействуя
взять: взяты
вид: виде
видимо: видимо
видно: видно
вместе: вместе
внешний: внешней внешних
внимание: внимание
внутренность: внутренности
внутрь: внутрь
вода: вода воды
возле: возле
возможно: возможно
возникать: возникает
возраст: возраста
вокруг: вокруг
волна: волны
вообще: вообще
вполне: вполне
вправе: вправе
вращаться: вращаются
вращение: вращение вращении
вред: вред
время: времена временем времени
вряд: вряд
вселенная: вселенной
всплывать: всплывает
вспышка: вспышки
всё: всё
второй: вторых
выглядеть: выглядит
вымерзание: вымерзания
вымерзать: вымерзать
выполнить: выполнена
выражение: выражении
вырисовываться: вырисовывается
вытянутый: вытянута
вытянуть: вытянуть
выше: выше
гелий: гелия
генератор: генератор
генерация: генерации
гигантский: гигантский гигантских
гиродин: гиродинов
главный: главной
глубина: глубину
говорить: говорит
год: года годам лет
годиться: годится годятся
гораздо: гораздо
горизонталь: горизонтали
горячий: горячее горячих
гравитационный: гравитационной
гравитация: гравитация
граница: границы
графика: графике
грубо: грубо
группа: группы
группироваться: группируются
давать: дают
далеко: далеко
далёкий: далекой дальше
данные: данным данных
данный: данном
дарвин: дарвин
дать: данные
два: двум двух
двадцать: двадцать
двести: двухсот
движение: движением движения
двухсотый: двухсотая
девять: девять
делать: делай
дело: дело
день: день дней
десятка: десятки
десяток: десятков
десять: десяти десять
диапазон: диапазоне
дипольный: дипольного
диск: диска диску
дифференциальный: дифференциальном
диффузия: диффузии
диффундировать: диффундирующие
длина: длина длины
длинный: длинные
довольно: довольно
должный: должно
доля: долей
дорога: дорог
достаточно: достаточно
достигнутый: достигнутый
достигнуть: достигла достичь
достижение: достижения
достижимость: достижимости
доступный: доступные
досягаемый: досягаемые
дотягивать: дотягивает
другой: другая другими других другое
дыхание: дыханием
единица: единицах
единственно: единственно
единственный: единственной единственным
желание: желании
жизнепригодность: жизнепригодности
жизнь: жизни жизнь
жить: живут
жёсткий: жестким жесткое
забросить: забросить
зависеть: зависит
зависимость: зависимости зависимость
задача: задача
замыкание: замыкание замыкании
затем: затем
затруднить: затруднено
звезда: звезд звезда звездам звезде звезду звезды
звёздный: звездного звездные звездный
зелёный: зеленым
землеподобный: землеподобной землеподобные
земля: земель земле землей земли землю земля
земной: земная земной земную
зеркало: зеркалом
знать: знаешь
значит: значит
значительно: значительно
значиться: значится
зона: зона зоне зоной зону зоны
идти: идут
избегать: избегают
излучение: излучением излучения
изучение: изучение
изучить: изучить
именно: именно
инструмент: инструмент инструментами инструментов
интенсивность: интенсивность
интенсивный: интенсивная интенсивный
интервал: интервал
интервью: интервью
интересный: интересней
интересовать: интересуют интересующей
интерференционный: интерференционный
интерферометр: интерферометр интерферометров
инфракрасный: инфракрасном
ионизировать: ионизирующего
ионизовать: ионизованные ионизованы
искать: искать
использование: использованием использовании
использовать: используя
испускать: испускают
исследовать: исследовать
каков: каковы
какой: каких
карлик: карлика карлики карликов
катастрофа: катастрофы
кеплер: кеплер кеплера
кит: кита
класс: класс класса классов
классический: классический
колебание: колебания колебаниям
количество: количество
колонизация: колонизация
комета: кометы
комментарий: комментариев
конвективный: конвективная
конвекция: конвекция
координата: координатах
корона: короне
корреляция: корреляции
космический: космический космических космического
который: которое которые который которых
край: крае
крайний: крайней
красивый: красивым
красный: красного красные красных
кривая: кривые
круглый: круглом
круговой: кругового
лазейка: лазейку
ледяной: ледяной ледяные
лежать: лежит
летучий: летучих
линза: линзы
линия: линии линия
лишить: лишило
лишь: лишь
лучевой: лучевая лучевой
любой: любым любых
лёгкий: легче
магнитный: магнитного магнитное
маленький: меньше
малое: малым
малый: малой
марс: марс марса
масса: масс масса массе массы
медленно: медленно
менее: менее
мера: мере
меркурий: меркурий
место: местах месте место
метод: метод метода методом
метр: метров
метровый: метровым
мешать: мешает
мигрировать: мигрировала
миллиард: миллиард миллиардов миллиарды
миллион: миллионов
минимум: минимум
мирный: мирных
миссия: миссия
многочисленный: многочисленные
молодой: молодого
молодость: молодости
мочь: могла могли могут можем
мощный: мощном мощные мощный
мягкий: мягкий
мёртвый: мертвые
наблюдательный: наблюдательной
наблюдать: наблюдать
наблюдение: наблюдение наблюдений наблюдения наблюдениям
набраться: набралась
наверняка: наверняка
навести: наведенная
название: название
наземный: наземный наземных
называть: называемая
наиболее: наиболее
найти: найдена найдено найти
намного: намного
напрашиваться: напрашивается
например: например
напрямую: напрямую
наружу: наружу
насколько: насколько
наслать: нашли
настоящий: настоящему
насчитываться: насчитывается
наука: наука науке
находиться: находится находиться находясь
нахождение: нахождения
наш: наших
небесный: небесного
небольшой: небольшая небольшим небольших
невидимый: невидима
невысокий: невысокой
недалёкий: недалекую
неделя: недель
недостаточно: недостаточно
недоступный: недоступная
немного: немного
неподалёку: неподалеку
неприятный: неприятное
несколько: несколько
несмотря: несмотря
неспособный: неспособен
нести: несет
ниже: ниже
нобелевский: нобелевская
новый: нового новые новый
нормировать: нормирован
нужно: нужно
нужный: нужен
обезопасить: обезопасить
обеспечить: обеспечил
обзавестись: обзаведясь
обитаемость: обитаемости
обитаемый: обитаемых
обитание: обитания
облучение: облучение облучением облучения
обнаружение: обнаружения
обнаружить: обнаруженные обнаружено обнаружены обнаружить
обозначить: обозначены
обойти: обойти
обойтись: обойтись
обратить: обратите обращены
обращение: обращения
обстоятельство: обстоятельство
огромный: огромный
один: одна одно одной
однако: однако
одновременно: одновременно
одноразовый: одноразовая
ожидать: ожидать
оказаться: окажется оказалось оказался
оказываться: оказывается оказываются
океан: океанами
океанский: океанская
около: около
околоземный: околоземными
окончательно: окончательно
окрестность: окрестностях
они: ними
оно: оно
опереться: опереться
определённый: определенное
опубликовать: опубликованных
оранжевый: оранжевые
орбита: орбит орбита орбитами орбитой орбиты
орбитальный: орбитальном орбитальному орбитальный орбитальным орбитальными
ориентация: ориентация
оросить: оросили
орошение: орошение
основное: основном
основный: основных
особенно: особенно
оставаться: остается
остановиться: остановившись
остаток: остатками
осуществление: осуществления
отдельно: отдельно
открытие: открытием
открытый: открытых
относительно: относительно
относиться: относящиеся
отношение: отношение отношению
отъюстировать: отъюстировано
оцениваться: оценивалась
оценка: оценки
очень: очень
очертить: очертить
падать: падает
падение: падение
пара: пара
парниковый: парниковом парниковый
парсек: парсек
первый: первые первый первых
передача: передачи
передний: переднем
переизлучать: переизлучают
перелёт: перелетов
пересоединяться: пересоединяется
период: период периодам периодами периодом периоду
перспектива: перспективы
перспективный: перспективную перспективные перспективным
печальный: печальное
пк: пк
планет: планетам
планета: планет планета планетами планете планету планеты
планетный: планетная планетной планетных
плохой: хуже
поверх: поверх
поглощать: поглощают
подавлять: подавляющее
подводить: подводить
подобный: подобное подобной
подтвердить: подтвержденные
подходить: подходит
подходящий: подходящих
позволять: позволяет
поиск: поиска поиски
пока: пока
показать: показан показано показаны
поколение: поколения
поле: поле поля
полезный: полезный
полметра: полуметра
полностью: полностью
полноценный: полноценной
поломка: поломки
полусотня: полусотни
получать: получает
получаться: получается
получить: получить
полушарие: полушарие полушарии
поместиться: поместилась
помочь: поможет
помощь: помощью
поначалу: поначалу
попадать: попадает попадают попадающем
попасть: попала
порог: порог порога
порядок: порядка порядке порядок
поскольку: поскольку
последний: последней
последовательность: последовательности
поток: поток
поторопиться: поторопились
потребовать: потребовало
потребоваться: потребуются
похоже: похоже
поэтому: поэтому
превосходить: превосходит
превратиться: превратившись
превышать: превышает
предварительно: предварительно
предел: пределах пределом пределу пределы
преимущество: преимущество
прекрасно: прекрасно
прекратить: прекращено
премия: премия
прибегать: прибегать
пригодность: пригодностью
пригодный: пригодную пригодные пригодных
придумать: придумать
приемлемый: приемлемую
прийтись: пришлось
прилететь: прилетевшие
приливный: приливное приливном
примерно: примерно
примерный: примерные
принадлежать: принадлежат
принцип: принцип
принципиально: принципиально
приоритетный: приоритетных
пристанище: пристанищем
прицел: прицелом
причина: причина
причём: причем
приютиться: приютиться
приятно: приятно
проблема: проблем проблема
продолжаться: продолжаться
проект: проект проектов
прожарить: прожарены
происходить: происходило происходят
проработать: проработал
протопланетный: протопланетного
прохладный: прохладные
проходить: проходит
прочить: прочим
прямой: прямого прямое
путать: путать
пять: пять
работа: работа работы
равный: равна равны
радиус: радиус радиуса радиусе радиусов радиусом радиусу
развить: развитая
разговор: разговор
размер: размером
разнообразный: разнообразные
разочаровывать: разочаровывает
разработать: разработана
разрешение: разрешению
разумный: разумный
распознать: распознать
распределение: распределение
распространить: распространить
расстояние: расстояние расстоянии
реакция: реакции
реализоваться: реализовался
реальный: реальную
революция: революцию
регистрироваться: регистрируется
редкий: редкое
режим: режиме
резонанс: резонансе
результат: результат результате
релаксировать: релаксировала
рентген: рентгеном
рентгеновский: рентгеновские рентгеновский рентгеновское
рис: рис
ряд: ряду
сам: само самой самом
самый: самая самое самую
свет: свет
светимость: светимости светимость
светосила: светосиле
свой: своей своем своих
связанный: связанные
сделать: сделанные
сдирать: сдирающее
сдираться: сдираются
секунда: секунду
селекция: селекции
серия: серии
сильно: сильно
сильный: сильная сильней сильное сильный
система: систем система системе системы
ситуация: ситуацию
сколько: сколько
сконденсироваться: сконденсироваться
скорее: скорее
скорость: скорости скорость
слабеть: слабей
следовательно: следовательно
следовать: следует
следующий: следующая
слишком: слишком
сложный: сложен сложнее сложнейшая
слой: слой слоях
случай: случае
смотреть: см смотреть
сначала: сначала
снеговой: снеговая снеговой
снимать: снимал
собирать: собирающий
собственный: собственной
совершить: совершить
современный: современном
содрать: содрал
сожаление: сожалению
солнечный: солнечной солнечный
солнце: солнц солнца солнце солнцу
соответствовать: соответствует соответствующая
сопровождать: сопровождаемые
сотня: сотни сотню
спасти: спасет спасти
спин: спин
список: списки
способ: способом
способный: способен способна
способствовать: способствовали
сравнение: сравнение сравнении
сравнительно: сравнительно
сразу: сразу
среди: среди
средний: средней
срок: срок
старательно: старательно
сто: ста сто
стоить: стоит
столбец: столбец
столь: столь
сторона: стороной
страшный: страшнее
строиться: строящийся
суперземля: суперземли суперземля
супермарс: супермарс
сутки: сутки
сухой: сухой
существенно: существенно
существовать: существовавших существует существуют
существующий: существующих
сфера: сфере
сформироваться: сформировалась
сценарий: сценарий
считаный: считаные
съехать: съехала
также: также
такой: таких такое
тау: тау
телескоп: телескоп телескопа телескопов телескопы
тело: тела
тема: тему
температура: температуру
тепло: тепла
термоядерный: термоядерные
технология: технология
тип: типа
типичный: типичным
толстой: толстая толстой
толщина: толщиной
тот: те той
точка: точки
точно: точно
точность: точностью
транзит: транзитам транзитов
транзитный: транзитных
трв: трв
требоваться: требуется
триллион: триллионов
турбулентный: турбулентного турбулентное
тысяча: тысяч тысячи
тяжёлый: тяжелых
убирать: убирать
убывание: убывания
углекислота: углекислота
удача: удачи
удачный: удачная
удержание: удержанию
удобный: удобны
ультрафиолет: ультрафиолет
упомянуть: упомянутых
уровень: уровень уровне уровня
уступать: уступают
ухищрение: ухищрений
учитывать: учитывая
фактор: фактора
физика: физике
финансирование: финансирование
фонарь: фонарем
формально: формально
формироваться: формироваться формируется
фотон: фотонов фотоны
хаб: хаб
хаббнуть: хаббла
химера: химера
холодное: холодное
холодный: холодном
хороший: хорошим
хотеть: хотим
целиком: целиком
цель: целей цель
центр: центра
цивилизация: цивилизация
циркуляция: циркуляция
чайник: чайник
часть: часть
человечество: человечества
черта: черту
четыре: четыре
чили: чили
численный: численное
число: числе число
чувствительность: чувствительности
чувствительный: чувствителен чувствительней
чёткий: четкая
шесть: шесть
широкий: широкой
штерн: штерн
эволюция: эволюции эволюция
экзопланета: экзопланет экзопланеты
экспансия: экспансии
элемент: элементов
энергия: энергии
эридать: эридана
этап: этап
это: этим
этот: эта этих
эффект: эффект эффекте
юпитер: юпитер
явление: явление
являться: является
ядерный: ядерной
яркий: яркий яркого
яркость: яркости
