абсолютный: абсолютной
автор: авторов авторы
агентство: агентством
адсорбировать: адсорбированного
аккреционный: аккреционный
активно: активно
активность: активность
активный: активного активном активны
алексей: алексей
алюминий: алюминия
андромеда: андромеда
аппарат: аппарат аппарата
арнольд: арнольдом
архивный: архивных
астроновость: астроновости
астроном: астрономом астрономы
астрономический: астрономических
атака: атакой
атмосфера: атмосфере атмосферу
атмосферный: атмосферное
бар: баром
белый: белый
биология: биологии
биосфера: биосферу
близкий: ближайшего близкой
близлежащий: близлежащих
больший: большая больших
большой: большого
брильянт: брильянтами
быть: будут
вдоль: вдоль
величина: величине
версия: версии
весь: всем
весьма: весьма
ветеран: ветераном
вещество: вещества вещество
взаимодействие: взаимодействия
взаимодействовать: взаимодействует взаимодействующих
взаимосвязь: взаимосвязей
взять: взяты
вид: виде
видеться: видится
видный: видна
виртанена: виртанена
влиять: влиять
внешний: внешним
внештатный: внештатная
внутренний: внутренней внутренним
вода: воды
воздействие: воздействием воздействия
воздействовать: воздействуют
возможно: возможно
возможность: возможность
возрасти: возрастет
войти: вошло
вокруг: вокруг
волна: волны
вращаться: вращающихся
врезаться: врезающихся
время: времени время
всплеск: всплески
встреча: встречей
встречаться: встречаются
всё: всё
входить: входили входит
выбрасываться: выбрасывается
выбрать: выбрана
выброс: выброс выбросов
вызвать: вызванные вызвать
выйти: вышел
выложить: выложенных
выполнить: выполнена
вырасти: вырасти
высокий: высокого
высокоскоростной: высокоскоростных
газ: газ газа газов
газовый: газовые
галактика: галактик галактика галактиках галактике галактики галактикой галактику
гвиана: гвиане
ггц: ггц
герасименко: герасименко
гершель: гершелем
гладкий: гладкую
глобальный: глобальном
год: год года году лет
голубой: голубых
гораздо: гораздо
горячий: горячих
готовый: готовый
грунт: грунте
группа: группе
давление: давление
далее: далее
дальнейший: дальнейшее
данные: данными
дать: данной данные дать
два: две двумя
двигатель: двигателя
дева: деве девы
декабрь: декабре
демонстрировать: демонстрируют
десорбция: десорбции
десятилетний: десятилетнем
десять: десять
джеймс: джеймс джеймса
джет: джета джетов джеты
джон: джоном
диск: диск диска
дисковый: дисковой
дифракционный: дифракционные
длина: длиной
длительный: длительного
довольно: довольно
должный: должен должна
дополнительный: дополнительный
доставлять: доставлять
достигать: достигать
достижение: достижений
доступ: доступ
драматический: драматическая
дыра: дыр дыра дыры
европейский: европейским
единый: единой
естественный: естественной
железо: железа
жидкий: жидкой
жизнь: жизни жизнь
журнал: журнале
жёсткий: жесткой
завершать: завершает
завершить: завершил
завеса: завесу
заключаться: заключается
закручивать: закручиваемого
запас: запасы
запуск: запуск запуска запуске
заряд: зарядов
затемнять: затемняет
затмевать: затмевать
звезда: звезд звезды
звездообразование: звездообразовании звездообразования
звёздный: звездной
зелёный: зелёный
земля: земле земли землю
земной: земными
знать: знаем
значительно: значительно
зонд: зонд
идея: идея
изготовить: изготовлена изготовлены
издалёка: издалека
излучать: излучают
излучающий: излучающие
излучение: излучение
изменить: изменить
измениться: изменилась изменились
изначально: изначально
изображение: изображение изображений
изучение: изучение изучения
илл: илл
именовать: именуемые
иметь: имевшей имеет
иметься: имеются
имя: имени
инструмент: инструмент инструментами
интересно: интересно
инфракрасный: инфракрасное
искусственный: искусственных
испаряться: испаряется
использование: использование использованием использования
использовать: использовали использованных использующая
исследование: исследований исследования
исследователь: исследователи
история: история
источник: источником
исходный: исходные
какой: каких какое
карлик: карлик
карликовый: карликовая карликовым карликовых
картинка: картинке
кислород: кислород кислорода
классифицироваться: классифицируется
климат: климат
климатический: климатические
ключевой: ключевое
количество: количества количество количеством
коллаборация: коллаборации коллаборация
колоризация: колоризация
кольцо: кольцо кольцом
команда: команде
комбинация: комбинация
комета: комета комете кометой комету кометы
кометный: кометного
комментарий: комментария
компаньон: компаньон компаньоном
композит: композита
контакт: контакта
космический: космический космическим космических космического
космодром: космодрома
космос: космос
который: которое которую которые который которых
красный: красной
кроме: кроме
крошечный: крошечных
крошка: крошки
крупный: крупная крупного крупные крупным крупных
кудрить: кудря
кура: куру
лев: лев
левый: левой
ледяной: ледяной ледяные
либо: либо
лишь: лишь
лишённый: лишенную
луна: луны
лунный: лунное
лёд: лед
магнитный: магнитные
маленький: маленькую меньше
мало: мало
малый: малых меньшая
марс: марс марса марсе
марсианский: марсианский марсианской марсианском
март: марта
масса: масс массой массы
массивный: массивнее массивной массивных
масштаб: масштабах масштабе
материал: материала
материя: материю
медленный: медленнее
медлить: медлить
мелкомасштабный: мелкомасштабную
менее: менее
мера: мере
местный: местной местных
место: мест
металлический: металлических
метод: метод метода методы
миллиард: миллиард миллиардов
миллион: миллионов
минимальный: минимальными
мир: мире
миссия: миссии миссию
мкм: мкм
млечный: млечного млечный
мнение: мнению
многие: многие
модель: модели модель
мочь: могло могут
мощный: мощные
мы: нам
мягкий: мягкая
наблюдение: наблюдений наблюдения
нагрев: нагрев
нагреваться: нагревается
надежда: надежда
название: названием
наметить: намеченной
наностержень: наностержней
наночастица: наночастиц наночастицами наночастицы
направить: направить
например: например
научиться: научимся
научный: научных
находиться: находятся находящихся
начало: начало
начать: начать
начаться: началась
начинать: начиная
наш: нашего нашей
небольшой: небольшая небольшое невелика
недавний: недавнее недавнюю
недостаточно: недостаточно
недостаточный: недостаточной
необходимость: необходимостью
необходимый: необходимого
неоправданно: неоправданно
непосредственно: непосредственно
несколько: нескольких
несмотря: несмотря
новость: новостей
новый: новой новую новые новых
номер: номера
носитель: носителя
ноябрь: ноября
оба: оба обе
обеспечивать: обеспечиваемой
обеспечить: обеспечит
обзор: обзор
обитание: обитания
обладать: обладает
облако: облака
обнаружение: обнаружение
обнаружить: обнаружено обнаружила
оболочка: оболочке
обработка: обработка
образование: образование образования
обращаться: обращаются
обсуждать: обсуждают
обусловить: обусловлены
объединить: объединены
объект: объекта
объектив: объективе
объём: объемов
овальный: овальную
огромный: огромное огромным огромных
один: одно одного
однако: однако
ожидаться: ожидается
оказаться: окажется
океан: океанами
около: около
околоядерный: околоядерного
окружающий: окружающая окружающего окружающее окружающей окружающие
оптический: оптическое
опубликовать: опубликованной
орбита: орбита орбиту
ориентация: ориентации
освещённость: освещенности
освоение: освоении
оседать: оседать
основный: основных
оставаться: оставаясь
осуществить: осуществил осуществлен осуществлена
отказ: отказ
открыть: открыта открыты
отложить: отложена
отмечать: отмечают
относительно: относительно
относить: относят
отправка: отправка
отскок: отскоками
отсутствовать: отсутствуют
оценка: оценкам
очень: очень
панель: панели
пара: пару
парниковый: парникового парниковых
первый: первая первые первый
передать: переданном передано
перекачивать: перекачивает
перемычка: перемычкой
перспектива: перспективой
пингвин: пингвин
писать: пишут
питаться: питается
плазменный: плазменных
планета: планете планету планеты
планироваться: планировался
площадь: площадь
поверхность: поверхности поверхность
повышение: повышения
повышенный: повышенные
поглощение: поглощения
подобный: подобные
подогреть: подогреть
подтолкнуть: подтолкнуть
позволять: позволяет
пока: пока
показать: показали
показывать: показывают
полагать: полагают
поле: поля
полоса: полосы
получать: получать
получить: полученное
полюс: полюсов
полярный: полярный полярных
полёт: полет полета
помогать: помогая
помочь: помочь
помощь: помощью
посадка: посадка посадкой
поскольку: поскольку
последующий: последующего
потреблять: потребляет
потребоваться: потребуется
похожий: похожи
появление: появление
практически: практически
практичный: практичным
предлагать: предлагаемый предлагали
предложение: предложений
предложить: предложенного
предполагать: предполагают
предположительно: предположительно
представить: представленной
представление: представление
представлять: представляют
предупреждать: предупреждают
предусматривать: предусматривающую
предыдущий: предыдущие
прежде: прежде
преимущество: преимущество
преобразование: преобразования
преобразовать: преобразовав
приводить: приводят
пригодный: пригодной пригодную пригодным
прийтись: пришлось
приливный: приливными
примерно: примерно
приспособить: приспособленным
прогнозирование: прогнозирования
программа: программа программу
прогреть: прогретом
производство: производства
произволить: произволить
произойти: произошла
происхождение: происхождения
проксим: проксимы
проникнуть: проникнуть
противоречие: противоречие
протяжённый: протяженным
проходить: проходит
прохождение: прохождение
процесс: процесс процессе процессы
проявить: проявить
пуск: пуск
путь: пути путь
путём: путем
пыль: пыли пыль пылью
пёс: пса
работа: работу работы
радиодиапазон: радиодиапазон радиодиапазоне
радиоструить: радиоструи
раз: раза
различный: различные
разный: разным
разрабатывать: разрабатывать
разредить: разреженную
разрешение: разрешением
ракета: ракеты
расположить: расположенная расположенного
распыление: распылении
распылять: распылять
рассеиваться: рассеивается
расстояние: расстоянии расстояниях
растянутый: растянутым
расчёт: расчеты
редкий: редкое
режим: режим
результат: результатов результаты
релятивистский: релятивистских
репозиторий: репозитория
ресурс: ресурсов
родительский: родительской
розетта: розетты
рукав: рукава рукавом
сам: само
самый: самый
сближение: сближения
сблизиться: сблизиться
сбор: сбора
сверхмассивный: сверхмассивная сверхмассивной сверхмассивные сверхмассивных
светимость: светимости светимостью
светиться: светится
световой: световых
свободный: свободный
свой: своему свои своих
связь: связи
сделать: сделать
себя: собой
семичасовой: семичасового
сентябрь: сентября
сила: силами
сильно: сильно
сильный: сильные
система: системе
ситуация: ситуация
сквозь: сквозь
скопление: скопления
скорость: скоростью
слабый: слабым
слева: слева
следовательно: следовательно
слиться: сольются
слияние: слияния
служба: службы
смотреть: см
снимок: снимке снимки
собрат: собратья
собственно: собственно
согласно: согласно
согревание: согревания
согреть: согреет
содержание: содержания
содержать: содержат содержащей
содержаться: содержится
созвездие: созвездии
создание: создания
создать: создать
солнечный: солнечное солнечной солнечные
солнце: солнца
сон: сна
соответствовать: соответствует
состав: состав
составной: составное
состоять: состоящего состоящее
сотрудничество: сотрудничестве
сохранять: сохраняют
спектр: спектре
спиральный: спиральная спиральные спиральным спиральных
спокойный: спокойна
способный: способно
справа: справа
спускать: спускаемого спускаемый
спутник: спутники
сравнение: сравнению
сравнительно: сравнительно
среди: среди
срок: сроке
стадия: стадии
сталкиваться: сталкивающиеся
старт: стартом
стать: станут
статья: статье статьи
стержень: стержни
сто: сто
столетие: столетий
столь: столь
сторона: сторон стороны
стрелец: стрелец
струить: струи
структура: структуру структуры
струя: струй струями
существование: существования
считаться: считается
также: также
такой: таких
таяние: таяние
таять: таять
телескоп: телескоп телескопа телескопом
темп: темпами темпы
температура: температур температура температуры
теория: теорией
тепло: тепло
теплообмен: теплообмен
терраформирование: терраформирование терраформированием
течение: течение
тип: типу
тот: тому
точечный: точечным
траектория: траектории
треугольник: треугольника
три: трех
тяжёлый: тяжелой
увеличить: увеличенный увеличит
удалённый: удален
ударный: ударные
удаться: удастся
удешевлять: удешевляет
узнавать: узнаваемых
указывать: указывает
улавливать: улавливаемое улавливать
уплотнить: уплотнить
упрощать: упрощает
усиление: усиления
условие: условия
усовершенствование: усовершенствования
успех: успех
успешно: успешно
устойчивый: устойчивый
утверждаться: утверждается
уход: уходом
участвовать: участвуют
учёный: ученые ученых
уэбба: уэбб уэбба
февраль: февраля
фильтр: фильтре фильтров
форма: форму
формирование: формирование формировании формирования
фотоматериал: фотоматериалов
фотосинтез: фотосинтезом
фотосинтетический: фотосинтетическую
фрагмент: фрагмент
французский: французской
хаббнуть: хаббла
цветной: цветного
цель: цели целью
центавро: центавра
центр: центров
центральный: центральные центральным
частица: частиц частицы
часто: часто
частота: частоте
часть: часть
человек: людей человека
черта: черт
число: числе
чурюмов: чурюмова
чёрный: черная черной черные черных
шанс: шансов
шапка: шапки шапок
швассман: швассманом
эдвин: эдвина
экзопланетный: экзопланетную
экономически: экономически
экстремальный: экстремальных
электромагнитный: электромагнитном
эллиптический: эллиптическая эллиптические эллиптических эллиптической
этап: этап
этот: эта этих
эффект: эффекта
юпитер: юпитера
явление: явление
являться: является
ядерный: ядерных
ядро: ядре ядро ядром
яйцо: яйцом
яркий: ярким
ярко: ярко
