австрия: австрии
автоматически: автоматически
автор: авторов авторы
агент: агентом
активность: активности
алексей: алексей
америка: америке
аномальный: аномальные
аппаратура: аппаратурой
архив: архив архивах
астероид: астероидов
астроном: астрономов
астрономия: астрономии
астрофизик: астрофизиков
атлантика: атлантики
атмосфера: атмосферах
атмосферный: атмосферных
благодарить: благодарю
блеск: блеска
близкий: ближе
болометрический: болометрическая
больший: большие
британский: британских
будущее: будущем
буря: бурей бури
быстро: быстро
быстрый: быстрых
валерий: валерий валерия
васильев: васильев васильева
ваш: ваше
век: века веке
великий: величайшим
вероятность: вероятность
верхний: верхнего верхней верхнем верхние
вести: ведет вести
видеть: видели
видимый: видимого
виток: виток
вовсе: вовсе
воздействовать: воздействовать
возможно: возможно
возможность: возможность
возможный: возможного
возмущение: возмущениям
возникать: возникают
волна: волн
вопрос: вопрос
вполне: вполне
временной: временной
время: времени время
всплеск: всплески
вспышечный: вспышечного
вспышка: вспышек вспышка вспышками вспышках вспышки вспышку
всё: всё
выборка: выборки
выброс: выброс выбросы
вывод: выводами выводу
выдать: выдало
вызвать: вызвала вызвать
вызывать: вызывать
выполняться: выполняется
высокий: высокой
высокочувствительный: высокочувствительным
вычислить: вычисленная вычисленного
гамма: гамма
гарантирование: гарантирования
гелиоцентрический: гелиоцентрическую
генерация: генерации
геомагнитный: геомагнитные геомагнитный
германия: германии
гистограмма: гистограмма
главный: главной
говориться: говорится
год: год года годов лет
годовщина: годовщину
гореть: гори
градус: градусов
граница: границе
гёттингенский: гёттингенского
далёкий: далеком
данные: данным
дать: дала данные
два: двум
действительно: действительно
декабрь: декабря
день: день
десятилетие: десятилетий
десяток: десятков
диапазон: диапазона диапазоне
династия: династия
длина: длин длина
длиться: длящиеся
дмитрий: дмитрия
доказательство: доказательств
допускать: допускают
достаточный: достаточной
достигать: достигает
дотянуть: дотянула
доходить: доходит доходить
дракон: дракона драконов
друг: друг друга другом
другой: другие другим других
дюжина: дюжина
европа: европе
едва: едва
жизнь: жизнь
житель: жителей
журнал: журнале
жёсткий: жесткого
зависеть: зависит
зависимость: зависимость
закон: закон закону
заметить: замечена
заметно: заметно
заниматься: занимались
запуск: запуска
запустить: запущен
зарактеристика: зарактеристикам
зарегистрировать: зарегистрировали зарегистрирована зарегистрированный зарегистрировано
зарождение: зарождение
застать: застать
затем: затем
звезда: звезд звездах звезды
звёздный: звездные звездных
зелёный: зеленая зеленые
земля: земле
земной: земных
зимин: зимина
знаменитый: знаменитую
знать: знаем
зона: зоне
зонтальный: зонтальная
излучение: излучение излучения
изменение: изменениям
измерение: измерения
измерить: измеренная
изотоп: изотопам изотопов
именно: именно
иметь: иметь имеют
иностранный: иностранным
институт: института
интегральный: интегральной
интенсивный: интенсивных
интерес: интерес
интересно: интересно
интересовать: интересующей
информация: информации информацию информация
иоганн: иоганна
исключить: исключить
использовать: использовали
испортить: испортило
исследование: исследования
история: историю
итог: итоги
каденция: каденцией
канаверал: канаверал
катаклизм: катаклизмы
катастрофический: катастрофические
квадрат: квадраты
квадратичный: квадратичная
кеплер: кеплер кеплера кеплером
кит: кита
кластеризация: кластеризации
км: км
количество: количество
коллега: коллег коллеги
коллектив: коллектив
команда: команды
комментарий: комментариев
конец: конца конце концов
конкретный: конкретных
континент: континентов
концентрация: концентрациях
кончина: кончины
король: короли
корона: короны
корональный: корональные корональный
короткий: короткое
космический: космической
космогенный: космогенным космогенных
космос: космосе
который: которая которые который которых
край: крае краю
кристофер: кристофер
крупный: крупных
кто: кому
кумулятивный: кумулятивное
кэррингтон: кэррингтон кэррингтона кэррингтону
кэррингтоновский: кэррингтоновской
лебедь: лебеди лебедя
левин: левин
лежать: лежала
лента: лента
линия: линии линий линия
лир: лиры
любитель: любителя
магнитная: магнитной
магнитный: магнитные магнитных
макс: макса
максимум: максимум максимумы
мало: мало
малый: меньшим
март: марта
масса: массы
массивный: массивными
масштаб: масштаба
маундёр: маундера
медицинский: медицинские
медленный: медленней
международный: международный
менее: менее
менять: меняет
меняться: меняется
мера: мере
место: месте место
механизм: механизмы
миллиард: миллиарда
миллион: миллионов
минимум: минимум минимумы
минута: минут
многоканальный: многоканальной
мониторинг: мониторинг
мочь: мог могут можем
мощность: мощности мощность мощностью
мощный: мощнее мощной мощный
мпикс: мпикс
мы: нам
мыс: мыса
мягкий: мягкого
наблюдать: наблюдал
наблюдение: наблюдение наблюдений наблюдения
надёжность: надежности
называть: называемые называемый называть называют
напомнить: напомню
напоследок: напоследок
нарушить: нарушившей
насколько: насколько
насчёт: насчет
наука: науки
начало: начале начало
наш: наша наше нашего наших
независимо: независимо
незначительно: незначительно
необычный: необычное
неопределённость: неопределенность
непрерывный: непрерывный
неприятный: неприятны
несколько: нескольких несколько
нижний: нижнем
низкий: низкой
нм: нм
новостной: новостная
новый: новое новые новый
ноябрь: ноября
нужно: нужно
нужный: нужное нужном
оба: обе
обладать: обладают
обнародовать: обнародовал
обнаружить: обнаруженными обнаружено
обработка: обработка
образ: образом
обратный: обратная
обсерватория: обсерватории обсерватория
обследовать: обследованных
обсуждать: обсуждаемой обсуждают
общество: общества
общий: общее общей
объявить: объявить
объяснение: объяснение
обязательно: обязательно
ограничение: ограничение
один: одна одно
однако: однако
одновременно: одновременно
ожидание: ожидания
означать: означает
оказаться: оказалось оказался
окрестность: окрестностях
округлить: округленная
октябрь: октября
оно: оно
орбита: орбиту
орбитальный: орбитальной
оснастить: оснащен
основа: основой
основать: основанных
оставить: оставила
отличие: отличие
отнюдь: отнюдь
отозваться: отозвались
оценить: оценить
оценка: оценки оценок
очень: очень
ошибка: ошибок
падать: падает
падение: падения
передний: переднем
переживать: переживает
пережить: пережило
перезамыкание: перезамыканий
период: период периоды
периодический: периодическим
письмо: письмо
плазма: плазмы
плазменный: плазменных
планетарный: планетарного планетарной
планк: планка
повезти: повезло
поверхностный: поверхностными
подобный: подобные
подсчёт: подсчет
позади: позади
позволить: позволили
поиск: поиск поиска
показатель: показателем показатель
показать: показать
показывать: показывает показывают
поле: полей
полмиллиона: полмиллиона
полоса: полоса
получить: полученная полученные
полярный: полярных
понятно: понятно
понять: поняты
попросить: попросил
порождать: порождать
порядок: порядка порядки порядок
последний: последнего последнее
последовательность: последовательности
потенциально: потенциально
потребоваться: потребуется
появиться: появившейся
праздный: праздный
превысить: превысило
превышать: превышает
предел: пределе
предполагать: предполагаемой
предпринять: предприняли
представить: представлены
представление: представление
предшественник: предшественников
прежде: прежде
прекратить: прекратил
приближаться: приближается
приблизительно: приблизительно
привести: приведенным
приводить: привожу
пример: примером
принять: принято
прислать: пришли
притяжение: притяжением
причина: причиной
пришествие: пришествие
проанализировать: проанализировали
проблема: проблемы
проводиться: проводились
прогноз: прогнозов
прогнозировать: прогнозируемые
проект: проект
произойти: произойти произошла произошло
происходить: происходило происходит
прокомментировать: прокомментировать
пропорционально: пропорционально
просто: просто
протон: протонов
прошлый: прошлой
прямой: прямые
психологиеский: психологиеские
пунктирный: пунктирная
пятно: пятен пятна
работа: работа работу работы
работать: работать
равный: равен равна равным
рад: рад
радиоастрон: радиоастрон
радиовсплеск: радиовсплесках
развиваться: развиваются
разгон: разгон
разрешение: разрешением
ранний: раньше
распределение: распределение распределения
рассчитать: рассчитанное
реакция: реакции
реальный: реальной
регистрировать: регистрировал
регулярный: регулярный регулярными
результат: результате результаты
реконструкция: реконструкций
релевантный: релевантна
рентген: рентгена
репрезентативный: репрезентативна
рис: рис
ричард: ричард
родственный: родственные
рождать: рождают
рождение: рождения
рост: ростом
ряд: ряд
сам: самой
самый: самым самых
светило: светило
светить: светил
свечение: свечение
свой: свое своей свои своим своих
свыше: свыше
связь: связи
северный: северной
сентябрь: сентября
середина: середине
сильно: сильно
сильный: сильнейшей сильные сильных
система: системы
систематический: систематическое
сияние: сияний
следовательно: следовательно
следующий: следующий
слово: слову
сложный: сложны
слой: слое слои
служить: служит
случайно: случайно
случиться: случившихся
смотреть: см
собранный: собранной собранных
собрать: собранная
событие: событие событием событий события событиями
современный: современный
согласно: согласно
содержать: содержали
созвездие: созвездии созвездий
солнечный: солнечного солнечной солнечные солнечный солнечных
солнце: солнца солнце солнцем солнцу
сообщение: сообщение
сообщить: сообщил
сопоставимый: сопоставимыми
составлять: составляет
состоять: состоит
сотня: сотни
сотрудник: сотрудника
специалист: специалистов
способность: способности
способный: способным способных
способствовать: способствовать
спутник: спутниками
сравнительно: сравнительно
сравнить: сравнить
среди: среди
среднее: среднем
статистика: статистика статистике
статистический: статистическая статистического
стать: ставшей стало стать
статья: статье статьи
степенной: степенной степенному
степень: степени
столетие: столетие столетий столетия
сторона: стороны
страх: страхов
стрёма: стреме
суммарный: суммарная
супервспышка: супервспышек супервспышка супервспышками супервспышки
считать: считать
считаться: считается
сша: сша
также: также
такой: такая такие таким такими таких такого
тау: тау
телеграфист: телеграфистам
телеграфный: телеграфной
телескоп: телескоп
температура: температура температурами
тенденция: тенденцию
тепло: тепло
технический: технических
течение: течение
тип: типа
типичный: типичную
тот: тому
точность: точностью
точный: точная
трансформация: трансформаций
трв: трв
тропический: тропической
трудно: трудно
турбулентность: турбулентностей
тысяча: тысяч тысячу
уважаемый: уважаемый
уверенность: уверенностью
ударить: ударить
указывать: указывает
уникально: уникально
упомянуть: упомянуть
установить: установить
факел: факела
физический: физическим
финляндия: финляндии
фонд: фонд
форма: формы
фотометр: фотометр фотометром
фотометрия: фотометрии фотометрию
франция: франции
функция: функция
хватать: хватает
ходжсон: ходжсон ходжсона
хотя: хотя
хромосфера: хромосфере
целое: целом
цель: целью
частота: частот частота частоту
частотный: частотное
чей: чья
четырёхлетний: четырехлетние
читатель: читателей
чёрный: черная черные
шаг: шагов
шанс: шансов
шторм: шторм
экзопланета: экзопланет
экстраполяция: экстраполяция
экстремальный: экстремальных
электрон: электронов
электронвольт: электронвольт
энергетический: энергетического
энергичный: энергичная
энергия: энергией энергии энергия энергиями
эрг: эрг
этот: эта
эффективный: эффективными
являться: является являются
ядерный: ядерные
язык: языке
япония: японии
яркий: яркое
яркость: яркости яркость
