агентство: агентство
азиатский: азиатские
аккреционный: аккреционный
аккреция: аккреция
активный: активного активных
алгоритм: алгоритма
алексей: алексей
альтернативный: альтернативная
американский: американское
апач: апачи
аргон: аргон аргоном
архив: архива
архивный: архивным
аспирантка: аспиранткой
астероид: астероиде
астроновость: астроновости
астроном: астроном астрономов астрономы
астрономия: астрономии
астрофизик: астрофизики
астроёлочка: астроёлочка
атмосфера: атмосфера атмосферах атмосфере атмосферы
бабочка: бабочка
барон: бароном
бенна: бенну
берк: берк
берто: берто
бетельгейза: бетельгейзе
библиотека: библиотеки
блеск: блеска
ближний: ближний
близкий: ближайшие
блок: блоков
блокировать: блокировали блокирующее
бо: бо
богатый: богатая
боде: боде
больцони: больцони
большинство: большинства
большой: большого большом
будущее: будущим
будущий: будущие
бурый: бурые
буря: бури
быстро: быстро
быстрорастущий: быстрорастущий
варьировать: варьирует
вверх: вверх
вверху: вверху
ввиду: ввиду
величина: величину
венера: венеру
вероятно: вероятно
версия: версия
верхний: верхняя
вершина: вершине
весь: всей
весьма: весьма
ветер: ветром
вещество: вещества вещество веществом
взаимодействие: взаимодействии взаимодействия
взрыв: взрыв взрыва
вид: вид
видеть: видели видеть видим видят
видимый: видимом видимому
визуализация: визуализации
вилсон: вилсон
включая: включая
вместе: вместе
вместо: вместо
внеземной: внеземной
внешний: внешний
вниз: вниз
внизу: внизу
водород: водород водорода водородом
возможно: возможно
возможность: возможности
вознамериться: вознамерились
возникать: возникают
возраст: возраста
вокруг: вокруг
волна: волн
вольтер: вольтера
вольфганг: вольфганг
восстановление: восстановлению
вращаться: вращаться
время: временем времени время
вспышка: вспышек
встречаться: встречается
второй: второй
вулканический: вулканическим
выборка: выборке
выброс: выброс выброса
выбросить: выброшенным
выглядеть: выглядело выглядит выглядящий
выдать: выдать
вызвать: вызвавшая
выполнить: выполнены
вырожденный: вырожденным
высвободить: высвободила
высокий: высоким высоких
вытягивать: вытягивающей
выявить: выявить
выяснить: выяснить
газ: газа газом
газовый: газовое
газообразный: газообразный
галактика: галактик галактика галактике галактики
галифакс: галифакс
гаффнить: гаффни
гейзер: гейзерами
геологически: геологически
германия: германии
германский: германской
гибель: гибель
гигант: гигантами
гигантский: гигантский
гипергигант: гипергигант
глаз: глаза глазами
говорить: говорит
год: года годами году лет
головоломка: головоломки
гора: горы
горение: горения
горячий: горячее
готовиться: готовится
гравитационный: гравитационное
гравитация: гравитации
градус: градусов
графика: графика
группа: группа группой группы
давление: давление
далеко: далеко
далёкий: далекий
данные: данных
дать: данные
два: две двух
двойной: двойной
действие: действием
дейтерий: дейтерия
декабрь: декабрю
дело: деле
демонстрировать: демонстрируют демонстрирующих
десятимесячный: десятимесячный
детализация: детализацией
деталь: детали
детально: детально
джеймс: джеймс джеймса
джорджия: джорджия
диапазон: диапазонах диапазоне
диск: диск
длина: длинах
длительно: длительно
довольно: довольно
доказательство: доказательств
дополнительный: дополнительных
достигнуть: достичь
доцент: доцентом
др: др
драматичный: драматичнее
друг: друг друга другом
дыра: дыр дыра дырой дыры
европейский: европейской
железо: железо железом
жизнь: жизни
завершаться: завершаться
зависимость: зависимости
закрывать: закрывавшими
заметно: заметно
занимать: занимает
заниматься: занималась занимающаяся
запросить: запросить
запустить: запустил запущенного
заставлять: заставляет
затем: затем
затемнение: затемнения
затемнить: затемненным
затмение: затмение
затухание: затухание затуханий затухания
зафиксировать: зафиксирована
захватить: захватил
звезда: звезд звезда звездой звезду звезды
звёздный: звездная звездного звездной звездную звездный
земля: земли
земной: земной
зеркало: зеркал
зеркальный: зеркальными
значит: значит
значительно: значительно
золотой: золотым
зонд: зонд
зрение: зрения
идентичный: идентичных
извержение: извержение
известно: известно
известный: известной
излучать: излучают
излучение: излучении излучения
изменение: изменения
изображение: изображение изображения
изучать: изучать
изучение: изучением
именно: именно
иметь: имеет
имитировать: имитирующую
индекс: индекс
институт: института
инструмент: инструментов
интеграл: интеграл
интенсивность: интенсивностью
интересный: интересна
инфракрасный: инфракрасную инфракрасный инфракрасным
ио: ио
исключение: исключением
исключительно: исключительно
использование: использованием
использовать: использовала использующий
исследование: исследованием исследований исследования
исследователь: исследователей исследователи исследователям
источник: источника источников
каждый: каждом каждые
какой: каким
калифорния: калифорнии
кальций: кальцием кальций
камера: камера камеру
канада: канада
карлик: карлик карлика карлики карликов карликом
квадратный: квадратных
квазар: квазар
кеплер: кеплера
килоновый: килоновая
китай: китай
китайский: китайские
км: км
колебание: колебания
колебаться: колеблется
коллапсировать: коллапсировать коллапсируют
команда: команда команды
компактный: компактного компактный компактным
компаньон: компаньон компаньона компаньоном
компьютерный: компьютерные
конец: конце концу
коричневый: коричневого коричневые коричневый коричневым коричневых
космический: космический космическими космического космической
космос: космос
костантино: костантино
который: которая которого которые который которых
крабовидный: крабовидной
крайне: крайне
красный: красный
кремний: кремнием кремний
кривая: кривая кривой кривые
крошечный: крошечных
крупный: крупнейших крупных
кудрить: кудря
кэв: кэв
кэтрин: кэтрин
лебедь: лебедя
либо: либо
лимб: лимбом
линия: линии
лишь: лишь
луна: луны
луч: лучах
льшать: льшая
льшуя: льшую
любитель: любитель
магелланов: магелланова магеллановом
магнитный: магнитных
май: мае
макс: макса
маленький: меньше
малый: малой
масса: масса массы
массив: массива
массивный: массивна массивной массивные массивных
матрица: матрицы
маунт: маунт
медленный: медленного медленному
межзвёздный: межзвездном
мексико: мексико
мелкий: мелкие
менее: менее
меняться: менялся
мера: мере
место: место
метан: метан метана
микрокалориметрический: микрокалориметрический
минимум: минимума
мир: мир
миссия: миссия
мкм: мкм
млечный: млечного
многий: многих
модельный: модельного
модуль: модулями
молекула: молекула
монард: монард
мониторинг: мониторинга
мочь: могут
мощный: мощное мощный мощных
мур: мур
мы: нам
мягкий: мягкого мягком
наблюдатель: наблюдателям
наблюдать: наблюдаемая наблюдать наблюдают
наблюдение: наблюдений наблюдения наблюдениях
нагрев: нагревом
нагрузка: нагрузка
называть: называемой
накопить: накоплена
намерить: намерена
намного: намного
наподобие: наподобие
например: например
насколько: насколько
наслать: нашли
наука: науке
находиться: находится находятся
нацелиться: нацелился
начинать: начинаем начинают
наш: нашей
небесный: небесных
небо: неба небе
небольшой: небольшой
недавний: недавнее
недозвезда: недозвезд недозвезде
недостаточный: недостаточной
недреманный: недреманное
нейтронный: нейтронная нейтронной нейтронные нейтронных
некоторый: некоторыми
необычный: необычного
непохожий: непохожая
неровный: неровной
несмотря: несмотря
неспокойный: неспокойное
нижний: нижней нижних нижняя
новогодний: новогодний
новость: новостей
новый: новая нового новое новой новый
нормальный: нормальной
нормировать: нормированной
нью: нью
оба: обе
обеспечивать: обеспечивающий
обзор: обзор
обладать: обладает
облако: облака облаками облаке облако
область: области
обнародовать: обнародованном
обнаружить: обнаруженный обнаружены обнаружив обнаружил обнаружит обнаружить
образование: образование образованием образования
образовать: образовав образовало
образоваться: образовалось
обсерватория: обсерватории обсерваторию обсерватория
общество: общества
общий: общая
объединить: объединенные
объект: объект объекта объектах объектом объекты
объявить: объявили
объяснение: объяснение
объяснить: объяснить
обычно: обычно
обычный: обычного
огромный: огромное огромные огромный
один: одна одного одном
однако: однако
ожидать: ожидаемой ожидали
оказаться: окажется
око: око
около: около
окончание: окончания
окружение: окружение
окружность: окружности
омар: омара
оно: оно
опубликовать: опубликована
опыт: опыту
орбита: орбита орбитами орбите
оставаться: остается
оставить: оставила
оставлять: оставляемыми оставляет
остаток: остатках остатки остатков остатком остаток
остаться: оставшийся
отличие: отличие
отметить: отметил отмечены
охладиться: охладилось
оцениваться: оценивается
очень: очень
ошибка: ошибки
панель: панели панель панелях
пара: пары
партнёр: партнера
пекинский: пекинского
первый: первые первый
пережить: пережила
переход: переходом
период: период
периодический: периодические
пзс: пзс
пик: пики
пиксель: пикселя
плавно: плавно
плавный: плавное
плазма: плазмы
планета: планетами
планк: планка
плотный: плотной
поведение: поведение
поверхностный: поверхностная
поверхность: поверхности поверхность
повторяться: повторяющиеся повторяющуюся
поглощать: поглощает
поглощение: поглощения
поддерживаться: поддерживается
подобный: подобное подобный подобных
подробный: подробные
подтвердить: подтверждено
подходить: подходит
позволять: позволяет позволяют позволяющая
пойнт: пойнт
пока: пока
показать: показали показан показана показаны показать
показывать: показывает показывают
поколение: поколения
покрытие: покрытием
поле: поле полей полем
полезный: полезная
полмиллиона: полмиллиона
полный: полной полный
полоса: полосе
получать: получать
получение: получения
получить: получена полученном полученные полученный получены получил получила
полюс: полюсах
полярный: полярного полярное полярные полярных
поместить: поместить
помочь: помогут
помощь: помощи помощью
поперечник: поперечник
портрет: портрет
порядок: порядка
поскольку: поскольку
последний: последние последняя
последовательность: последовательность
последствие: последствия
постепенный: постепенное
потемнение: потемнения
потребоваться: потребовались
потускнеть: потускнела
превышать: превышает
предположить: предположили предположить
представиться: представился
представление: представлениям
предстать: предстал
предыдущий: предыдущими
прежде: прежде
прежний: прежней
прибор: прибор
пригодный: пригодные
признак: признак признаками признаком
приливный: приливное
примерно: примерно
примечательно: примечательно
примечательный: примечательными
природа: природу
присутствие: присутствие присутствия
приходиться: приходится
причина: причиной причину
причём: причем
провести: проведенные
программа: программы
продемонстрировать: продемонстрировать
продолжать: продолжали
проект: проектом
произойти: произошел
происходить: происходил происходит
промежуточный: промежуточной
пропасть: пропавшие
пропускание: пропускания
просто: просто
пространство: пространстве
протекать: протекать
протяжение: протяжении
процесс: процесс
прочий: прочими
прошлое: прошлого
прояснение: прояснений
прояснить: прояснить
прямой: прямых
пульсар: пульсар пульсара
путь: пути
пылевой: пылевыми пылевых
пятый: пятого
пять: пять
работа: работу
работать: работает работать работающих
равновесие: равновесие
радиус: радиус
разгадка: разгадка
разглядывать: разглядывать
размер: размеры
разрешение: разрешение разрешением
разрешить: разрешить
разрушение: разрушение
раковина: раковин
ранее: ранее
ранний: раньше
расположить: расположена расположенного расположенной расположены
рассеивание: рассеивания
рассеиваться: рассеивается
рг: рг
реакция: реакции
реалистичность: реалистичность
реальный: реальном
регулярный: регулярные
резко: резко
результат: результате результаты
реконструировать: реконструированные
рекорд: рекорд
рентгеновский: рентгеновские рентгеновский рентгеновских рентгеновского рентгеновское рентгеновской рентгеновском рентгеновскую
российский: российской
рукав: рукаве
руководить: руководил руководят
сам: самого самом
самоподдерживающийся: самоподдерживающиеся
самый: самых
сатурн: сатурна
сверхновый: сверхновая сверхновой сверхновую сверхновых
сверхплотный: сверхплотное
свет: свет света свете
светимость: светимость
светиться: светиться
световой: световых
свидетельство: свидетельства
своеобразно: своеобразно
свой: своего своей свои
связанный: связанные связанным
связка: связке
сделать: сделанные
семь: семь
сентябрь: сентябре
сера: сера
серый: серой серым
сжатие: сжатия
сигизмонди: сигизмонди
сильный: сильного
симон: симоне
система: системе системы
сияние: сияние сияний сияния
скопление: скопления
скорректировать: скорректированные
скрытый: скрыт
слева: слева
след: следы
следить: следящий
слияние: слияния
случай: случае случай
смотреть: см
смочь: смогли
снижение: снижение
снимок: снимке снимки снимков
снова: снова
собрат: собрата
собственный: собственной собственным
событие: событие события событиями
совпасть: совпал
современный: современным
согласиться: согласились
согласно: согласно
созвездие: созвездии
создать: созданные
солнечный: солнечной солнечный солнечным
солнце: солнца
сомнительный: сомнительна
соответствие: соответствие
соответствовать: соответствующая
соответствующий: соответствующие
сопоставлять: сопоставляя
соседний: соседней
состав: составу
составить: составлен
составлять: составляет
состояние: состояния
состоять: состоит
сотрудничество: сотрудничестве
спектр: спектр спектра спектре спектром
спектральный: спектральной
спектрография: спектрографии
спектрометр: спектрометр
спектроскопический: спектроскопические
спектроскопия: спектроскопии
специализировать: специализированные
специальный: специальную
спиральный: спиральном
список: списке
справа: справа
спутник: спутника спутнике спутники спутников
сравнение: сравнению
сравниваться: сравнивается
сталкиваться: сталкивается
стать: стала стало
статья: статье статья
стивенсон: стивенсон
столкновение: столкновения
столь: столь
сутки: суток
существование: существование существованием существования
существовать: существовать
сходить: сходят
сценарий: сценариев
считать: считают
счёт: счет
также: также
такой: такими
телескоп: телескоп телескопа телескопе телескопов телескопы
темно: темно
температура: температура температуре температуры
тепло: теплом
термоядерный: термоядерного термоядерные
тестовый: тестовом тестовые тестовых
технический: технической
технология: технологии технологию
томас: томас
тонна: тонны
тот: тех той
точечный: точечный
треть: трети
туманность: туманности
тусклый: тусклого тусклые тусклый
тёплый: теплый
увидеть: увидела увидели
угасать: угасает
удаляться: удалялось
удалённый: удаленной удаленный
удаться: удалось
удельный: удельной
удивить: удивили
узкий: узким
указывать: указывают
улика: улики
уменьшаться: уменьшается
университет: университета
уран: уран
установка: установка
установленный: установленной
уточнение: уточнение
утратить: утратила
участие: участии
учёный: ученые ученых
учёт: учетом
уэбба: уэбб уэбба
фабьеном: фабьеном
факт: фактов
физика: физики
фольманна: фольманн
форма: формой формы
формироваться: формирующимся
фотометрический: фотометрические фотометрического
фотосфера: фотосфера
характерный: характерным
хастак: хастак
холодный: холоден
цвет: цветом
цветовой: цветовая цветовой
целое: целом
центральный: центральной
цефея: цефея
цикл: циклов
чандра: чандры
час: часов
частица: частиц
часто: часто
часть: части часть
четвёртый: четвертое
чёрный: черная черной черные черным черных
шанхайский: шанхайского
шепард: шепард
шесть: шести
широкий: широкое широчайшим
широкополосный: широкополосного
широкоугольный: широкоугольный
шкала: шкала
штат: штата
щит: щита
эв: эв
эволюция: эволюцию
эйнштейн: эйнштейна
экзолуна: экзолуны
экзопланета: экзопланеты
электромагнитный: электромагнитного
электронный: электронным
эмиссия: эмиссию эмиссия
энергетический: энергетическое
энергия: энергии энергий энергию энергиями
энцелада: энцелада
южноафриканский: южноафриканский
южный: южной
юпитер: юпитер юпитера
являться: является
явный: явный
ядро: ядра ядрах ядро
японский: японское
яркий: яркий ярких яркого
яркость: яркости яркость яркостью
