агентство: агентства
активно: активно
активный: активных
алексей: алексей алексея
амай: амая
анализ: анализ
анализировать: анализировать
андромеда: андромеде андромеды
аппарат: аппарат аппарата аппаратом
астероид: астероид астероиде астероидов
астроновость: астроновости
астроном: астрономам астрономов астрономы
астрономический: астрономические астрономический астрономических
астрофизик: астрофизики
атакамский: атакамской
атмосфера: атмосфера атмосферах атмосферу атмосферы
атмосферный: атмосферных
бабочка: бабочка
базироваться: базирующихся
базовый: базовые
бак: бак
бар: бар
белый: белый
бенна: бенну
бесчисленный: бесчисленного
блестящий: блестящих
ближний: ближнем
близкий: близкой
близко: близко
боде: боде
больший: большей большие
большой: большого большой
борт: борту
буря: бури
быстрорастущий: быстрорастущий
быстрый: быстрый быстрым
быть: будут
вблизи: вблизи
вверху: вверху
век: века
вероятный: вероятные
верхний: верхней
весь: всей всему вся
весьма: весьма
ветер: ветер ветра ветров ветром
взаимоотношение: взаимоотношения
взгляд: взгляд
взглянуть: взглянуть
взяться: взялись
вид: виде
видеть: видеть
видимый: видимого видимом
визуализация: визуализация
вилсон: вилсон
внеземной: внеземных
внимание: внимание
внутренний: внутреннюю
водяной: водяного
воздушный: воздушных
возле: возле
возможно: возможно
возможность: возможности
возраст: возрасту
вокруг: вокруг
волна: волн волны
вопрос: вопросов вопросы
вращаться: вращающийся
вращение: вращение вращения
время: времени время
вселенная: вселенная вселенной вселенную
встречаться: встречаются
всё: всё
выборка: выборки
выброс: выбросы
вывести: выведен
выглядеть: выглядеть выглядят
выделяться: выделяется
вызывать: вызывает
выйти: выйдет
выпуск: выпуске выпуском выпуску
выпускать: выпускают
высокий: высочайшей
вытянутый: вытянуты
гавайи: гавайях
газовый: газовых
галактика: галактик галактика галактике галактики галактику
галактический: галактических
гелиоцентрический: гелиоцентрическую
гигант: гигантом
гикеан: гикеан
гипотеза: гипотез
гистограмма: гистограмма
глаз: глазом
глубокий: глубже
глыба: глыбы
год: год года годах году лет
гора: горе
горячий: горячий
готовиться: готовиться готовятся
гравитация: гравитация
далеко: далеко
дальнейший: дальнейшие
далёкий: далекая далекие далеких
данные: данным данными данных
данный: данного
дать: данные даст дать
два: двух
двигаться: движущийся
движение: движения
двойник: двойник
двойной: двойной двойных
двумерный: двумерное
декабрь: декабря
делать: делает
дело: деле дело
день: день
депаскуале: депаскуале
десятилетие: десятилетие
десятилетний: десятилетняя
десяток: десятков
десять: десяти
детализация: детализацией
детально: детально
детальный: детальная детальный
джеймс: джеймс
джозеф: джозеф
диаметр: диаметр
диапазон: диапазона диапазонах диапазоне
динамика: динамике
диск: диске
длина: длин
длинноволновый: длинноволновых
длительный: длительного
длиться: длится
добавить: добавлены
добавлять: добавляет
долгий: долгое
должный: должно
дополнительно: дополнительно
достигать: достигает
достигнуть: достичь
друг: друг другом
другой: другие другим других
дуть: дул
дыра: дыр дыра дырами дырой
европейский: европейского
единица: единиц
журнал: журнала
завершить: завершена завершил
загадка: загадка загадку
задворки: задворках
заметный: заметнее
занятый: занятый
запечатлеть: запечатлена
запланировать: запланированной
запуск: запуска
заставлять: заставляют
зафиксировать: зафиксирован
захоронение: захоронения
звезда: звезд звезда звезде звездой звезды
звёздный: звездная звездного звездном звездных
зелёный: зеленая зеленый
земля: земли
земной: земной
знаковый: знаковая
значительно: значительно
золотистый: золотистый
играть: играют
идеально: идеально
идея: идеи
известный: известная известной известные
излучать: излучают
излучающий: излучающий
излучение: излучения
изменение: изменения
измерение: измерения
измерять: измеряют
изначально: изначально
изображение: изображение изображением изображений изображения
изучать: изучать
изучение: изучение
именно: именно
иметь: имеют
инженер: инженеры
инженерный: инженерная
инозвёздный: инозвездных
инструмент: инструментов
интересный: интересные
информация: информации информацию
инфракрасный: инфракрасного инфракрасном
искажать: искажает
искать: ищут
исключение: исключением
искривление: искривления
использование: использованием
использовать: использует используют
испытание: испытаний
исследование: исследование исследования
исследователь: исследователей
исследовать: исследованных
истинный: истинный
история: истории
к: ко
каждый: каждым
какой: какие каким
каменно: каменно
карлик: карлик
карта: карта карте карту карты
картина: картину
каталог: каталог каталогов
качественный: качественные
качество: качество
квазар: квазар квазаров
квинтет: квинтет
кг: кг
кеа: кеа
класс: класса
км: км
койперо: койпера
количество: количества количествах количество
коллаж: коллаж
кольцо: колец
команда: команда команды
комета: комет кометы
кометный: кометные кометных
короткий: короткий
космический: космический космическим космических космического космическое
космос: космос космоса космосе
который: котором которые который которыми
кроме: кроме
кропотливый: кропотливую
круг: круг
круглый: круглую
крупный: крупному крупных
кудрить: кудря
лагранж: лагранжа
лебедь: лебедя
левин: левина
ледяной: ледяные ледяных
линия: линия
люси: люси
лёд: льда
манёвр: маневры
март: марта
масса: массе массой массу массы
мауна: мауна
маунт: маунт
межзвёздный: межзвездной
менее: менее
месяц: месяцев
метка: метки
метод: методы
микронный: микронных
миллиард: миллиардов миллиарды
миллиметр: миллиметров
миллиметровый: миллиметрового миллиметровом
миллион: миллионов
минимум: минимум
мир: мира мирах
миссия: миссии
млечный: млечного млечном млечный
многие: многие
многое: многое
множество: множества множество
моделирование: моделирование
момент: момент момента
мочь: могла могут
мы: нам
наблюдать: наблюдаемая наблюдать
наблюдаться: наблюдается
наблюдение: наблюдение наблюдений наблюдения
набор: набору
назад: назад
название: названием
называть: называемая называемые
наиболее: наиболее
найти: найдены
наклонить: наклонены
наличие: наличии
нанометровый: нанометровых
например: например
наслать: нашли
настолько: настолько
настоящий: настоящий настоящим
насчитываться: насчитывается
научный: научная
находиться: находится находятся находящейся
начальный: начальных
наш: наша нашего нашей наши нашим нашу
небесный: небесных
небо: неба
небольшой: невелики
небосвод: небосводе
невероятно: невероятно
невероятный: невероятной
невидимый: невидимых
невооружённый: невооруженным
недавно: недавно
неделя: недель
нейтронный: нейтронная
некоторый: некоторые
необходимость: необходимость
необычный: необычные
несколько: нескольких несколько
неяркий: неяркий
нижний: нижней
низкий: низких
новость: новостей
новый: новая новому новую новые новый новым
номер: номера номере
ночь: ночь
нынешний: нынешнюю
обзор: обзор обзором
область: области областях
обнаруживать: обнаруживала
обнаруживаться: обнаруживались
обнаружить: обнаружена обнаружены обнаружила обнаружить
обозначать: обозначают
обозначить: обозначены
обрабатывать: обрабатывать
обработка: обработка
образ: образом
образовать: образуя
обсерватория: обсерватории
обширный: обширнее обширную обширным
общий: общее общую
объединение: объединению
объект: объект объекта объектах объектов объекты
объявить: объявлено
объяснение: объяснение
объём: объем
овал: овал
один: одна одной одну
одинаковый: одинаковы
ожидаться: ожидается ожидалось
около: около
окончание: окончание
окончательно: окончательно
окружающий: окружающего
окружение: окружение
описывать: описываемые
определить: определить
опубликовать: опубликовано
опустелый: опустел
оранжевый: оранжевого
орбита: орбитах орбиту орбиты
орёл: орла
осенний: осеннюю
основа: основе
основное: основном
основной: основной
оставаться: остаются
остаток: остаток
ответ: ответов
отдалить: отдаленные
отделиться: отделились
отдельный: отдельных
открытие: открытие открытия
отличие: отличие
отметить: отмечена
отметка: отметки
относительный: относительной относительную
отобразить: отображенный
отражать: отражает
отслеживать: отслеживала
отсюда: отсюда
официально: официально
охватить: охвачено
охватывать: охватывающему
оценка: оценки
очерк: очерк
панель: панели
панорамный: панорамное панорамный панорамным
параллакс: параллакса
первый: первые первый
переосмыслить: переосмыслить
пересмотреть: пересмотрены
период: период
песочный: песочные
песчинка: песчинки песчинок
пиксель: пикселей
питать: питаемых
планета: планет планета планете планету планеты
планетарный: планетарные планетарных
планетезималь: планетезималей
планетезимальный: планетезимальных
планетный: планетных
планироваться: планируется
плотность: плотность
пляж: пляже
поглощать: поглощает
подобный: подобные подобных
подробность: подробностей
подробный: подробную
подход: подход
подчёркивать: подчеркивают
позволить: позволило позволит позволят
позволять: позволяет позволяют
поздний: позже
поиск: поиск
показатель: показатели
показать: показав показана
покинуть: покинет
полмиллиона: полмиллиона
полный: полной
половина: половине половины
положение: положения
получить: полученного полученное полученную полученные полученных получены получить
получиться: получился
помочь: помогут
помощь: помощью
понять: понять
посвятить: посвящено
поскольку: поскольку
последний: последнее последнему последние
поток: потоков
потрясать: потрясающий
пояс: пояс пояса поясах поясов поясом
практически: практически
пребывание: пребывания
превосходить: превосходит
превышать: превышает превышающей
предварительно: предварительно
предел: пределами пределах
предмет: предметом
представление: представлении представления
представлять: представляет представляют
предшественник: предшественники
предыдущий: предыдущий
приблизительно: приблизительно
привлекать: привлекала
привычный: привычных
приливный: приливное
применение: применении
примерно: примерно
принести: принесли
природа: природу
причём: причем
провести: проведенное проведены провел
проводить: проводят
программа: программы
продолжать: продолжать
продолжительность: продолжительности
продолжить: продолжит
проект: проекта
происхождение: происхождения
пролетать: пролетающих
промежуток: промежутками
промежуточный: промежуточной
простираться: простираются
пространство: пространства
протопланетный: протопланетных
протяжение: протяжении
проходить: проходят
процесс: процессах процессе
прошлый: прошлом
пузыриться: пузырящаяся
пульсар: пульсары
пунктирный: пунктирная
путь: пути путь
пылевой: пылевые
пыль: пыли
пятый: пятому
работа: работа работу работы
работать: работающая работая
радиус: радиус радиусов
раз: раза
развиваться: развиваются
различаться: различаются
различный: различных
размер: размеров размером
разновидность: разновидность
разнообразие: разнообразие
разрушение: разрушение
рамка: рамках
ранее: ранее
ранний: раннюю
раскрыть: раскрыть
расположение: расположение
распределение: распределение
распространить: распространены
расстояние: расстоянии расстояния расстояниях
расходиться: расходятся
расширить: расширить
реализация: реализации
регион: регион
результат: результате результатов результаты
рекорд: рекорд
решётка: решетки
родительский: родительской
родный: родную
роль: роли
рукав: рукавов
сам: самом
самый: самую самые самый самым самых
сатурн: сатурне
свежий: свежих
сверхмассивный: сверхмассивная сверхмассивными
сверхновый: сверхновая сверхновой
сверху: сверху
свет: свет света
световой: световых
свидетельствовать: свидетельствует свидетельствуют
свой: своей своими своих
свыше: свыше
сделать: сделанных сделано сделать
себя: собой
северный: северной северный
сегодняшний: сегодняшний
сигарообразный: сигарообразный
сигнал: сигнала
символ: символами
синий: синего
система: систем системах системе системы
сиять: сияли
сканирование: сканированию сканирования
скорость: скорость скоростью
скрываться: скрывается
слабый: слабый
следующий: следующих
слияние: слияний
случай: случай
смотреть: см смотреть
смочь: смогут
снимка: снимок
снимок: снимках
собственный: собственного собственной собственным
совместный: совместных
содержать: содержал содержит
созвездие: созвездии
создавать: создавая
создать: создала создать
солнечный: солнечной
солнце: солнца солнцем
соответствовать: соответствует соответствующий
соседка: соседки
состав: состав
составить: составить
составление: составлением
состояние: состояния
сотня: сотен
спасибо: спасибо
спектроскопия: спектроскопии
спектрофотометрия: спектрофотометрии
спираль: спираль
спиральный: спиральная спиральные спиральных
спутник: спутник спутники
сравнивать: сравнивая
среди: среди
сталкиваться: сталкиваются сталкивающихся
становиться: становятся
стать: стал
столетие: столетие
столь: столь
сторона: стороны
странный: странному
стрелец: стрельце
структура: структур структура
структурно: структурно
субмиллиметровый: субмиллиметрового субмиллиметровом
существование: существовании
сформироваться: сформировались
схожий: схожей
считать: считали
считаться: считался
тайна: тайны
также: также
такой: такие таким таких такого
тбайт: тбайт
телелескоп: телелескопа
телескоп: телескоп телескопа телескопе телескопом
тело: тел
температура: температуры
тенденция: тенденция
тестирование: тестирование
технический: технические
течение: течение
тип: типа
топливный: топливный
топливо: топлива
тот: тех той тому
точка: точки
точный: точную точные
транзит: транзиты
триллион: триллиона триллионов триллионы
трлн: трлн
трёхмерный: трехмерную
туманность: туманность
туманный: туманный
увеличить: увеличенных
уверять: уверяют
удаваться: удавалось удается
удалить: удалены
удалённый: удаленных
удаться: удалось
удивительный: удивительные
узнать: узнать
указывать: указывают
улучшаться: улучшаются
ультрафиолетовый: ультрафиолетовом
уместиться: уместившихся
уникальный: уникален уникального уникальными
условие: условий условия
установить: установил установлено
устройство: устройстве
утверждение: утверждению
участок: участков
учёный: ученые ученым ученых
уэбба: уэбб уэбба
финальный: финальную
формироваться: формируются
фотограф: фотограф
фотографирование: фотографирования
фрагментарный: фрагментарных
хаббл: хаббл
хаббнуть: хаббла
характеристика: характеристик характеристиками
хвост: хвосты
ход: ходе
холодный: холодных
художник: художника
хукер: хукера
царить: царить
царство: царство
цвет: цвета
целое: целом
цель: цели
центр: центре центров
центральный: центральная центральной центральный центральных
чандра: чандры
час: час
часть: части часть
часы: часы
чей: чьи
человечество: человечества
четвёртый: четвертом четвертому
чили: чили
число: числе
чувствительный: чувствителен
чёрный: черная черной черными черных
чёткий: четкие
ширина: ширину ширины
широко: широко
эволюция: эволюции
эдвин: эдвин
экватор: экваторе
экзокомета: экзокомет экзокометы
экзокометный: экзокометные экзокометных
экзопланета: экзопланет экзопланета
экзопланетный: экзопланетных
экзотический: экзотических
эксплуатация: эксплуатации
экстремальный: экстремальных
эллиптический: эллиптическая
этот: эта этих
южный: южной
юпитер: юпитер юпитера
являться: является
ядро: ядро
январский: январском
январь: января
яркий: яркий ярких ярче
ярко: ярко
яркость: яркости
ясный: ясную
