австралия: австралии
австранезиец: австранезийцы
автор: авторами авторы
агент: агентом
азия: азии
анализ: анализа анализом
антропологический: антропологические
великий: великих
веркор: веркор
веркора: веркора
верхний: верхнюю
видимо: видимо
видный: видны
википедия: википедия
вирус: вирусов
возможно: возможно
волна: волна
восточный: восточной
вряд: вряд
всякий: всяком
вшить: вшей
выбирать: выбираем выбирает
выделиться: выделились
выйти: вышедшей
выявляться: выявляется
гельфанд: гельфанд
географический: географических
год: лет
головной: головных
гоминид: гоминиды
граница: границу
датировка: датировки
два: двух
двадцатилетний: двадцатилетний
двадцать: двадцать
денисовец: денисовцев
денисовца: денисовцами
династия: династия
дмитрий: дмитрия
днк: днк
дожить: доживи
древний: древней древний древних древняя
животное: животные
жить: жили
заселение: заселения
зимин: зимина
знать: знаем
издательство: издательство
именно: именно
индонезия: индонезии индонезия
иностранный: иностранной иностранным
ископаемое: ископаемые
исследование: исследования исследованиях
исторический: исторических
история: истории
исчезновение: исчезновения
каждый: каждый
кардинально: кардинально
контакт: контактах
косвенно: косвенно
который: которые
кроманьонец: кроманьонцев
лента: лента
лжный: лжно
линия: линии линий линия
литература: литературы
манин: манин
математика: математику
метод: методами методы
метр: метр
мигрировать: мигрировавших
миллион: миллион
минимум: минимум
михаил: михаил
многие: многие
многий: многих
множественный: множественных
мочь: могла могут
музейный: музейных
мышление: мышления
наводить: наводило
надежда: надежды
назад: назад
накатить: накатила
наука: науки
находка: находки
наш: нашими наших
неандерталец: неандертальцев
небольшой: небольших
недавний: недавней
некоторый: некоторых
немного: немного
новостной: новостная
новый: новыми
оба: обоих
обойтись: обошлись
объявить: объявить
ознаменоваться: ознаменовался
окаменелость: окаменелости
океания: океании
они: ними
особенность: особенности
остальной: остальных
остров: острова
ответственность: ответственность
отделиться: отделившаяся отделившейся
отдельный: отдельная
открытие: открытий открытия открытиями
отнести: отнесли
относить: относя
очень: очень
папиллома: папилломы
первоначально: первоначально
первый: первые первых
пересмотреть: пересмотрены
плечо: плеч
погулять: погуляли
подтверждаться: подтверждается
пока: пока
показать: показано
полагать: полагают
полагаться: полагаться
последний: последними
послужить: послужило
постареть: постарели
потерять: потеряли
потомок: потомками потомком
поэтому: поэтому
правильно: правильно
предок: предков
представитель: представителей
представление: представлениям
примерно: примерно
приписывать: приписывать
приходиться: приходится
причина: причиной
причём: причем
пройти: пройти
профессия: профессией
разделение: разделения
размышление: размышления
ранний: раньше
рациональный: рационального
реконструкция: реконструкциях
рост: росте ростом
сам: самими
самоощущение: самоощущения
свой: своей
север: севера
сильно: сильно
след: следы
случай: случае случаях
смотреть: см
сначала: сначала
снимать: снимает
современник: современниками
современный: современным современных
сожаление: сожалению
сотня: сотни
сохраниться: сохранилась сохраниться
спустя: спустя
сразу: сразу
стабильно: стабильно
статья: статье
стиль: стиле
стоять: стоять
стража: страже
страх: страхом
существенно: существенно
существование: существования
счастие: счастью
считать: считали
также: также
тесный: тесных
тигр: тигров
торговец: торговцы
точно: точно
традиционный: традиционные
три: трех
тропик: тропиках
тысяча: тысяч
фигаро: фигаро
флорес: флорес
флоресец: флоресцы
фонд: фонд
человек: людей люди человек человека
человечество: человечества
череп: череп
эволюция: эволюции
экспонат: экспонатах
эпоха: эпохи
этнос: этносов
этот: этими
юар: юар
юбилей: юбилей
юго: юго
южный: южной
ява: явы
являться: является являются
