абсолютный: абсолютным
автор: авторы
азот: азот
аккреция: аккреция
активность: активности
активный: активна
алексей: алексей
амай: амая
амина: аминой
аналогичный: аналогична
англия: англия
астероид: астероид
астроновость: астроновости
астроном: астрономам астрономом астрономы
астрономический: астрономический
астрофизик: астрофизики
астроёлочка: астроёлочка
атака: атакой
бабочка: бабочка
бедный: бедны
бейль: бейли
белокуров: белокуровым
бин: бин
ближний: ближнем
близость: близость
боде: боде
больший: большую
большой: большой
брильянт: брильянтами
будущий: будущие будущих
быстрорастущий: быстрорастущий
быстрый: быстрее
быть: будут будь
ван: ван
вариант: варианта
василий: василием
вегас: вегасе
вероятно: вероятно
весь: всей
ветер: ветров
вещество: вещества
взаимоотношение: взаимоотношения
взгляд: взгляд
вид: виде видов
видимый: видимому
видно: видно
видный: видны
визуализация: визуализация
включая: включая
влиять: влияет
вместе: вместе
вновь: вновь
внутри: внутри
водород: водорода
возможность: возможностью
возникать: возникает
войти: вошедшие
волна: волн
вопрос: вопрос
воспользоваться: воспользовалась
восточный: восточной
восхититься: восхитилась
вояджер: вояджера
впервые: впервые
вращение: вращения
время: временем время
вселенная: вселенная вселенной вселенную
вывод: выводы
выглядеть: выглядеть
вызвать: вызвал
вырабатывать: вырабатывают
вырисовываться: вырисовывается
высокий: высокого высоком
выставить: выставлены
выставочный: выставочном
выявить: выявлены
газ: газа
гайя: гайя
галактика: галактик галактика галактикам галактике галактики галактикой
галактический: галактического
гелий: гелия
генерация: генерации
гигант: гигант гиганта
гигантский: гигантской
гикеан: гикеан
глава: главе
главное: главное
глаз: глазами
го: го
год: год года годах году лет
голова: голова
горячий: горячих
гравитационный: гравитационных
гранула: гранулы
гринвич: гринвича
гринвичский: гринвичской
гронингенский: гронингенского
гун: гун
густой: густое
давний: давним
далёкий: далекая далеких далеком
данлоп: данлопом
данные: данным данными
дать: данной данные
двигаться: движутся
движение: движение движения
делать: делает делают
дельфин: дельфина
детализация: детализацией
деталь: деталей
детально: детально
детальный: детальных
детектор: детекторов
джеймс: джеймс джеймса джеймсом
джет: джеты
диапазон: диапазона диапазоне
дигель: дигеля
динамика: динамику
диск: диск диски
дискуссия: дискуссии
довольно: довольно
должный: должны
достаточный: достаточной
др: др
другой: другие другими других
дыра: дыр дыра дырами дырой дыру дыры
ежегодный: ежегодного
жертвенник: жертвенника
журнал: журнала журнале
жёлтый: желтыми
завершать: завершает
загадка: загадок
заглянуть: заглянуть
заключить: заключили
зал: зале
запечатление: запечатлении
запечатлеть: запечатлел запечатлела
запланировать: запланирован
запуск: запуск
заслуживать: заслуживающая
затем: затем
затмение: затмением затмения
заявка: заявок
звезда: звезд звезда звезде звезды
звездообразование: звездообразования
звёздный: звездная звездного звездной звездных
зелёный: зеленый
земля: земле земли
знать: знаем
значительный: значительные
золотой: золотая
идеальный: идеальной
известный: известное известной
изменение: изменения
изначально: изначально
изображение: изображение изображении изображений изображения
изучаться: изучалась
изучение: изучения
изучить: изучить
иметь: иметь
империо: империо
имя: имени
инновационный: инновационный
инструмент: инструмента инструментов
интересный: интересны
интерферометр: интерферометр
инфракрасный: инфракрасном
искажённый: искаженные
исключение: исключением
исключительный: исключительная
использовать: использовали использовать
испускать: испускают
исследование: исследование исследования
история: истории
исходить: исходя
ихан: ихан
июнь: июня
каждый: каждого каждый
какой: каких
карликовый: карликовые
карта: карту
категория: категориях
квазар: квазар
квинтет: квинтет
кембриджский: кембриджским
кеплер: кеплера
керри: керри
кислород: кислород
классификация: классификации
классифицироваться: классифицируется
колоссальный: колоссального
кольцевой: кольцевого кольцевым
кольцо: кольцо
команда: команда командой
компьютерный: компьютерном
конвекционный: конвекционные
конвекция: конвекции конвекцию конвекция
конкурс: конкурс конкурса
контакт: контакта
королевский: королевских королевской
космический: космический космических космической
космос: космос
который: которого которые который которых
красный: красная красного красные красный
кроме: кроме
крупный: крупной
кудрить: кудря
лазерный: лазерный
ласа: лас
лекка: лекки
луна: луны
лунный: лунное
люси: люси
марс: марс
масса: масса массе массы
массив: массива
международный: международной
межзвёздный: межзвездную
менее: менее
меняться: меняется
мера: мере
мероприятие: мероприятие
мерцать: мерцающих
место: местах
месячный: месячному
метеоролог: метеоролог
механизм: механизмов
миллиард: миллиардов
мир: мир
мишень: мишенью
млечный: млечного млечный млечным
множество: множество
моделирование: моделировании
модель: модели
молодой: молодые молодых
момент: момента
море: море
морской: морском
морфологический: морфологической
музей: музее музеев
мы: нам
мяо: мяо
наблюдать: наблюдал
наблюдение: наблюдений наблюдениях
назад: назад
назвать: названного
найти: найти
намерить: намерены
нанести: нанести
направляться: направляется
находиться: находится находятся
национальный: национальном
начало: началом
наш: наш наша нашего нашей
небесный: небесных
небо: неба
невадский: невадского
невероятный: невероятных
недавний: недавних
недавно: недавно
недолго: недолго
недра: недрах
неизвестный: неизвестных
нейтронный: нейтронная
некоторый: некоторые некоторых
необычный: необычная необычные
непосредственно: непосредственно
нераскрытый: нераскрытых
неровный: неровной
несколько: несколько
нидерланды: нидерланды
ниже: ниже
новогодний: новогодний
новый: новая новое новые новый новых
номер: номера
номинант: номинантов
ночной: ночного
нуклеосинтез: нуклеосинтеза
обилие: обилие
облако: облаках облаке облако
область: областей области область
обогащать: обогащая
обработать: обработанные
обработка: обработка
образоваться: образующиеся
обсерватория: обсерватории
общий: общего
объединить: объединенные
объект: объектов
объектив: объективах
объявить: объявлены
объяснить: объяснить
объясняться: объясняется
огромный: огромных
один: одна одно
однако: однако
оживлённый: оживленные
ожидать: ожидали
ожидаться: ожидалось
означать: означает
оказаться: оказалось
оказываться: оказывается
около: около
оконечность: оконечности
окончание: окончанием
окраина: окраин окраинах
окружающий: окружающая окружающего
они: ими
опубликовать: опубликованное
орбита: орбите
орбитальный: орбитального
ореол: ореола
основать: основано основаны
основный: основных
особенность: особенность
остаток: остаток
остывать: остывают
отвести: отведенном
ответ: ответы
отдельный: отдельных
открыть: открыта
отметить: отметили
относительно: относительно
относительный: относительное
относиться: относится
отобразить: отображена
отследить: отследить
отслеживаться: отслеживались
параллельный: параллельные
партнёр: партнера
пейзаж: пейзажей
первый: первое
перемешивание: перемешивание
перемычка: перемычкой
периферия: периферии
пингвин: пингвин
плазма: плазмы
планета: планеты
пленить: пленило
плотность: плотностью
победитель: победителем победители победителя
поверхность: поверхности поверхность
повышенный: повышенной
подать: подано
поддержка: поддержке
подробный: подробнее
подтвердить: подтверждено
позволять: позволяют позволяющей
поздний: позже
пока: пока
показать: показаны
полный: полной
положение: положения
получить: полученные получил получить
полюс: полюсов
полярный: полярных
помимо: помимо
помочь: помочь
помощь: помощью
понять: понять
пора: пор
поразить: поразило
поскольку: поскольку
последствие: последствия
похоже: похоже
похожий: похожими
поэтому: поэтому
превосходить: превосходит
превышать: превышают
предоставлять: предоставляет
представить: представлены
представление: представлении
презентация: презентации
привести: приведенном
придавать: придавая
приз: призы
признание: признания
признать: признан
пример: примере
примерно: примерно
присвоить: присвоены
присутствовать: присутствовать
причина: причина
проводиться: проводится
прогрессия: прогрессию
продукт: продукты
произойти: произошло
происхождение: происхождения
пропасть: пропавшие
просвет: просветы
протяжённый: протяженные
проходить: проходить
процесс: процесс
прошлое: прошлого
прошлый: прошлом
прямой: прямое
пузыриться: пузырящаяся пузырящуюся
пузырь: пузырей
пузырёк: пузырьков
пульсар: пульсара пульсары
путь: пути путь
путём: путем
работа: работа работу работы
работать: работает
радиотелескоп: радиотелескоп радиотелескопов
раздутый: раздутую
различный: различной различные различным различных
размер: размер размеру
разница: разницы
разный: разные
разрешение: разрешении
разыграть: разыграны
райан: райан райана
район: районов
ранний: ранней раннюю
распадаться: распадаются
расположить: расположена расположенная
распределять: распределяет
рассказывать: рассказывают
рассмотреть: рассмотреть
расстояние: расстоянии
регион: региона
результат: результаты
рекорд: рекорд
ремонт: ремонт
рентгеновский: рентгеновской
ресслера: ресслер
решающий: решающим
российский: российского
рост: роста
рыба: рыба
сверхмассивный: сверхмассивная сверхмассивной сверхмассивных
сверхновый: сверхновая сверхновой сверхновые
свести: сведенные
свет: свету
световой: световых
свидетельство: свидетельство
свой: своих
свыше: свыше
сделать: сделана
сей: сих
сейфертовский: сейфертовским
серия: серия
силуэт: силуэт
сильный: сильных
синий: синий
синтез: синтеза
синь: синь
система: система
сияние: сияний
скопление: скопление скоплениях
скоростной: скоростная
скорость: скорости
след: следы
слиться: слившейся слился
слияние: слияние слиянием слияния
сложность: сложность
случай: случае
смотреть: см
смочь: сможем
снимок: снимке снимки снимков
событие: событием
содержать: содержащее
созвездие: созвездии
создать: созданные
солнечный: солнечного солнечному солнечные
солнце: солнца солнце
соответствие: соответствии
состав: состав
составлять: составляют
спектр: спектра
специально: специально
спиральный: спиральная
список: список
способ: способ
спутник: спутника
среда: среда среду
среднее: среднем
станция: станции
старение: старения
стать: стал
страна: стран
стрелец: стрелец стрельца
стрелка: стрелками
струить: струи
структура: структуры
субскопление: субскопление
судьба: судьбе
судья: судей
сформироваться: сформировавшиеся
схема: схеме
считаться: считается
счёт: счет
сша: сша
съёмка: съемки
также: также
такой: таких такое
телескоп: телескоп телескопа телескопов
тень: тени
тип: типа типы
толстый: толстый
том: тома
топография: топографию
точка: точке
третий: третьего
туманность: туманность
туманный: туманные
тяжёлый: тяжелее тяжелые
тёплый: теплый
увидеть: увидеть
углерод: углерод
уголок: уголок
удалить: удалены
удалёнка: удаленке
удаться: удалось
уильямс: уильямса
ультрафиолетовый: ультрафиолетовой
университет: университета
уносить: уносят
уран: уран
условный: условные
участник: участников
учёный: ученые ученых
уэбба: уэбб уэбба
фаза: фазы
фильтр: фильтрам
фон: фоне
фонд: фондом
фоновый: фоновые фоновых
форма: форму
формирование: формирования
формировать: формируют
фото: фото
фотограф: фотограф
фотография: фотографии фотографию фотография
фэн: фэн
хаббл: хаббл
хаббнуть: хаббла
характер: характер
характеристика: характеристик
хельмить: хельми
хепбёрн: хепберн
художник: художника
цвет: цвета
центр: центра центре
цикл: циклу циклы
чандра: чандры
часто: часто
часть: части часть частях
четыре: четырех
чжан: чжан
чёрный: черная черной черную черными черных
чётки: четки четок
шотландский: шотландским
эволюция: эволюцию
экзолуна: экзолуны
элемент: элементами элементы
энергия: энергию энергия
энн: энн
энцелада: энцелад
этот: эта этих
эффект: эффект
эхо: эхо
юпитер: юпитер
ядерный: ядерного
язев: язев
яйцо: яйцом
яркий: яркий
яркость: яркость
