абзац: абзац
абсолютно: абсолютно
аквариум: аквариум
алгоритм: алгоритм
алексей: алексей алексея
альтернатива: альтернатива
альтернативный: альтернативная
алёшин: алёшина
аминокислота: аминокислотам аминокислотами аминокислоты
аминокислотный: аминокислотной
аналитически: аналитически
аналогично: аналогично
аномалия: аномалии
антибиотик: антибиотикам
апрель: апреле
археология: археология
ассистент: ассистента
африка: африки
африканский: африканские
байка: байка
бактерия: бактерии бактерий бактерия
банально: банально
банальный: банальный
бегать: бегают
бежать: бежите
белка: белки
белков: белковых
белок: белка белкам белков белком белок
беседа: беседы
бесконечный: бесконечного
бескрылый: бескрылые
бесполезный: бесполезные
бессмысленный: бессмысленный
билет: билет
биологический: биологических
биология: биологией биологии
биоразнообразие: биоразнообразие
биохимия: биохимия
благоприятно: благоприятно
благоприятность: благоприятностью
благоприятный: благоприятна благоприятные
близкий: ближайшего ближайшие близких
близорукий: близорука
блуждание: блуждания
бог: бог
болезнь: болезней
больший: большая больших
большинство: большинство
большой: большое большому
бонгард: бонгардом
бонгарда: бонгард бонгарда бонгарду
борис: борис
брак: браков
брать: берем
браться: берется
будущее: будущем
буква: буква букву
буквально: буквально
бывало: бывало
бывать: бывает
быстро: быстро
быстрый: быстрая быстрее быстрой
быть: будем будете будут
бюрократ: бюрократ бюрократа
важный: важнейших
вариант: вариантах варианте вариантов варианты
ваш: ваш ваше ваши вашими
вверх: вверх
вегаснуть: вегас
ведать: ведая
ведущий: ведущие
век: века
велеть: велел
великий: великие
величина: величины
верить: верил
верно: верно
верховный: верховный
вести: ведет
весь: весь всем вся
ветер: ветер
ветка: ветки
вещь: вещей вещи вещь
взаимодействие: взаимодействие взаимодействий
взять: взяла взять возьмем
взяться: взялся
вид: вид вида видов видом виду виды
видеозапись: видеозапись
видеть: видел видели видим видит
видимо: видимо
видимый: видимому видимые
видно: видно
виктория: виктория
вирус: вирусы
включать: включает
включаться: включается
включая: включая
владимир: владимира
влиять: влияло влияют
вместо: вместо
вмещаться: вмещается
внешний: внешние внешних
вниз: вниз
внутри: внутри
водный: водной
возбудитель: возбудитель
возможный: возможна
возникать: возникает возникал
возникновение: возникновении
возникнуть: возник возникли
волков: волков
воля: волей
вообще: вообще
вопрос: вопрос вопросах вопросы
воспроизводство: воспроизводства
восстановиться: восстановился восстановится
восстановление: восстановления
впечатление: впечатление
вполне: вполне
время: времена времени время
вряд: вряд
вселенная: вселенной вселенную
вставать: встающих
встреча: встреч
встречаться: встречались встречаться
встроить: встроена
всюду: всюду
всякий: всякие всяким всякой
всё: всё
вторично: вторично
второй: вторых
выбрать: выбрал
выгнать: выгнать
выдающийся: выдающихся
выдерживать: выдерживает
вызывать: вызывают
выйти: вышла
вымереть: вымерло
вымирать: вымирает вымирают
выражение: выражение
вырваться: вырваться
высказывание: высказывание
высоко: высоко
выступать: выступал
вытащить: вытащить
вытекать: вытекающий
выход: выхода
выше: выше
гедди: гедди
гейгера: гейгера
гельмгольц: гельмгольца
гельфанд: гельфанд
ген: ген гена генов гены
генератор: генератор
генетически: генетически
генетический: генетическом
генный: генный
геном: геном генома геноме геномов геномы
геномик: геномике
геологический: геологическим
гибрид: гибридов
гибридизация: гибридизации
гипотеза: гипотеза
глаз: глаза глазом
глобально: глобально
глобальный: глобальным
говорить: говорил говорим говорит говорить говоря
год: лет
голова: голову
гора: горы
гораздо: гораздо
господь: господь
готовить: готовим
грубо: грубо
гуманитарий: гуманитарии
густота: густота
давать: давай
давление: давление
давно: давно
далёкий: дальше
датчик: датчик датчика датчики датчиков
дать: дадите данные
два: две двух
двадцать: двадцать
двигаться: двигаться
дворняга: дворняги
деваться: деваться
девочка: девочки
деградация: деградации деградацию деградация
деградировать: деградирует деградируют деградирующих
действительно: действительно
действовать: действовать действует
деконструировать: деконструировал
делать: делает делал делать
делаться: делается
деление: делений
дело: деле дело
день: день
дерево: деревья
десятка: десятки
десяток: десятков
десять: десять
деталь: деталям
деятель: деятелей
джон: джона
диалог: диалог
дикий: диких дикой
дифференцировка: дифференцировка дифференцировки
диффура: диффуры
длинный: длиннее длинного длинный
днк: днк
добавляться: добавлялись
доводиться: доводится
довольно: довольно
дойти: дойдем
доклад: докладом
долгий: долгая долгое дольше
долго: долго
долговременный: долговременные
должный: должен должно должны
достаточно: достаточно
древний: древних
друг: друг друга другом
другой: других другого другое
думать: думал думать думаю
дуплицироваться: дуплицировался
душа: душу
дээнков: дээнковых
евгений: евгением
единица: единицу
единичный: единичных
естественно: естественно
естественный: естественный
жаргонный: жаргонное
жгутик: жгутик
живой: живых
животное: животное
жизнь: жизни жизнь
жить: живут живущий жили жить
журнал: журнала
забираться: забираетесь
забывать: забываю
зависеть: зависеть зависят
зависимость: зависимость
загонять: загонял
задача: задач задача
задизайнить: задизайнить
заключительный: заключительное
закодировать: закодированного
закономерность: закономерности
закреплять: закрепляет
замена: замен
заметить: заметить замечено
замечание: замечание
замечательный: замечательная замечательно замечательный
замечать: замечаем
занимать: занимающие
заниматься: занимались
занятый: заняты
занять: занял
записывать: записывает
запись: запись
заплатка: заплаток
запрудить: запрудило
зародыш: зародышей
заставлять: заставляет
застать: застал
затем: затем
захотеть: захотят
земля: земле землю
землянин: землянами
земной: земных
знать: знает знали знать знаю
значение: значения
значимый: значим
значит: значит
идеал: идеал
идеальный: идеальный
идентичный: идентичные идентичных
идти: идем идет
известный: известная известное известных
изготовить: изготовил
излучение: излучение
изменение: изменений изменения изменениям
изменить: изменить
измеримый: измеримая
измерить: измерить
измерять: измеряете измеряют
изначально: изначально
изоляция: изоляции изоляция
изучать: изучает изучал изучать
иллюзия: иллюзии
илона: илон
иметь: имеет иметь имеют
иммунитет: иммунитет
иммунный: иммунную
иначе: иначе
инженер: инженер
инициализация: инициализации
инициализировать: инициализировать
институт: института институте
интеллект: интеллект интеллекта
интенсивный: интенсивным
интервью: интервью
интересно: интересно
интересный: интересная интересное интересный
информация: информации
ионизировать: ионизирующее
искать: искал искать
искра: искра
использование: использованием
использоваться: используется
исправление: исправления
исследование: исследований
исследователь: исследователи
исследовать: исследована
история: истории историй история
исходить: исходя
к: ко
каждый: каждого каждое каждый каждым
казаться: кажется казалось
какой: какие какими каких какого какое каком
канал: канале
карло: карло
карта: карты
картинка: картинкой картинку
карьера: карьера
качество: качестве
кишечный: кишечных
класс: классов
классифицировать: классифицировать
классический: классические классический
клетка: клеток
клеточный: клеточной
климат: климат
код: код кода
кодировать: кодировало кодирует кодируют
количество: количества количестве количеству
коллега: коллегами
колонизация: колонизацию колонизация
комментарий: комментариев
компания: компания
комплекс: комплексе
компонент: компоненты
конец: конце концов
конечность: конечность
конечный: конечном
конкретный: конкретных
конкуренция: конкуренции
конструкция: конструкции
контактировать: контактируют
контрпример: контрпримеры
конференция: конференциях
кончиться: кончились
копирование: копировании
копировать: копировал
копия: копии
коралл: кораллов
короткий: короткий
коррелировать: коррелирует коррелируют
корреляция: корреляции корреляциям
косяк: косяки
который: которая которое которой которому которую которые который которых
кох: коха
край: крае
красивый: красивых
критерий: критериев критерий
кролик: кролика
кроме: кроме
крыло: крылья
крыса: крысы
кстати: кстати
кто: кого кому
кудрить: кудря
кунин: куниным
купить: купить
кусок: кусок
куча: кучу
кёльнский: кёльнском
лаборатория: лаборатории
лабораторный: лабораторных
ландшафт: ландшафт ландшафта
ласа: лас
лев: лев
лекарственный: лекарственная
лессиг: лессиг лессигом лессигу
летать: летать летают
либо: либо
лингвист: лингвист
линия: линиях
лишний: лишнего
ложиться: ложатся
локально: локально
локальный: локального локальное локальные локальным
ломать: ломать
лужа: лужах
любить: люблю
любой: любая любом
лягушка: лягушек
максимальный: максимального
маленький: маленькими меньше
малый: малые
мальчик: мальчики
марс: марс марса марсе
маск: маск
масса: масса
массово: массово
материал: материал
медленно: медленно
межпланетный: межпланетный межпланетным
мелкий: мелким мелкими
менее: менее
меняться: меняется менялись меняться меняются меняющейся меняющихся меняющуюся
местный: местные
место: местах месте место
месяц: месяцы
метафора: метафор метафору
метод: метод методов
механизм: механизм механизмов механизмы
миллиард: миллиарды
миллион: миллион миллиона
минимум: минимумы
мир: мира
михаил: михаил
михаэль: михаэлем михаэль
младший: младшего
млекопитающее: млекопитающих
многоклеточный: многоклеточных
модель: модель
мозг: мозга
моисеевич: моисеевич
мой: моему
молекула: молекул
молекулярный: молекулярная молекулярно молекулярные
момент: момент
моментально: моментально
монт: монте
монтаж: монтаж
мотив: мотивам
мочь: могли могу могут можем
мощный: мощнейших мощный
мутантный: мутантной
мутация: мутации мутаций мутация мутациями
муха: мухи
мы: нам
мысленный: мысленного мысленные
мышь: мыши
наблюдать: наблюдаем наблюдать
наблюдение: наблюдение
наверно: наверно
наверное: наверное
надстраивание: надстраивания
надстройка: надстройку
назад: назад
назвать: назвать
назреть: назрел
называться: называется
найти: найти
накапливаться: накапливаются
накопление: накопление
нанять: нанять
наоборот: наоборот
написать: написать
направление: направлении
например: например
нарываться: нарывались
насколько: насколько
наслать: нашли
наследие: наследие
настолько: настолько
наука: наука
научный: научная
начальник: начальника
начальный: начальные
начать: начать
начинать: начинал начинают
начинаться: начинается
наш: наш нашей наших
неадекватный: неадекватной
неандерталец: неандертальцами
небольшой: небольших
невозможно: невозможно
неволей: неволей
недавно: недавно
недолго: недолго
недостаточно: недостаточно
незачем: незачем
нейтральный: нейтральны
некоторый: некоторые
некуда: некуда
немедленно: немедленно
немножечко: немножечко
немножко: немножко
необязательно: необязательно
неоптимальный: неоптимальный неоптимальными
непонятно: непонятно
неправильно: неправильно
неправильный: неправильными
несколько: нескольких несколько
несовместимость: несовместимость
несомненно: несомненно
несуществующий: несуществующую
неуправляемый: неуправляемой
неуспешный: неуспешного
неферментативный: неферментативная
нечеловеческий: нечеловеческой
неэффективный: неэффективным
никак: никак
никакой: никакого никакой
никто: никто
ниша: нишах ниши нишу
новый: новое новую новые новый новых
норма: норме
нужно: нужно
нужный: нужен нужна нужны
нуклеотид: нуклеотид нуклеотидами
оба: оба
обещать: обещает
область: область
обложка: обложка обложку
образ: образом образу
образование: образованием образования
образоваться: образовались образовалось
обратно: обратно
обратный: обратном
обретать: обретают
обсуждать: обсуждаем
обширный: обширный
общаться: общаться
общий: общая общем общих
обязательно: обязательно
оговорить: оговорили
один: одни одних одно одного одной одном одну
однажды: однажды
однако: однако
одноклеточный: одноклеточных
однообразный: однообразны
ожидать: ожидать
озеро: озера озере озеро
означать: означает
озёрный: озерные
ой: ой
оказаться: оказались оказалось
оказываться: оказывается оказываются
оно: оно
оператор: оператор
определённый: определенный определенным
оптик: оптик
оптимально: оптимально
оптимальный: оптимального
оптимизм: оптимизма
оптимум: оптимума оптимумы
опухоль: опухолей опухоль
опыт: опыт
опытный: опытный
орган: органов органы
организм: организм организмов организму организмы
ортодоксальный: ортодоксального
основной: основной
основный: основного
осознанный: осознанная
осознать: осознали
остаться: остался останется
остров: островам островах
отбирать: отбирает
отбираться: отбираются
отбор: отбор отбора
ответ: ответ ответов
ответить: ответить
отвечать: отвечают
отдельный: отдельные
откатить: откатить
откуда: откуда
отличать: отличает
отличаться: отличаться
отлично: отлично
относительно: относительно
отождествить: отождествлена
отрицательный: отрицательной
отследить: отследить
отсутствие: отсутствие отсутствия
оценка: оценками
очень: очень
очередной: очередного
ошибка: ошибки
ощущение: ощущение
палец: пальцами
палочка: палочек палочка палочки
палочник: палочники
панспермия: панспермия
панчин: панчина
пара: пары
паразит: паразитов паразиты
паразитизм: паразитизма
паразитический: паразитическому
параметр: параметры
патоген: патоген патогенам патогены
паттерн: паттерны
патч: патчами патчей
пахать: пахать
пена: пены
первый: первое первые первый первых
передача: передачи
передний: переднем
перейти: перешел
перемешивать: перемешиваете
перепонка: перепонка перепонками перепонки
перестать: перестало
писать: писать пишу пишут
пища: пищу
плавать: плавать плавают
плохо: плохо
плохой: плохой хуже
поведение: поведения
повернуть: повернула
поверхность: поверхности
повторять: повторять
повышать: повышает
повышение: повышению
подавлять: подавляющее
подбирать: подбирает
подбираться: подбираемся
подножие: подножье
подобный: подобные
подобрать: подобрал
подозрение: подозрение
подстраиваться: подстраивался подстраиваются
подстроиться: подстроиться
подстройка: подстройка подстройку
подхватить: подхватит
пожалуйста: пожалуйста
позиция: позиций
пойти: пойти
пока: пока
показатель: показатель
показать: показать
показывать: показывает
поколение: поколений
покупать: покупали
полезно: полезно
политический: политических
полный: полного полной
получать: получаете получают
получаться: получается получалось
получить: получена
получиться: получилась получились получится
поменяться: поменяется поменялись поменялся поменяться
поместить: поместили
поместиться: поместились
помнить: помню
помогать: помогает помогать
помощь: помощью
понимать: понимаем понимали понимать понимаю
понятно: понятно
понять: понял поняли понять
попадать: попадает
поправлять: поправляет
попросить: попрошу
популяция: популяции
порождение: порождения
порядок: порядка порядку порядок
посадить: посадите
посадка: посадки
поскольку: поскольку
последний: последнее последнюю
последовательность: последовательности последовательность последовательностях
посмотреть: посмотреть
поставить: поставить
постепенно: постепенно
постепенный: постепенного постепенных
постоянно: постоянно
постоянный: постоянна постоянной
посчитать: посчитать
потащить: потащит
потомство: потомство
поучительный: поучительно
похоже: похоже
похожий: похожее похожи похожую
почему: почему
починить: починили
починка: починка
поэтому: поэтому
появиться: появились появился появится
появление: появление появления
появляться: появляется появляются
правда: правда
правильно: правильно
правильный: правильное правильный правильным
превратиться: превратилась превратится
предковый: предковый
предложить: предложенная
предок: предков
предсказывать: предсказывать
представимый: представим
предыдущий: предыдущие
преждевременный: преждевременный
прекрасно: прекрасно
прекрасный: прекрасные
привести: привести
придавать: придавать
придумать: придумали придумано придумать
признак: признак признаки признаков
прийти: придете
прийтись: придется
пример: пример примеров примеры
примерно: примерно
приниматься: принимались принимаются
принцип: принципе
принципиально: принципиально
природный: природных
приспосабливаться: приспосабливается приспосабливаться
приспособить: приспособленные
приспособление: приспособления
приспособленность: приспособленности приспособленность
приходить: приходит приходите
причина: причинам
причём: причем
проблема: проблем проблема проблемах
пробой: пробои
проверить: проверить
программировать: программировал программируемой
программист: программист
прогресс: прогрессом
прогрессивный: прогрессивная прогрессивной
продолжать: продолжает продолжают
продумать: продуман
проект: проекты
проектировать: проектировать
произвольный: произвольное
произойти: произошла
происходить: происходило происходит происходят
происхождение: происхождение происхождении
проказа: проказы
пролог: пролог
промежуточный: промежуточном промежуточные
проследить: проследить прослеженная прослеженных
просто: просто
простой: простые простыми простых проще
профессор: профессором
проходить: проходить
процедура: процедура процедуру
процесс: процессы
прямо: прямо
псевдослучайный: псевдослучайных
публикация: публикацией
путаница: путаница
путь: пути
пушистый: пушистые
пытаться: пытается пытались пытаться
работа: работу работы
работать: работает работал работали работать работают
работник: работником
равно: равно
радикально: радикально
разбегаться: разбегались
разболтать: разболтанная
разветвиться: разветвился
развитие: развитии развитию развития
разглядывать: разглядывал
разговаривать: разговаривайте
разговор: разговор
размер: размером
разнообразие: разнообразие
разный: разная разного разное разные разных
разойтись: разойтись разошлись
разумно: разумно
разумный: разумного
раковый: раковая раковых
ранний: раньше
распределение: распределение
рассасывание: рассасывание
рассасываться: рассасывается
рассказать: рассказал
рассматривать: рассматривать рассматривают
рассуждение: рассуждения
расти: растут
растить: растить
расходиться: расходиться
расшифровать: расшифровали
реалистично: реалистично
ребёнок: детей
регион: регионы
регулироваться: регулировался регулироваться
регулятор: регулятора
регуляторный: регуляторной регуляторную регуляторные регуляторных
регуляция: регуляция
редкий: редкие
резко: резко
результат: результате
река: реке реку
репликатор: репликаторы
репликация: репликация
репродуктивный: репродуктивная репродуктивной
решение: решением решения
решить: решена
рис: рис
рисовать: рисуют
рнк: рнк
ровно: ровно
род: роде
родитель: родителя
родственница: родственница
родственный: родственные родственных
рождение: рождения
роль: роль
роман: романы
рот: рта
ротор: ротор
рука: руками
рядом: рядом
сайт: сайт сайтам сайтов сайты
сам: сами самого самом
самец: самцов
самый: самое
свалиться: свалились
свобода: свободе
свободно: свободно
свободный: свободный
свой: свое своей своих
связать: связана связано
связывание: связывания
связь: связи связь
сдвигаться: сдвигаются
сделать: сделан сделать
секта: сектой
семейство: семейства семейство
семинар: семинаре
семь: семь
сергеевич: сергеевич
серенький: серенькие
серьёзный: серьезные
сеть: сети
сильно: сильно
сильный: сильное сильный
система: систем система системах систему системы
ситуация: ситуации ситуаций
скажем: скажем
сказать: скажете сказал сказать
скинуться: скинуться
склон: склон склоне
склонный: склонен склонны
сколько: сколько
скорость: скорость скоростью
скрещиваться: скрещиваются
слабо: слабо
следить: следить
следующий: следующие
слишком: слишком
слово: слова словам
сложность: сложности сложность сложностью
сложный: сложная сложные сложный
сломать: сломать
сломаться: сломался
слон: слон
случай: случае
случайно: случайно
случайность: случайности случайность
случайный: случайная случайного случайные случайных
слушать: слушает слушал
смирнов: смирнов смирновым
смоделировать: смоделировать
смотреть: см смотрит смотрите смотришь
смочь: смог смогут сможем сможет
смысл: смысл смысла смысле
сначала: сначала
снести: снесет
собака: собаки
собственно: собственно
совершенно: совершенно
совершенный: совершенные
совершенство: совершенства совершенством
совместный: совместные
содержательный: содержательного содержательный
сожрать: сожрет
создавать: создает
сообразить: сообразил
соответственно: соответственно
соответствовать: соответствует
соответствующий: соответствующие
сорт: сорта
соскребать: соскребает
состояние: состоянии состояния
состоять: состоит состоял
сотня: сотен сотни
сотрудник: сотрудник
сохраняться: сохранялась
спасибо: спасибо
специально: специально
специальный: специальную
способный: способна
сравнивать: сравнивая
сравнить: сравнили
сразу: сразу
среда: среда среде среду среды
стабильность: стабильность
стабильный: стабильна стабильны
стадия: стадии стадиях
становиться: становится становиться
станок: станки
старание: стараниями
старший: старшего
старый: старые старый
статистический: статистические статистических
стать: стали стало
статья: статьи статья
стенка: стенок
стенограмма: стенограмма
степь: степи
сто: сто
стоить: стоит
столбец: столбце
столетний: столетнему
сторона: сторону
строение: строение
структура: структура структуре
ступать: ступает
стыд: стыда
суслик: суслика
существенно: существенно
существо: существ
существовать: существовал существует существуют
существующий: существующие
сформулировать: сформулировал
схватить: схватить
сходу: сходу
схожий: схожим
считать: считать
считываться: считываются
счёт: счет счете
счётчик: счетчика
съесть: съел
сякнуть: сяк
таблица: таблице
также: также
таки: таки
таков: таково
такой: такая такие таких такого такое такую
таксон: таксоне таксонов
тандемный: тандемной
таракан: таракан
телеологический: телеологического
телепатия: телепатию
тема: тему
темп: темп темпа
температура: температура
теоретический: теоретической
теория: теория
термин: терминах
терять: теряют
технология: технологии
тип: типов
ткань: тканей
тоненький: тоненькое
тот: та те тех тому ту
точно: точно
транскрипционный: транскрипционного
транскрипция: транскрипции
трв: трв
треть: треть
трое: трое
троицкий: троицком
трудно: трудно
туберкулёзный: туберкулезной
туда: туда
тупик: тупиках тупики тупиков
тысяча: тысяч тысячу
тяжело: тяжело
увеличиваться: увеличивается
уверенный: уверен
увидеть: увидеть
углеродный: углеродно
угодный: угодно
удаваться: удавалось
узнавать: узнавал узнавать узнают узнаёт
узнаться: узнается
улучшение: улучшение улучшений
ультрафиолет: ультрафиолет
уметь: умеем умеют
университет: университете
упоминать: упоминал
упорно: упорно
упорный: упорной
упроститься: упростился
уровень: уровне
условие: условий условия условиях
усложнение: усложнению усложнения
усложняться: усложнялся
усовершенствование: усовершенствованию
успеть: успели
успешный: успешный
устойчивость: устойчивость
устойчивый: устойчиво устойчивы
устроенный: устроен
устроить: устроена устроено
утверждение: утверждение
участок: участков участок
учёный: ученый
фактор: фактор фактора факторов факторы
фенотипический: фенотипическое
фертильный: фертильные
физик: физик
физика: физике физики
физический: физическими
философский: философская философский
фраза: фраза
функциональность: функциональность
функция: функцию функция
хак: хаками
хансена: хансена
характерный: характерные
хвост: хвост
химиотерапия: химиотерапии
химический: химические химического
хищник: хищник
ход: ходе
хозмаг: хозмаге
хозяин: хозяина хозяине
хомяк: хомяка
хороший: хорошая хорошие
хотеть: хотел хотим
хотя: хотя
хрен: хрен хрена
цвет: цвета
целый: целых
центральный: центральной
цепочка: цепочки
цикл: цикла
цихлида: цихлид цихлиды
частичный: частичная частичный
часто: часто
частый: чаще
человек: людей люди человека
человеческий: человеческого
четверть: четверть
чинить: чинили
число: чисел числа число
чистопородный: чистопородные
читать: читает
чудесный: чудесная чудесной чудесные чудесных
чёткий: четкое
шажок: шажками
шесть: шесть
штамм: штаммов
штерн: штерн
штука: штука
шум: шума
шутить: шутили
щелчок: щелчка
эвм: эвм
эволюционировать: эволюционировать эволюционирует
эволюционно: эволюционно
эволюционный: эволюционной эволюционные
эволюция: эволюцией эволюции эволюцию эволюция
экологический: экологические экологических экологического
эксперимент: эксперимент эксперимента эксперименты
экспериментально: экспериментально
экспериментальный: экспериментальный
элемент: элементов
эмбрион: эмбрионов
эпоха: эпоха
эрэнковый: эрэнковые
это: этим
этот: эта этих
эукариот: эукариот
эффект: эффект
эффективность: эффективность
юбилей: юбилею
явление: явление
явный: явные
язык: язык
яркий: яркие
