август: августа
автор: автор авторов авторы
агентство: агентства
айболит: айболит
алексей: алексей
амай: амая
аналогично: аналогично
аналогичный: аналогичны
андромеда: андромеды
аппарат: аппарат
аресибо: аресибо
ароматический: ароматических
архивный: архивных
астероид: астероид
астроновость: астроновостей астроновости
астроном: астроном астрономов астрономы
астрономический: астрономический астрономических астрономического
астрофизик: астрофизики
астрофизический: астрофизического
астроёлочка: астроёлочка
барионный: барионного
белый: белый
бланко: бланко
ближний: ближнего
близкий: ближайшие
близлежащий: близлежащей
больший: большей большим
большой: большое большой
быстрый: быстрыми
важный: важную важный важным
венера: венере венеры
верный: верна
вероятно: вероятно
весьма: весьма
ветер: ветра ветрами ветры
ветеран: ветераном
взаимодействие: взаимодействие взаимодействию
взаимоотношение: взаимоотношения
взгляд: взгляд
вид: виде
видео: видео
видеть: видеть видим
видимый: видимом
видный: видны
виктор: виктора
включая: включая
влияние: влиянием
внеземной: внеземного
внешний: внешнего
внизу: внизу
вновь: вновь
внутри: внутри
водород: водород водорода
возвращение: возвращения
возглас: возгласом
возможность: возможностью
возникновение: возникновению
временной: временное
время: времени время
вселенная: вселенной вселенную
вспышка: вспышкой вспышку
всё: всё
выброс: выброс выбросах выбросы
выбросить: выброшен
вывод: вывод
выглядеть: выглядит
выдать: выдал
выживание: выживание
вызвать: вызвал
выполнить: выполненные
выполнять: выполняя
выпуск: выпуск
высокий: высокой
вытянутый: вытянутые
выявить: выявили
выявлять: выявлять
выяснить: выяснить
газ: газом
газета: газеты
газовый: газового газовой
галактика: галактик галактика галактики галактикой галактику
галактический: галактические галактическими
гало: гало
ганимед: ганимед ганимеда
ггц: ггц
герой: герои
гершель: гершелем
гигант: гиганта гигантов
гикеан: гикеан
гипотеза: гипотез
главное: главное
глаз: глазами
год: год года году годы лет
горячий: горячей горячим
гравитационный: гравитационного гравитационный гравитационных
график: график
группа: группа группы
давать: дает
дальнейший: дальнейшие
далёкий: далекая далеком далекую
данные: данными данных
данный: данное
дать: данная данные
два: две
двойник: двойник двойниками
двойной: двойного двойной
десяток: десятков
детализация: детализацией детализации
деталь: деталь
детальный: детальные
джеймс: джеймс
джерри: джерри
диаметр: диаметра
диапазон: диапазона
диск: диска
довольно: довольно
должный: должно
достаточный: достаточна
достигнуть: достигнет
друг: друг другу
другой: другим
дуга: дуг
дыра: дыр дыры
евклид: евклид
европа: европы
естественно: естественно
естественный: естественного естественное
жареный: жареных
желтковый: желтковая
жизнь: жизни
зависимость: зависимости
загадка: загадка
закономерность: закономерности
заметить: заметить
запечатлеть: запечатлевший запечатлена
запустить: запущен
зарегистрировать: зарегистрированной зарегистрировано
защитить: защищены
звезда: звезд звезда
звездообразование: звездообразования
звёздный: звездных
земля: земле землей земли
зерно: зерна
зонд: зонд зонда
играть: играют
идти: идут
известный: известная известных
излучение: излучение излучения
изображение: изображение изображения
изучение: изучения
изучить: изучил
иметь: имеет имеют имеющая
импульс: импульс
имя: имени
инструмент: инструмента инструментами инструментов
интенсивность: интенсивности
интерес: интерес
интересный: интересен
интригующий: интригующих
инфракрасный: инфракрасного инфракрасной инфракрасном
ио: ио
ионизировать: ионизирующего
искать: ищут
использовать: использовавших использовать
использоваться: использовались используется
исследование: исследования
исследователь: исследователи исследователь
исследовать: исследовать
исходить: исходить
исходящий: исходящих
итог: итоги
каллисто: каллисто
камера: камера камерами камерой камеры
карлик: карлик карлика
карман: карманах
карта: карта карты
каталог: каталога каталогу
квинтет: квинтет
кг: кг
кеплер: кеплера
классифицироваться: классифицируется
км: км
колдуэлла: колдуэлл колдуэлла
количество: количеством
комментарий: комментариев
компаньон: компаньон компаньоном
компьютерный: компьютерной
конец: конце
конечный: конечной
космический: космический космических космического
космос: космос космоса
который: которого которое который
крайне: крайне
красный: красного красный
кроме: кроме
круговорот: круговорота
крупный: крупнейших
кудрить: кудря
лазер: лазера
левый: левый
ледяной: ледяных
линия: линии
литература: литературы
лишь: лишь
луна: лун луной луны
люси: люси
магелланов: магеллановым
магнитар: магнитар
магнитный: магнитным
мазер: мазера
май: май
максимальный: максимальное
маленький: маленькие
манёвр: маневр маневра маневров маневры
марсианский: марсианский
материал: материала материалом
материя: материи
мгц: мгц
межзвёздный: межзвездными
мелкодисперсный: мелкодисперсных
менее: менее
местный: местном
метод: методы
метровый: метрового
микроволновый: микроволнового
миллион: миллионов
мимо: мимо
минус: минус
мир: миром
миссия: миссии
млечный: млечного млечный млечным
мнение: мнению
многоцветный: многоцветное
множество: множество
моделирование: моделирование моделированием
момент: момент
морфология: морфологии
мочь: могли можем
мощный: мощной мощную мощный
мур: мур
мы: нами
наблюдатель: наблюдателя
наблюдать: наблюдал наблюдали
наблюдение: наблюдений наблюдения наблюдениях
набрать: набрать
надеяться: надеются
называть: называют
наиболее: наиболее
найти: найти
наличие: наличие
направить: направив
направиться: направиться
направление: направлении направлению
научный: научного
находиться: находимся находится
наш: наш наша нашего нашей
небо: неба
нейтрон: нейтрон
нейтронный: нейтронная
некоторый: некоторые
немного: немного
немой: нем
необходимо: необходимо
необходимый: необходима
необычный: необычные
неплохой: неплохое
нередко: нередко
несколько: нескольких несколько
нижний: нижнем нижний
нить: нитей
новогодний: новогодний
новость: новостей
новый: новая нового новую новые новый
номер: номера
нормальный: нормальные
ночной: ночного
обзор: обзор
обзорный: обзорной
облако: облаками облаков облаком
область: области область областями
обнаружение: обнаружения
обнаружить: обнаружена обнаруженная обнаружили обнаружить
обозначение: обозначение обозначением
образ: образом
обратный: обратной
обсерватория: обсерватории
обход: обход
обширный: обширной
объединяться: объединяются
объект: объектов
объяснение: объяснение
объяснить: объяснить
объяснять: объясняет
обычный: обычная
огайо: огайо
один: одна одну
однажды: однажды
однократный: однократное
оказаться: оказалось
океан: океанов
около: около
окологалактический: окологалактическую
окрестность: окрестностей
октябрь: октября
операция: операция
опубликовать: опубликовали опубликована опубликованы
особенно: особенно
особенность: особенность
отклонить: отклонил
открытие: открытие открытиям
отметить: отметил
отмечаться: отмечается
относительно: относительно
отсутствовать: отсутствует
охлаждать: охлаждающим
очень: очень
очередной: очередных
очередь: очередь
павлин: павлина
патрик: патрик
пау: пау
первый: первой
передний: переднем
перемычка: перемычки перемычкой
период: период
песенка: песенке
песочный: песочные
план: плане
планета: планете планетой планеты
плоскость: плоскости
плотный: плотного
поверхностный: поверхностных
поверхность: поверхности
подобный: подобные подобных
подповерхностный: подповерхностных
подробность: подробностях
подтверждаться: подтверждается
позволить: позволило
позволять: позволяет
поиск: поиск поиска
полагать: полагают
поле: полем
полициклический: полициклических
полоса: полоса
получать: получать получающего
получить: получен полученное полученном полученные получены получившая
поляризация: поляризации
полёт: полета полеты
помочь: помог поможет
помощь: помощью
пончик: пончик
пополнять: пополняемого
попытаться: попытались
порождать: порождает
портрет: портреты
порядок: порядка
поскольку: поскольку
похожий: похожа похожи похожих
поэтому: поэтому
появление: появление
правдоподобный: правдоподобных
право: правом
предел: пределами
предлагать: предлагают
предназначить: предназначен
предположить: предположить
представить: представлено представлены
представление: представление
представлять: представляет представляющих
предстоять: предстоит
прежде: прежде
препринт: препринтов
приблизиться: приблизился
прибыть: прибыл
привести: привело привести
прижать: прижатых
примерно: примерно
примечательный: примечательная
принять: принявший принял
присмотреться: присмотреться
присутствовать: присутствовать
проанализировать: проанализировав
провести: провести
программа: программы
прогреть: прогретым
продемонстрировать: продемонстрировал
проект: проекта
произойти: произошло
происхождение: происхождения
пролетать: пролетая
пролететь: пролетел
пролёт: пролет пролета пролеты
пропасть: пропавшие
пропускание: пропускания
простираться: простираются
проходить: проходя
прошедший: прошедшей
прошлый: прошлом
пузыриться: пузырящаяся
пульсар: пульсара пульсары
пусть: пусть
путь: пути путь
путём: путем
пылевой: пылевого пылевые
пыль: пыли
пытаться: пытаясь
пятно: пятно
радиоволна: радиоволны
радиовсплеск: радиовсплесками
радиотелескоп: радиотелескоп
разбойник: разбойников
размер: размер
разница: разница разницы
разрешение: разрешение
рамка: рамках
ранее: ранее
ранний: раннюю
раскрыть: раскрыть
распечатка: распечатки
расположить: расположена расположенная расположенную
рассмотреть: рассмотреть
расстояние: расстояние расстоянии
реализация: реализации
ребро: ребра
регулирование: регулировании
редко: редко
результат: результаты
решить: решила
рискованный: рискованный
роднить: роднит
роль: роль
рукав: рукава
рыба: рыбах
сам: самой
самый: самых
сближение: сближение
сверхновый: сверхновая
сверхскопление: сверхскоплении
свет: свете
светить: светят
световой: светового световой световых
светящийся: светящееся
свой: своей своими
связанный: связанным
связать: связаны
связь: связью
сделать: сделали сделанный
себя: собой
сервер: сервере
серебряный: серебряная
сигнал: сигнал сигнала сигналов сигналом сигналы
сильный: сильным
симуляция: симуляцией
система: системе
сказать: сказал
сканирование: сканирования
скопление: скоплений
скорость: скорости скорость скоростью
слабый: слабых
сложный: сложных
слой: слоев слоя
смешивание: смешивания
смонтировать: смонтированная
смотреть: см
снимка: снимку снимок
снимок: снимке
событие: событие
совершенный: совершенных
современность: современности
согласоваться: согласуется
созвездие: созвездию созвездия
создание: создание создания
создатель: создатель
сократить: сократить
солнечный: солнечной
солнце: солнца
сообщение: сообщении
сотрудник: сотрудники
спектроскопический: спектроскопические
специалист: специалисты
спиральный: спиральная спирального спиральной спиральные спиральных
способный: способна
справа: справа
спутник: спутники спутников
сравнение: сравнению
среда: среду
средний: средней
станция: станции
стать: стал
статья: статьи статья
степень: степени
стимулировать: стимулированное
сторона: стороны
страница: страница
странный: странный странным
структура: структур
судьба: судьба
суперпузырь: суперпузырей
существование: существования
сформировать: сформированных
сфотографировать: сфотографировать
сходство: сходство
сценарий: сценарий сценария
считать: считают
считаться: считаться
сэкономить: сэкономил
тайна: тайны
также: также
такой: таким такое
телескоп: телескоп телескопа телескопе телескопом
течение: течение
толстяк: толстяк
тонкий: тонкие
топливо: топлива
тот: ту
траектория: траекторией траекторию
три: трех
тусклый: тусклое
тёмный: темной
увеличить: увеличил
углеводород: углеводородов
угол: углу угол
удалённый: удаленные
удивить: удивил
уильям: уильямом
уменьшить: уменьшило
университет: университета
упоминаться: упоминался
уран: уран
условный: условных
усовершенствовать: усовершенствованной
успешно: успешно
усыпать: усыпанные
утверждаться: утверждалось
уточнение: уточнением
ух: ух
уходить: уходит
участок: участка
учёный: ученые
уэбба: уэбб уэбба
фаза: фазы
февраль: февраля
феномен: феномену
фильм: фильма
фото: фото
фотограф: фотограф
хабблом: хабблом
хаббнуть: хаббла
холодное: холодного
хороший: лучшее
цвета: цветах
целое: целом
цель: цели цель целью
центр: центра
чандра: чандры
частица: частиц
частность: частности
частота: частота частоте
часть: часть
часы: часы
четыре: четыре
четырёхметровый: четырехметровом
числиться: числящейся
член: членом
чёрный: черной черных
штат: штата
щепка: щепка
эйман: эйман
эйфмана: эйфмана
экзолуна: экзолуны
энергия: энергии
этап: этап
этот: эта этих этому
юпитер: юпитер юпитера юпитеру
являться: является
ядро: ядро
яйцо: яйца
ярко: ярко
