австралия: австралии
автоматизированный: автоматизированные
автоматический: автоматический
автор: авторов авторы
агентство: агентством
аккреционный: аккреционного аккреционный
активный: активных
алгоритм: алгоритмов
алексей: алексей
американский: американские
анализ: анализ
аннотация: аннотации
астероид: астероиде
астроновость: астроновости
астроном: астрономы
астрономический: астрономический астрономических
астрономия: астрономии
астрофизик: астрофизики
астрофизический: астрофизической
астроёлочка: астроёлочка
атака: атакой
атакама: атакама
бабочка: бабочка
белый: белый
бенна: бенну
благодаря: благодаря
ближний: ближнем
близкий: ближайшей близкую
богатый: богат
боде: боде
болометрический: болометрическая
больший: большей больших
большинство: большинство
большой: большого большой большом
брильянт: брильянтами
будущий: будущая
бурно: бурно
буря: бури
быстро: быстро
быстрорастущий: быстрорастущие быстрорастущий
важность: важности
важный: важнейшие
век: веке
венера: венере
вероятно: вероятно
весьма: весьма
вещество: вещество
взрыв: взрыва взрывов взрывом
вид: виде
видео: видео
видеть: видеть
видимый: видимая видимых
видный: видна видны
включая: включая
вместе: вместе
вместо: вместо
внешний: внешнюю
внутренний: внутренних
внутри: внутри
возникнуть: возникла возникло
вокруг: вокруг
волна: волн
впервые: впервые
вполне: вполне
время: время
всевозможный: всевозможные
вселенная: вселенной
всплеск: всплесками
вспыхнуть: вспыхнувший вспыхнул
вспышка: вспышки
всё: всё
второй: второй вторых
вулкан: вулкан
выброс: выброс
выбросить: выброшенные
выглядеть: выглядит
вызывать: вызываемым вызываемых
высокий: высоким
высокочувствительный: высокочувствительного
высокоэнергетический: высокоэнергетическим высокоэнергетических
выявление: выявление
выявляться: выявляется
выясниться: выяснилось
газ: газ газа
газопылевой: газопылевой
галактика: галактик галактика галактиках галактике галактики
галлей: галлея
гамма: гамма
гарсия: гарсия
гаснуть: гаснуть
гелий: гелием
глаз: глазами
год: год года годах году лет
горячий: горячи горячие
гравитационный: гравитационных
гравитация: гравитация
грейс: грейс
давать: давал дают
далеко: далеко
дальний: дальнем
далёкий: далекий далеких далеком
данные: данных
дать: данные дать
двойной: двойная
действовать: действующий
десятилетие: десятилетии
детальный: детальнее
джеймс: джеймс джеймса
диаметр: диаметр диаметре
диапазон: диапазон диапазонах
диас: диас
диск: диск диска дисках диски дисков
длина: длинах
длительный: длительный
довольно: довольно
догадаться: догадались
доказательство: доказательств
долгий: долгое
должный: должен должна
долл: долл
доля: доля
дополнение: дополнение
дополнить: дополнит
достаточно: достаточно
другой: других
дыра: дыр дыра дыре дыру дыры
евклид: евклид
европейский: европейская европейским европейской
единица: единиц
завершать: завершает
зависимость: зависимости
запланировать: запланирован
запуск: запуск
запустить: запустит запустить запущен запущенный
затрата: затраты
звезда: звезд звезда звездах звездой звезду звезды
звездообразование: звездообразования
звёздный: звездная звездной звездных
зелёный: зеленая
земля: земли
зерно: зерен
идеальный: идеальной
идентифицировать: идентифицировали
излучать: излучает излучают
излучение: излучением излучения
измерение: измерения
измерить: измерить
изначально: изначально
изображение: изображение изображении изображения
изучать: изучал изучать
изучение: изучения
изучить: изучил изучить
именно: именно
иметь: имеют
инструмент: инструмент
интенсивный: интенсивных
интерферометр: интерферометра
информация: информации информацию
инфракрасный: инфракрасных
ионизировать: ионизирующим
искать: ищут
испанский: испанский
использование: использованием
использоваться: используются
исследование: исследования
исследователь: исследователи
исследовательский: исследовательской
источник: источника источники
исходить: исходит
казаться: казавшаяся
камера: камер
кандидат: кандидата
карлик: карлик карлика
карта: карта карту
каталог: каталоге
каталогизировать: каталогизировал
качество: качестве
квадрат: квадрат
квазар: квазар квазара квазаров квазары
кеплер: кеплера
классификация: классификацию
классифицировать: классифицировать
количественно: количественно
количество: количество
коллизия: коллизия
кольцо: кольцо
комета: кометы
комментарий: комментариев
компактный: компактного
компонент: компонент
конец: конец конце
концентрация: концентрация
коричневый: коричневого
космический: космический космическим
космос: космос
который: которая которого которой которую которые
красный: красная красного красные красным
кроме: кроме
кружка: кружки
крупный: крупнейший
кудрить: кудря
либо: либо
линия: линии
лунный: лунное
луч: лучей
любитель: любитель
магелланов: магеллановом
май: май
малоисследовать: малоисследуемая
марс: марс
март: марта
масса: масс масса массой массу
массивный: массивных
материя: материю
машинный: машинного
мегапарсек: мегапарсека
менее: менее
место: месте
метод: методами
метровый: метрового метровый
миссия: миссии миссий миссия
мишень: мишенью
млечный: млечный
мнение: мнению
многоволновый: многоволновую
многочисленный: многочисленные
молекулярный: молекулярном
момент: момент момента
мочь: могла
мы: нам
наблюдать: наблюдаемой наблюдаемые наблюдаемых
наблюдаться: наблюдавшихся
наблюдение: наблюдений наблюдения
набор: наборы
наводиться: наводиться
надвое: надвое
надёжный: надежными
название: названием
наиболее: наиболее
найти: найдено
накапливать: накапливает
намного: намного
направление: направлению
наращивать: наращивать
наслать: нашли
настолько: настолько
настоящий: настоящий
находиться: находится
начало: начале
наш: наша нашего нашей
небесный: небесных
небо: неба
недавно: недавно
незадолго: незадолго
нейтронный: нейтронная нейтронную нейтронных
немало: немало
необходимый: необходимое
необычный: необычную
непростой: непростых
несколько: несколько
несмотря: несмотря
низкий: низкую
никакой: никаких
новогодний: новогодний
новость: новостей
новый: новая новую новые новый
нэнси: нэнси
обеспечить: обеспечить
обзор: обзор обзора
облако: облака облаке
область: областей области область областью
обнаружить: обнаружен обнаружена обнаружить
обновлять: обновляемого
обозначение: обозначение
обозначить: обозначены
оболочка: оболочку
образ: образом
обсерватория: обсерватории обсерватория
обусловить: обусловленные
обучение: обучения
обширный: обширны
объект: объект объекта объектов объектом объекты
объектив: объективе
обычный: обычная
огромный: огромное
один: одна одним одной
ожидание: ожидании
ожидаться: ожидается
озадачить: озадачила
оказаться: окажется оказался
оказываться: оказывается
около: около
околоземный: околоземную
окружать: окружает
окружающий: окружающей
оно: оно
определить: определил определить
опубликовать: опубликованы
оранжевый: оранжевыми
орбита: орбиту
ординарный: ординарной
освещать: освещает
оседание: оседание
оснастить: оснащен
основной: основные
основный: основная
особенно: особенно
остаток: остатке остаток
отдалить: отдаленные
отклонить: отклонить
открытие: открытия
открытый: открытая открытый открытыми
открыть: открыл
отличить: отличить
отменяться: отменяется
отметить: отметить
оценка: оценкам
очень: очень
падать: падающих
пара: пару
парсек: парсек парсека
первый: первые первых
пересекать: пересекающая
период: период
песочный: песочные
пингвин: пингвин
планетезималь: планетезималей
планироваться: планируется
плоскость: плоскости
плотный: плотный
плюс: плюс
поглощение: поглощения
подобный: подобных
подробный: подробная
подтверждение: подтверждения
позволить: позволит
позволять: позволяют позволяющий
поздний: поздние
поиск: поиск поиска
показать: показана
поле: поля
полмиллиона: полмиллиона
полоса: полоса
получить: полученные получено получивший получил получить
получиться: получилось
полёт: полеты
помочь: помогут
помощь: помощью
понимание: понимания
породить: породить
порядок: порядка
постепенно: постепенно
потребоваться: потребовался
правило: правило
правильный: правильную
превратиться: превратиться
предел: пределами
предназначить: предназначенного
предоставить: предоставил предоставили
предполагать: предполагают
предположение: предположение
предсказывать: предсказывала
представлять: представляет
преследовать: преследует
пресс: пресс
применять: применяют
примерно: примерно
принять: приняли
пристально: пристально
притягивать: притягиваемое
причём: причем
проанализировать: проанализировать
проведение: проведению
проводить: проводимых проводить
проводиться: проводившейся
программа: программа программе программы
продлиться: продлится
продукт: продукты
пропасть: пропавшие
протозвезда: протозвезд протозвезда
протопланетный: протопланетные протопланетный протопланетных
проходить: проходящие
процесс: процесс процессе
прошлогодний: прошлогодних
прошлый: прошлом
прямой: прямого прямые
пузыриться: пузырящаяся
пульсар: пульсара
пурпурный: пурпурная
пустыня: пустыне
путь: путь
пыль: пыли пыль
работа: работа работу
радио: радио
разделять: разделяющий
размер: размер размером
разный: разных
рамка: рамках
раскромсать: раскромсала
расположить: расположен расположена расположенную
расстояние: расстояние расстоянии
расти: растущая
ребро: ребра
результат: результатов результаты
рекорд: рекорд
рекордный: рекордный
релиз: релиз
рентгеновский: рентгеновских
решить: решили
роман: роман
ромб: ромбами
рукав: рукава
ряд: ряда
сайдинга: сайдинг
сам: самой
самый: самые самый самым самых
св: св
сверхгигант: сверхгигант
сверхмассивный: сверхмассивные
сверхновый: сверхновая сверхновой сверхновую сверхновых
свет: свет света
светимость: светимость
световой: светового световой световых
светящийся: светящихся
свидетельство: свидетельств свидетельства
свой: своего
сгусток: сгустки
сегодняшний: сегодняшний
семь: семь
серый: серые
синий: синий
система: система системы
скрытый: скрыта
слабый: слабее
следовать: следует следуют
следующий: следующей
слишком: слишком
слияние: слиянием слияния
смещение: смещением смещения
смотреть: см
смочь: сможет
снимок: снимки
событие: события
современный: современную современных
согласно: согласно
создаваться: создаваться
создать: созданная создать
солнечный: солнечная солнечной
солнце: солнца
соседка: соседки
составить: составило составит
составлять: составляет составлял
спектр: спектра спектров
спектрограф: спектрограф спектрографом
специализироваться: специализируется
спринг: спринг
спутник: спутники
сравнение: сравнения
сравнимый: сравнима
среда: среды
средний: средней
стать: стал стала стали станет
стоимость: стоимость
столкновение: столкновения
столь: столь
столько: столько
сторона: сторон
странный: странным
строиться: строящийся
стягивать: стягивают
существование: существования
съёмка: съемка
также: также
такой: такие таким таких такого
телескоп: телескоп телескопа телескопов телескопом
тельце: тельца
теория: теория
точка: точки точкой
точно: точно
точный: точного точные
транзиент: транзиенты
транность: транности
третий: третьих
триллион: триллионов
трудно: трудно
туманность: туманности туманность
тёмный: темная темные
увеличиваться: увеличивается
удалённость: удаленности
удалённый: удаленных
удаться: удалось
указание: указанием
указывать: указывают
ультрафиолет: ультрафиолет ультрафиолете
ультрафиолетовый: ультрафиолетовая ультрафиолетового ультрафиолетовом ультрафиолетовую ультрафиолетовый ультрафиолетовым
умирать: умиравшей
уран: уран
усилие: усилия
условие: условие
уф: уф
участок: участках
учёный: ученых
уэбба: уэбб уэбба
февраль: феврале
формирование: формирования
формировать: формирует
фото: фото
фотограф: фотограф
франсиско: франсиско
фундаментальный: фундаментальной
хаббл: хаббл
хирон: хирона
ход: ходе
цель: цели
центр: центр центре
чандра: чандры
часть: части часть
часы: часы
четвёртый: четвертой
чилийский: чилийской
число: числе
чрезвычайно: чрезвычайно
чёрный: черная черной черную черные черных
широкий: широкого
эволюционировать: эволюционируют
эволюция: эволюции эволюция
экзолуна: экзолуны
экстремальный: экстремальные
электромагнитный: электромагнитного
эмиссионный: эмиссионные
эмпирически: эмпирически
энергия: энергии
эрг: эрг
этот: эта
эффект: эффектам
эффективный: эффективного
южный: южная южной
юпитер: юпитер юпитера
явление: явлений
являться: является
ядро: ядра
яйцо: яйцом
яркий: ярки яркие яркий ярким яркой ярчайший ярче
ярко: ярко
яркость: яркости яркость
