австралия: австралии
азт: азт
алексей: алексей алексея
америка: америке
анализировать: анализировать
антарктида: антарктиде
аргумент: аргумент
астроновость: астроновости
астроном: астрономов астрономы
астрономический: астрономическом
астрономия: астрономии
астрофизик: астрофизики
атом: атомов
атомный: атомно
африка: африку
барионный: барионная барионного
берег: берега
бетельгейза: бетельгейзе
бинокль: бинокль
благодаря: благодаря
близкий: близкая близкой
близость: близость
боков: боковой
больший: большая
большой: большого большой
борис: борис
борроу: борроу
британский: британского
бугор: бугор
будущий: будущих
быстро: быстро
быстрый: быстрых
важный: важнее важны
великое: великое
величина: величина
вероятность: вероятность вероятностью
версия: версии
верхний: верхнем
вещество: вещества веществе вещество
взгляд: взглядом
взорваться: взорвавшейся
взрыв: взрыва
видеть: видим
видимость: видимости
видимый: видимом
видно: видно
википедия: википедия
виртуальный: виртуальную виртуальные
виток: виток
влияние: влияния
возникать: возникали возникающую
возникнуть: возникли
возраст: возраст возраста
вообще: вообще
восток: востока
время: времени время
вселенная: вселенной вселенную
всплеск: всплеск всплеска всплескам
всё: всё
второе: второе
выброс: выбросом
вывод: вывод
выглядеть: выглядит
выдвинуть: выдвинуты
вызвать: вызван
вызывать: вызывает
высокий: высоким
вычисление: вычисления
вычислительный: вычислительной
галактика: галактик галактика галактике галактики
гамма: гамма
гаснуть: гаснущий
гипотеза: гипотезы
глава: главе
год: год года году лет
горгон: горгона
гпк: гпк
гринвич: гринвичу
группа: группа
далее: далее
далеко: далеко
далековато: далековато
дальний: дальнего
данный: данное данном
дарем: дарема
дата: дата
действительно: действительно
декабрь: декабря
дело: дело
день: дни
десять: десять
джеймс: джеймс
джош: джош
диаметр: диаметра
диапазон: диапазон диапазоне
диск: диска
длина: длиной
длинный: длинный длинным
довольно: довольно
домашний: домашней домашний
достаточно: достаточно
древоном: древоном
другой: других
дыра: дырой дыру
евклид: евклид
евразия: евразию
житель: жители
журнал: журнале
жюльеном: жюльеном
жёсткий: жесткий
занять: занял
затемнение: затемнение
затмение: затмение затмения
затравка: затравкой
звезда: звезд звезда звезды
земля: землей земли
земной: земной земную
зона: зона
зондовый: зондовую
зрение: зрения
излишний: излишне
излучение: излучение излучения
изменение: изменение изменения
изображение: изображений изображения изображениями
изучение: изучение
изучить: изучила
иметь: имеют
имитация: имитацией
иной: иным
институт: института
интеграл: интеграл
интересный: интересный
интерпретироваться: интерпретируется
интерферометр: интерферометр
инфракрасный: инфракрасном инфракрасный
исключение: исключением
исключительно: исключительно
использовать: использовала использовали использовать используемая
исследование: исследование исследовании исследования
исследователь: исследователей исследователи
история: истории
источник: источник источника
казань: казань
казаться: казалась
каковой: каковые
картина: картина
килоновый: килоновая килоновую
класс: класса
количество: количеству
коллапс: коллапсом
коллапсарный: коллапсарным
команда: команда
компьютер: компьютер
компьютерный: компьютерное компьютерных
консорциум: консорциум
короткий: короткий
корректный: корректна
космический: космического космической
космология: космологии
космос: космос космосе
котлета: котлета
который: которого которую которые который
край: край
крайний: крайней
краснеть: краснела
красный: красный
кремний: кремния
кристалл: кристалл кристалла кристалле кристаллов кристаллы
кроме: кроме
крузалеб: крузалебом
кубический: кубического
кудрить: кудря
лазурный: лазурного
лишний: лишним
лишь: лишь
ломоносов: ломоносов
луна: луна луны
лунный: лунного лунное
любой: любой
магнитар: магнитар
магнитуда: магнитуды
максимально: максимально
максимальный: максимальное
марс: марс
март: марте
масса: масс масса массы
массивный: массивной
масштаб: масштабе
материя: материя
машина: машина
мгновение: мгновение
мгу: мгу
мегапарсек: мегапарсек
межпланетный: межпланетной
мера: мере
место: места месте место
метод: метод
миллиард: миллиарды
миллуром: миллуром
минута: минут
миссия: миссии
михаил: михаил
многий: многих
многоканальный: многоканальной
моделирование: моделирование моделирования
моделировать: моделируя
модель: модели модель
молекула: молекулы
момент: момент моменту
монооксид: монооксида
мочь: могла могли могло могут
мощность: мощности
мпк: мпк
мы: нам
мягкий: мягком
наблюдательный: наблюдательной
наблюдать: наблюдаемо наблюдали
наблюдаться: наблюдавшееся наблюдается
наблюдение: наблюдений наблюдения наблюдениям
нагреваться: нагревается
нагрузка: нагрузку
называть: называемая
найтись: найдется
нанометр: нанометра
население: населения
насколько: насколько
наслать: нашли
настоящий: настоящий
наступление: наступления
наука: наука науки
находиться: находилась находилось находится
начало: начало
наш: наш нашей
небо: неба
невооружённый: невооруженным
недавний: недавнее
недреманный: недреманное
нейтрино: нейтрино
нейтронный: нейтронные нейтронных
неплохо: неплохо
непохожий: непохожа
нижний: нижних
новость: новостей
новый: новая новое новой новый
ночной: ночного
ночь: ночь
оба: обе
обзор: обзор
облако: облака облако
оболочка: оболочка оболочке оболочку
образ: образом
образование: образованием образовании образования
обсерватория: обсерватории обсерватория
общий: общая
объявить: объявили
объясняться: объясняется
объём: объема
обычный: обычная обычного
овен: овна
огромный: огромную огромный
один: одна
однако: однако
оказаться: оказалась
океания: океании
око: око
около: около
окончание: окончание
октябрь: октябре октября
описание: описания
определить: определено определить
определять: определять
определённый: определенного
оптически: оптически
опубликовать: опубликовано
орбита: орбите
основное: основном
основный: основное
особенность: особенностью
остыть: остыла
охарактеризовать: охарактеризовать
охватить: охватила
очевидный: очевидная
очень: очень
пара: пара пары
первый: первые первых
переменный: переменная
период: период
пиар: пиар
планета: планеты
планироваться: планируется
поверхность: поверхности поверхность
погружаться: погружалась
погрузиться: погрузилось
подтверждение: подтверждение
позволить: позволит
позволять: позволяет
поздний: позднее
показать: показана
покрыть: покрыта
полагать: полагают
полнолуние: полнолуния
полностью: полностью
полный: полной полным
положение: положение
полуправильный: полуправильная
полутеневой: полутеневая полутеневого полутеневое полутеневых
полутень: полутень полутенью
получение: получения
получить: полученными получили
полушарие: полушария
польза: пользу
помощь: помощью
понимание: понимания
понять: понять
попытаться: попытаются
портрет: портрет
порядок: порядков
послесвечение: послесвечение послесвечения
постепенно: постепенно
поток: потоку
потратить: потратил
похожий: похож
поэтому: поэтому
практически: практически
превосходить: превосходит
превышать: превышает
предел: пределах
предполагать: предполагаемой предполагали
предыдущий: предыдущие
приливный: приливное
примерно: примерно
приморье: приморья
принцип: принципе
принять: приняла
природа: природе
пришествие: пришествие
провести: провели
продолжаться: продолжалось
продолжительность: продолжительность продолжительностью
проект: проекта
проекционный: проекционном
проекция: проекция
произойти: произошел произошло
проинтерпретировать: проинтерпретировал
происходить: происходили происходит
промежуточный: промежуточной
проследить: проследили
прослеживаться: прослеживаются
простираться: простирается
противостояние: противостоянию
процессор: процессоров
процессорный: процессорных
прочный: прочные
прошлогодний: прошлогоднему
проявиться: проявилась
прямой: прямое
пустота: пустоте
пылинка: пылинок
пыль: пыли пыль
пьер: пьером
пятно: пятна
ради: ради
радиационный: радиационное
радиоактивный: радиоактивный
радиовсплеск: радиовсплесках
радиус: радиус
развиваться: развивались
размер: размером
разрешение: разрешением разрешения
разрушение: разрушение
ранее: ранее
ранний: ранней
рано: рано
распадаться: распадающийся
расплавить: расплавлена
располагаться: располагаясь
расположение: расположение
распределить: распределили
расстояние: расстоянии
расширяться: расширяющейся
реальный: реальными
ревнивец: ревнивцев
результат: результате результаты
род: рода
россия: россии
ряд: ряд ряду
самый: самым самых
сверхгигант: сверхгигант
сверхновый: сверхновой сверхновую
свет: свете
светило: светилом
светиться: светится
световой: световых
свидетельствовать: свидетельствует
свинец: свинца
свой: своего своей своему
связать: связаны
северный: северного северной
секунда: секунды
сеть: сетью
скопление: скопления
скучный: скучна
след: следы
следовательно: следовательно
слишком: слишком
слияние: слиянием слиянии
служба: службы
служить: служить
случай: случае
смелый: смелый
сми: сми
смотреть: см
снижение: снижение
снимка: снимок
собранный: собранных
собственный: собственной
событие: событие события
совпадение: совпадение
совпасть: совпавшие
содержать: содержат
созвездие: созвездии
солнечный: солнечных
солнце: солнца солнцем
сомнение: сомнение
соответствовать: соответствует
соседствовать: соседствовала
состав: состав
составлять: составляет
сохраняться: сохраняться
спектр: спектр спектре
спектро: спектро
спутник: спутник спутники
сравнительно: сравнительно
сравнить: сравнить
среднее: среднего
срез: срез среза
стандартный: стандартная
станция: станций
старший: старше
статистический: статистической
стать: стал стала
стерлинг: стерлингов
стоимость: стоимостью
столкновение: столкновения
столь: столь
сторона: стороны
страна: стран
стремиться: стремится
структура: структуре
суперкомпьютер: суперкомпьютер
сформироваться: сформироваться
считаться: считается считалось
также: также
такой: таким такое таком
твёрдый: твердой
телескоп: телескоп телескопа телескопов
тело: тела
теневой: теневым
тень: тень
теоретически: теоретически
теоретический: теоретической
теория: теории теория
тепловой: теплового тепловой
территория: территории
типичный: типичную типичный
толстой: толстой
толщина: толщиной
томография: томографию
тонкий: тонкий
точка: точек точки
точность: точностью
точный: точного
трв: трв
требоваться: требуется
триангуляция: триангуляции
трудно: трудно
тусклый: тусклее тусклой
тысяча: тысячами тысячу
тёмный: темная темное темном
увидеть: увидеть
указывать: указывает указывают
улететь: улететь
университет: университета
уран: уран
устойчивый: устойчивые
уступать: уступает
уточнение: уточнение
учёный: ученые
учёт: учетом
уэбба: уэбб
фаза: фаз фазе фазы
факт: факт
фенотип: фенотипу
фидуциарный: фидуциарного
физика: физика
фиксировать: фиксируют
фильтр: фильтрами
флорентин: флорентином
фокусироваться: фокусировались
формирование: формирование
фото: фото
фотон: фотонов
фотосфера: фотосфера фотосферы
франция: франция
фунт: фунтов
хаббл: хаббл
характер: характер
химический: химический
холодное: холодного
хотя: хотя
хронометр: хронометрами
циркон: циркона цирконе цирконы
час: час часа часов
частичный: частичного частичное частичной
часто: часто
часть: часть
человек: человек
чисто: чисто
чёрный: черной черную
штерн: штерн
эволюционировать: эволюционировали
эволюция: эволюции эволюцию эволюция
эксперт: эксперты
элемент: элемент
энергия: энергии энергия
эра: эры
эффект: эффект
южный: южной
юпитер: юпитером
являться: является являются
ядро: ядра
яркий: яркая яркий ярким ярких ярчайший ярче
яркость: яркости яркостью
