автоматический: автоматическая
автор: автор
агентство: агентства
акацук: акацуки
аккрецировать: аккрецируют
аккреция: аккреция
активно: активно
активность: активность
активный: активного активные
алай: алая
алексей: алексей алексея
аппарат: аппарата
апрель: апреля
арктур: арктур
архив: архиве
астероид: астероид
астроновость: астроновости
астроном: астрономов астрономом
астрономия: астрономии
астрофизик: астрофизике астрофизики
астроёлочка: астроёлочка
аэрокосмический: аэрокосмических
аяг: аяг
батарея: батареи
белый: белый белых
богатый: богатую
больший: большим
большинство: большинство
большой: велик
буря: бури бурь буря
быстро: быстро
быть: будут
важно: важно
вблизи: вблизи
вега: вега
ведущий: ведущий
великолепный: великолепные
величина: величина величины
вероятно: вероятно
вероятный: вероятных
вертолетик: вертолетик
верхновое: верхновые
весна: весной
ветер: ветра
вечером: вечером
вещество: вещества вещество
взрыв: взрывы
вид: вид вида виды
видимый: видимая видимом
вильнюс: вильнюс
виновник: виновником
включать: включает
внешний: внешнего
внимательно: внимательно
вовремя: вовремя
возможно: возможно
возможность: возможность
возмущение: возмущение возмущений возмущения
возникнуть: возникли
возобновить: возобновлено
возрастание: возрастанию
вокруг: вокруг
восстановить: восстановить
впервые: впервые
время: времени время
вселенная: вселенная вселенной
вспышечный: вспышечную
вспышка: вспышка вспышки вспышку
всё: всё
входящий: входящий
выброс: выброса выбросы
вывести: выведены
вызвать: вызвавшая вызвало
вызывать: вызывают
выйти: вышла
высокий: высоких высокой
выход: выход
выше: выше
газ: газом
газопылевой: газопылевых
галактика: галактик галактика галактике галактики галактикой галактику
галактический: галактических галактическое
геомагнитный: геомагнитная геомагнитного геомагнитные геомагнитных
германский: германском
гершель: гершелем
главный: главных
глаз: глазами глазом
глубокий: глубокий
го: го
год: года годах году лет
гравитационный: гравитационного
группа: группа группы
давать: дающие
далёкий: далеких
данные: данных
дармштадт: дармштадт дармштадте
два: две двух
двигатель: двигатели двигателям
двигательный: двигательная
двойной: двойных
дева: девы
декабрь: декабрь декабря
делать: делают
делить: делят
демонстрировать: демонстрирует
день: дней
детектирование: детектированием
диапазон: диапазоне
динамичный: динамичные
динкинеш: динкинеш
добиться: добиться
должный: должен
достаточный: достаточное
др: др
древний: древнейший
другой: другие
дыра: дыры
евклид: евклида
европейский: европейского
ждать: ждут
журнал: журнале
жёсткий: жестких
завершиться: завершилась
зависимость: зависимости
закатиться: закатились
закручиваться: закручиваются
запланировать: запланирован
заснять: заснял
затем: затем
зафиксировать: зафиксирована
зачастую: зачастую
защитить: защищенным
звезда: звезды
звездообразование: звездообразования
звёздный: звездная
земля: земле земли
земной: земной
зигзаг: зигзаг
зонд: зонд зонда
зрение: зрения
идеально: идеально
излучение: излучения
изменение: изменения
изображение: изображение изображений изображения
изучать: изучать
ики: ики
именовать: именуют
имя: имени
индекс: индекса
инженер: инженерам
интерес: интерес
интересный: интересное интересной интересные
исзф: исзф
использовать: использовать
использоваться: используются
исследование: исследований исследованию
исследователь: исследователи
источник: источников
итог: итогом
каждый: каждые
карлик: карлик карликов
карликовый: карликовой карликовую
карта: карте карты
катаклизм: катаклизмов
катаклизмический: катаклизмических
каталог: каталог каталога каталоге
квазар: квазар
квинтет: квинтет
келси: келси
кеплер: кеплера
класс: класса
классификация: классификацию
классифицировать: классифицированных
кокон: коконах
количество: количество количеством
кольцо: кольцо
комета: комета
комментарий: комментариев
компаньон: компаньонов
координата: координатах координаты
корона: корона
корональный: корональной
космический: космическая космического
космолог: космологам
космос: космос
который: которая которой которые который которым которых
кп: кп
красивый: красивейшие
красный: красного
кривая: кривые
критический: критической
кудрить: кудря
кэв: кэв
лаборатория: лаборатория
легко: легко
лететь: летящего
линзовидный: линзовидная линзовидные линзовидных
линзообразный: линзообразную
литва: литва
луч: лучах
магелланов: магеллановом
магнетар: магнетара
магнитная: магнитной
магнитный: магнитная магнитного
магнитосфера: магнитосфера магнитосферы
май: мая
максимально: максимально
максимальный: максимального
малый: малом
манёвр: маневр маневра
марсианский: марсианский
март: марта
масса: массе массы
меняться: меняются
меркурий: меркурий меркурию меркурия
место: местах
миллиард: миллиардов
мимо: мимо
минимум: минимум
минута: минуты
мир: мир
миссия: миссии миссия
млечный: млечного
мнение: мнения
многий: многих
множество: множеством
модель: модель моделях
модуль: модуль
молодой: молодые
момент: момент
мочь: могут можем
мощность: мощности мощность
мощный: мощной мощные
мпк: мпк
наблюдать: наблюдаемой наблюдали
наблюдаться: наблюдались наблюдался
наблюдение: наблюдений наблюдения
наглядно: наглядно
назад: назад
название: названия
найти: найти
наметить: намечен
направить: направлены
направление: направление
наследие: наследие
настолько: настолько
настоящий: настоящий
научный: научной научные научный
находиться: находятся находящиеся
начало: начала
начать: начать
начаться: начавшись
наш: нашей
небесный: небесную
небо: неба небе небо
небывалый: небывалые
невидимый: невидимой
невооружённый: невооруженным
негласный: негласное
недостаточно: недостаточно
недоступный: недоступны
необработанный: необработанных
необходимость: необходимости
необычный: необычная
неправильный: неправильные
непрерывно: непрерывно
нептун: нептуна
несколько: нескольких несколько
низкий: низкая
новогодний: новогодний
новый: новая новом новые новый
номер: номера
ночной: ночном
ночь: ночь
нынешний: нынешнего
оба: оба
обзор: обзор обзора обзоров
облако: облаке
область: области область областью
обнаружить: обнаружена обнаруженных обнаружили обнаружим обнаружить
образование: образования
образоваться: образовались
обсерватория: обсерватории обсерватория
общий: общей
объединить: объединенные
объект: объект объекта объектов объекты
объектив: объективах
обычный: обычной
огромный: огромное
один: одной
одинаковый: одинаковых
однако: однако
оказаться: оказалось
около: около
окружающий: окружающее окружающей
октябрь: октября
они: ними
определить: определить
определять: определять
оптимально: оптимально
оптимистичный: оптимистичные
оптический: оптических
орбита: орбите орбиту
орбитальный: орбитального орбитальной
осмотреть: осмотрено
основа: основе
основание: основании
основный: основных
особый: особый
остаться: остались
осторожный: осторожные
отдел: отдела
открытый: открытое
отметить: отметить
отмечать: отмечают
относительно: относительно
отождествление: отождествления
отслеживать: отслеживает
отчётливый: отчетливые
отыскивать: отыскивать
оценивать: оценивать
оценить: оценить
оценка: оценкам
очень: очень
очередной: очередной
павлинский: павлинского
пасечник: пасечника
первый: первые первый
передать: передать
пережить: пережила
перелёт: перелета
перелётный: перелетный
переменный: переменных
пиковый: пиковая
плазма: плазмы
планета: планеты
планироваться: планируется
плевок: плевок
плоскость: плоскости
плотность: плотность
повлиять: повлияет
повторный: повторная
повышенный: повышенная
поглотить: поглотила
подкласс: подклассов
подобрать: подобранным
подойти: подошедшие
подходящий: подходящим
позволить: позволили
позволять: позволяют
пока: пока
полгода: полгода
полдень: полудню
поле: поля
полный: полного полную полный
положение: положение положения
полоса: полосы
полтора: полутора
получить: полученное полученных
полушарие: полушарии полушария
полярный: полярное полярных
полёт: полетом
поменять: поменять
помогать: помогают
попасть: попал
породить: породят
порядок: порядка
последующий: последующих
постоянный: постоянную
построение: построением
поэтому: поэтому
пояснить: пояснил
практически: практически
прародитель: прародитель
превысить: превысила
превышать: превышал
предварительный: предварительным
предположение: предположения
представить: представлен
представлять: представляют представляя
прежний: прежнего
препринт: препринтов
прибыть: прибыть
привет: привет
привнести: привнесло
примерно: примерно
принять: принята принято
природа: природу
присутствие: присутствие
причина: причиной
проблема: проблемы
проверять: проверяющих
проводить: проводил
продолжить: продолжило
произойти: произошедших
происходить: происходит происходят происходящие
пролетать: пролетал пролетают
промахнуться: промахнулись
пропасть: пропавшие
протозвезда: протозвезд
профессор: профессор
прощать: прощай
публикация: публикации
пульсар: пульсара пульсары
путь: пути
путём: путем
пылевой: пылевые
пыль: пыли
пытаться: пытаются
пятно: пятен пятна
пять: пяти пять
работа: работы
работать: работать работающая
раз: раза
разбушеваться: разбушевалось
разделять: разделять
различный: различные
размер: размер размеры
ран: ран
расположить: расположена
распространиться: распространилась
расстояние: расстояние расстояния
расходиться: расходятся
расширение: расширения
рг: рг
реагировать: реагировать
результат: результате
рекорд: рекорд
рентгеновский: рентгеновских рентгеновского рентгеновской рентгеновскую
российский: российской
сазонов: сазонов
самый: самое
сверхмассивный: сверхмассивные
сверхновый: сверхновая сверхновой сверхновых
свет: света
светимость: светимости
свеча: свечами
свой: своего своих
свёртка: свертки
сгусток: сгустки
себя: собой
северный: северная северного
сентябрь: сентябрь сентября
сергей: сергей
сила: силу
сильный: сильнейшее
символ: символов
система: систем систему
ситуация: ситуацию
сияние: сияние сияний
сканирование: сканирование
сканировать: сканировал
сколько: сколько
скопление: скопление
скорее: скорее
скорость: скорость
слабый: слабее
слияние: слияние слияния
сложность: сложности
сложный: сложная сложного
случай: случае
смещение: смещения
смотреть: см смотрим
смочь: смог
снижение: снижение
снимка: снимок
снимок: снимке снимки
событие: событий события
совершать: совершая
совершенно: совершенно
совместный: совместная
согласно: согласно
созвездие: созвездии
создание: создания
солнечный: солнечного солнечной солнечные солнечных
солнце: солнца солнце
сомбреро: сомбреро
сообщить: сообщила сообщило
соответственно: соответственно
соревнование: соревнование
состав: состав
составить: составил составила
сотня: сотен
сотрудник: сотрудник
сохранение: сохранении
спектр: спектр
специалист: специалисты
спиральный: спиральные
спутник: спутнике
сразу: сразу
срг: срг
среда: среды
среди: среди
ставить: ставили
стандартный: стандартными
стараться: старается
стать: стал стала
статья: статье статьи
стефан: стефана
стоить: стоит
столетие: столетии
структура: структура
существование: существования
сфера: сферу
схожий: схожие
также: также
такой: такие
текущий: текущем
телескоп: телескоп телескопа телескопом
теория: теории
течение: течение течением
тип: тип типа
тот: той
точечный: точечных
точка: точки
точность: точностью
триллион: триллионах
трио: трио
трудиться: трудились
тукан: тукана
туманность: туманность
тысяча: тысячи
тяга: тяги тягу
тёплый: теплый
угловой: угловой угловые
удаться: удалось
уильям: уильямом
уникальный: уникальный
управление: управления
уран: уран
уровень: уровень уровней уровня
усилиться: усилилась
установка: установка
утратить: утратили
учёный: ученые
уэбба: уэбба
физический: физических
фильтр: фильтром
фото: фото
фотонный: фотонных
хаббл: хаббл
хаббнуть: хаббла
характеризовать: характеризует
характеристика: характеристик
ход: ход ходе
цель: целей цель
центр: центра центрах
цикл: цикле
цупа: цупе
чандра: чандры
чанъэ: чанъэ
часто: часто
часть: часть
четверть: четверти
четвёртый: четвертого
четыре: четыре
четырежды: четырежды
чёрный: черные
шесть: шесть
широкий: широкие
эйнштейн: эйнштейна
экзолуна: экзолуны
электрический: электрическая
электронный: электронных
электроэнергия: электроэнергии
эллиптический: эллиптические
энергия: энергий
эпоха: эпоху
этот: эта этих
южный: южном
юпитер: юпитер
являться: является
ядро: ядра
язев: язев
японский: японского
яркий: яркие
яркость: яркость
