ага: ага
агс: агс
адрон: адронов адроны
адронный: адронного адронном адронных
азот: азот азота
аккрецировать: аккрецирующие
аккреция: аккреция
активный: активные активных
актуально: актуально
аматэраса: аматэрасу
американский: американского
анализ: анализ анализа анализом анализу
андромеда: андромеды
анизотропия: анизотропию
аргентина: аргентине
астрономический: астрономические
астрономия: астрономии
астрофизик: астрофизики
астрофизический: астрофизические астрофизическую
атмосфера: атмосферу
атмосферный: атмосферном атмосферный
база: базу
базовый: базовых
бак: баки
безлунный: безлунной
беседа: беседу беседы
блазар: блазары
близкий: ближе близок
близко: близко
бог: боже
боковой: боковым
больший: большая большее большие больших большую наибольшие наибольшую
большой: большое большой велика побольше
борис: борисов
борт: бортом
брать: брать
будоражить: будоражит
буквально: буквально
быть: будем буду будут
важный: важнейших важную
ваш: ваша вашей вашему
ввести: ввести
вдаваться: вдаваться
величина: величина
верно: верно
верный: верна
вероятность: вероятность вероятностью
вероятный: вероятны
вертикальный: вертикальная
вести: ведет
весь: весь всем вся
вечером: вечером
вещь: вещей
взять: взял взять возьмете
видеть: видели видим видите видят
видно: видно
вклад: вклад
включать: включают
вне: вне
внегалактический: внегалактическими внегалактических внегалактического внегалактическое внегалактической внегалактическом
внимание: вниманию
внутри: внутри
вода: водой
воздух: воздуха
возможно: возможно
возможность: возможность
возможный: возможное возможные возможными
возникать: возникает
возрастание: возрастанием
войд: войда
вокруг: вокруг
волна: волны
воображение: воображение
вообще: вообще
вопрос: вопрос вопросы
восприниматься: воспринимаются
восстанавливаться: восстанавливается
восстановить: восстановить восстановленная
вписываться: вписываются
вполне: вполне
временами: временами
время: времена времени время
вроде: вроде
вряд: вряд
вселенная: вселенной вселенную
вскоре: вскоре
всплеск: всплеск всплески
вспышка: вспышками вспышки
всякий: всякая
всё: всё
вторичный: вторичные
второе: второе
второй: вторая вторых
вывернуть: вывернутым
вывод: вывод выводы
выдавать: выдают
вызывать: вызывало
выйти: выйдет
выполнить: выполнено
выполнять: выполняя
выразить: выражено
высокий: высоких высокой
высокоэнергичный: высокоэнергичная высокоэнергичной высокоэнергичные высокоэнергичных
выставить: выставить
выходить: выходило выходит
выше: выше
выяснить: выяснить
выясниться: выяснилось
газ: газ
галактика: галактик галактиками галактиках галактике галактики
галактический: галактический галактического галактическое
гамма: гамма
гзк: гзк
гибрид: гибрид
гиперновый: гиперновые
гипотеза: гипотез гипотеза
глаз: глаз глазом
говорить: говорил говорили говорит говорить говорю говоря говорят
говориться: говорится
год: года лет
гораздо: гораздо
горячий: горячее горячий горячим
градус: градусов
градусный: градусного градусной
грайзть: грайзена
графика: графика графике
грубо: грубо
группа: группа группами группе группой
гс: гс
давать: давайте давали дают
дагвэя: дагвэй
далее: далее
далеко: далеко
дальнейший: дальнейшей дальнейшему
данные: данным данными данных
данный: данном
дать: данная данной данные
два: двумя двух
двадцать: двадцать
действие: действием
действительно: действительно
делаться: делается делаются
дело: делами деле
десятка: десятки десяток
десяток: десятка десятков
десять: десять
детектор: детектор детектора детекторами детекторов детектором детекторы
джет: джетом
диагональный: диагональная
диапазон: диапазоне
длина: длина длину
добавить: добавили
добираться: добирается
добиться: добиться
довольно: довольно
доказать: доказать
докладывать: докладываем
документировать: документировано
долгий: долгое
должный: должен должно должны
доля: долей доли долю
дополнительный: дополнительных
допустить: допустим
достаточно: достаточно
достигнуть: достигнут
достижение: достижений
достоверно: достоверно
достоверность: достоверности достоверность
друг: друг друга
другой: другие другим другими других другого
думать: думаем думал
дыра: дыр дыра дыры
единица: единицы
единственный: единственное
ждать: ждать
железо: железа железо железом
жизнь: жизни
журнал: журнале
жёсткий: жестким
зависимость: зависимости зависимость
загадка: загадка
загадочный: загадочной
задавать: задавал задают
задача: задача задачи
закономерность: закономерности закономерность
закрывать: закрываю
закрытый: закрыта
заниматься: занимается
запутать: запутанная
заработать: заработать
зарегистрировать: зарегистрировал зарегистрирована зарегистрированная зарегистрированного зарегистрированными зарегистрированных зарегистрировано
заряд: заряд
зарядить: заряженная заряженные
заслуживать: заслуживает
затруднять: затрудняло
зацепин: зацепина
звезда: звезда звезды
звездообразование: звездообразования
земля: земли
земной: земной
знаменитый: знаменитая
знание: знание знаний
знать: знаем знаете знаю
значение: значения
значимость: значимость
значит: значит
значительный: значительное значительную
зона: зоне зону
зрение: зрения
игра: игры
идеально: идеально
идея: идей идею
идти: идет идущие
известный: известна известны известные
извлечь: извлечь
излучаться: излучается
излучение: излучение излучении излучения
измерение: измерениями
измерить: измерено
изучить: изучен изучено
именно: именно
иметь: имеет имела имело имеют имея
иметься: имеющихся
иначе: иначе
индивидуально: индивидуально
иной: иным
институт: института
интеграл: интеграл
интеллект: интеллект интеллектом
интенсивность: интенсивности интенсивность
интервью: интервью
интересно: интересно
интересный: интересна интересная интересный
интерпретация: интерпретацией интерпретации интерпретацию
интриговать: интригует
ионизированный: ионизированные
ионизировать: ионизируют
искать: ищете
исключаться: исключаются
исключить: исключили исключить
искусственный: искусственный искусственным
использовать: использовали используя
испускать: испускать испускают
испытательный: испытательном
исследование: исследование исследований
исследователь: исследователей
история: историю история
источник: источник источника источниками источнике источники источников
исходить: исходить исходя
исходный: исходное
исчезающе: исчезающе
итог: итоге
ияи: ияи
каждый: каждого каждой
казаться: кажется
каков: какова каково
какой: какие какое какому какую
кальций: кальций
канд: канд
кандидат: кандидаты
карло: карло
картинка: картинка картинке
качество: качестве
квант: квант кванты
квантовый: квантов
кислород: кислорода
класс: классы
количество: количество
коллаборация: коллаборацией коллаборации
коллега: коллега
коллегиальный: коллегиальная
комментарий: комментарии
коммерсантъ: коммерсантъ
компактный: компактные
компонент: компонент компонента
компьютер: компьютере
конкретно: конкретно
конкретный: конкретное конкретной
консенсус: консенсус консенсусу
консервативный: консервативный
контекст: контексте
конференция: конференциях
концентрация: концентрации концентраций концентрацию
корреляция: корреляции корреляцию корреляция
космический: космические космическим космических космической
который: которая которого которое которой которую которые который
краб: краб
край: крае краю
крайний: крайней
кремний: кремний
кроме: кроме
кузнецов: кузнецов кузнецова кузнецовым
кузьмин: кузьмина
кусочек: кусочек
лаборатория: лаборатории
легко: легко
лежать: лежат
лететь: летит летят
либо: либо
ливень: ливень ливне ливней ливнях
линия: линия линиями
лишний: лишним
лишь: лишь
луч: лучах лучей лучи
любой: любой любом
любопытно: любопытно
магнитара: магнитарами магнитары
магнитный: магнитного магнитное магнитные магнитным
май: мая
максим: максим
максимально: максимально
максимальный: максимальное
максимум: максимум
маленький: маленькая маленькие маленьким маленькое маленькой меньше
мало: мало
малый: меньшей меньшем меньших меньшую
масса: массы
масштаб: масштаб
мат: мат
материя: материей материи материю материя
машинный: машинного машинном
мгу: мгу
мегапарсек: мегапарсека
медведица: медведицу медведицы
международный: международной
менее: менее
мера: мере
мерка: меркам
местный: местного
место: мест места месте место
метод: метод метода методом
миллиард: миллиардов
миллион: миллионов
минимальный: минимальная
минимум: минимум
минус: минус
михаил: михаил михаила михаилом
мкгс: мкгс
многий: многих
многое: многом
моделирование: моделирование моделированием моделирования
моделироваться: моделируется моделируются
модель: модели моделью моделями моделях
модернизация: модернизации модернизацию
мой: моей
молекула: молекулы
момент: момент
монт: монте
морфология: морфология
мочь: могла могу могут можем
мощный: мощные
мпк: мпк
мпс: мпс
муха: мухи
мы: нам нами
мюон: мюонами мюонов мюоны
мюонный: мюонная
набираться: набираться
наблюдать: наблюдаемый наблюдали наблюдать
наблюдаться: наблюдается
наблюдение: наблюдений наблюдения
набор: набор
наверное: наверное
надежда: надежда надежду
наделать: наделав
надеяться: надеемся
надёжно: надежно
назад: назад
название: название
наземный: наземная наземные наземным наземными наземных
называть: называемый называли называть
называться: называется
наиболее: наиболее
наизнанку: наизнанку
найти: найдете найти
наличие: наличия
наложить: наложить
наметить: намечено
нанести: нанесены
наоборот: наоборот
написать: написано
напоследок: напоследок
направление: направление направлением направлении направлению направления
например: например
насколько: насколько
наука: наук наука
научный: научном научный научных
находиться: находится находиться
начало: начало
начать: начал начали
начинать: начинали начинают начиная
наш: наш наша нашего нашей нашу
нгс: нгс
невидимый: невидимый
невооружённый: невооруженным
недавно: недавно
недоставать: недостает
недостаточно: недостаточно
недреманный: недреманное
нейронный: нейронные
нейтрино: нейтрино
нейтронный: нейтронные
некий: некая некую
некоторый: некоторую некоторые
немаленький: немаленькая
немаловажный: немаловажно
немножко: немножко
немой: нем
необходимо: необходимо
необходимый: необходимую
необычный: необычного
неожиданно: неожиданно
неожиданный: неожиданного
неопределённость: неопределенности неопределенность неопределенностью
непростой: непростая
несколько: нескольких несколько
несмотря: несмотря
нетривиальный: нетривиальный
низкий: низкой
низкоэнергичный: низкоэнергичные низкоэнергичных
никак: никак
никто: никто
новый: новая нового новое новой
ночью: ночью
ноябрь: ноябре
ноябрьский: ноябрьскую
нравиться: нравится
нужно: нужно
обеспечить: обеспечить
обилие: обилии
обиход: обиходе
область: области область
обнаружить: обнаружил обнаружили обнаружить
обработка: обработки
образ: образом
образовать: образована
обратный: обратная
обсерватория: обсерватории обсерватория
обсудить: обсудим
обсуждать: обсуждаемая обсуждаемой обсуждает обсуждать
обсуждаться: обсуждается
обучаться: обучаются
обучение: обучение обучении обучения
общий: общем общий
объединять: объединяющая
объект: объекты
объявить: объявлено
объяснить: объяснить
объём: объеме
обычно: обычно
обычный: обычной
обязанность: обязанностей
ограничение: ограничение ограничения
ограничить: ограничить
огромный: огромной
один: одна одними одного
одиночество: одиночестве
оже: оже
ожидать: ожидаем ожидаемых
ожидаться: ожидалось
означать: означает
оказаться: оказалась оказалось
оказываться: оказывается
око: око
около: около
окончательно: окончательно
окончательный: окончательный
окрестить: окрестили
окрестность: окрестности
октябрь: октября
олимпийский: олимпийские
оно: оно
описание: описанием
оправдывать: оправдывает
определение: определение определению определения
определённый: определенной определенный определенным
опубликовать: опубликована опубликовать
орбита: орбите
организационный: организационной
основа: основе
основать: основано
основное: основном
основный: основного
особенно: особенно
особый: особого
оставаться: оставалась остается остаются
оставить: оставил
оставлять: оставляем
остальной: остальные
ответить: ответить
отдельный: отдельная отдельной отдельные отдельными
откалываться: откалывается
отклонение: отклонение отклонении отклонения отклонениях
отклоняться: отклоняется отклоняются
открытие: открытие открытий открытия
откуда: откуда
отличаться: отличается
отложить: отложили
отметить: отметили
относительно: относительно
отношение: отношения
отнюдь: отнюдь
оценивать: оцениваем
очень: очень
очередной: очередной
очертить: очертить
ошибка: ошибка ошибке ошибкой ошибок
пара: пару
парадокс: парадокс
параллельно: параллельно
параметр: параметр параметров
первичный: первичная
первоначально: первоначально
первоначальный: первоначальной
первооткрыватель: первооткрывателей
первый: первых
передний: переднем
перепроверять: перепроверяя
перестать: перестала
перспектива: перспективы
перспективный: перспективно
писать: писать
писаться: пишется
планировать: планируете
плохо: плохо
плохой: плохой
площадь: площади
плюс: плюс
побить: побит
побочный: побочный
повезти: повезет повезло
поговорить: поговорим
погода: погода
пограничный: пограничном
подверженный: подвержены
поддержка: поддержке
подобный: подобные
подозрительный: подозрительным
подробность: подробности
подробный: подробнее
подходящий: подходящее подходящих подходящую
поздний: позже
позитрон: позитронов позитроны
поиск: поиске
поистине: поистине
пока: пока
показание: показаний
показать: показать
показывать: показывает
покрывать: покрываемой
поле: поле полем поля
полигон: полигоне
полный: полного полной полный
получать: получаем
получаться: получается
получить: полученное полученными получить
помогать: помогают
помочь: помочь
помощь: помощью
понимание: понимание
понимать: понимать понимаю
понятно: понятно
понятный: понятна
понять: понять
попадать: попадали
попасть: попасть
поправка: поправка поправки поправкой
пора: пор
породить: породила порожден
порождать: порождает порождать порождают
порция: порция
порядок: порядка порядок
посвятить: посвящена
последний: последние
посмотреть: посмотрел посмотреть
постоянный: постоянной
построить: построите
потенциальный: потенциальный
поток: поток потока потоки
почему: почему
поэтому: поэтому
появиться: появилась появился
появление: появление появления
правда: правда
практически: практически
пребывать: пребывает
предварительный: предварительным
предел: пределах
предельно: предельно
предельный: предельных
предлагать: предлагаем
предполагать: предполагаем предполагаемого предполагаемые предполагая
предполагаться: предполагается
предположим: предположим
предположить: предположить
предсказывать: предсказывают
представлять: представлять
предшественница: предшественницы
предыдущий: предыдущие
прежде: прежде
прежний: прежнее
преодолеть: преодолев
пресса: прессе
привести: приведена
привлечь: привлечены привлечь
прийти: прийти пришла
прилетать: прилетать
прилететь: прилетело
приливный: приливного
приличный: приличной
применять: применяли
примерно: примерно
примитивный: примитивнее
принимать: принимают
принцип: принципе
принципиально: принципиально
присутствовать: присутствует
приход: прихода
приходить: приходит
причём: причем
пробег: пробега
проблема: проблема проблему
провести: провести
проводить: проводить
прогонять: прогоняете
проделать: проделал проделана
проделывать: проделывает проделывали
продолжать: продолжаем
продолжаться: продолжается
продукт: продуктом
произойти: произойдет
происходить: происходило происходит
происхождение: происхождения
пролетать: пролетают пролетая
промежуток: промежуток
промежуточный: промежуточной промежуточные промежуточных
пронаблюдать: пронаблюдать
пронизывать: пронизывающего
просто: просто
простой: простыми
пространство: пространстве пространство
протон: протон протона протонов протоном протоны
процент: процента
процесс: процесса
прочий: прочих
проясниться: прояснится
публика: публики
публикация: публикации публикацию
публиковаться: публиковались
пунктирный: пунктирная пунктирной
пустота: пустоты
пустынный: пустынной
пытаться: пытаемся пытаетесь пытается пытаться пытаются
пьер: пьера
пятно: пятна пятне пятно пятном пятну
пять: пять
работа: работа работе работу работы
работать: работает работают
рабочий: рабочая
равно: равно
равный: равна
ради: ради
радиационный: радиационное
раз: раза
разброс: разброс
разговор: разговор
разлетаться: разлетаются
различаться: различаться
размер: размера
разный: разное разные
разобраться: разобраться
разрешить: разрешенными разрешить
разрушаться: разрушается
разрушение: разрушения
разумеется: разумеется
ран: ран
ранний: раньше
расклад: раскладом
расколоть: расколоть
распад: распада
распадаться: распадаются
расположить: расположен расположены
распределение: распределение
рассвет: рассвете
рассеиваться: рассеивается
рассеяние: рассеяния
рассматривать: рассматриваете
рассматриваться: рассматривается рассматривался рассматриваться рассматриваются
рассмотреть: рассмотреть
рассосаться: рассосалось
расстояние: расстояние расстояний
рассчитать: рассчитано
расхождение: расхождения
расширение: расширение
расширить: расширить
реально: реально
реальный: реальным
ревнивец: ревнивцев
регистрация: регистрации
регистрировать: регистрируемых регистрируют регистрирующие
регистрироваться: регистрируется
регулярно: регулярно
редко: редко
резко: резко
результат: результат результате результатов результаты
реконструкция: реконструкцией реконструкции реконструкцию реконструкция
рекорд: рекорд
рекордный: рекордная рекордной
рекордсменка: рекордсменка рекордсменкой
реликтовый: реликтовом
рентгеновский: рентгеновского
рецензировать: рецензируют
рецензироваться: рецензируется
решаться: решается
решить: решенная решили решить
решётка: решетка
рнф: рнф
рождаться: рождаются рождающихся
рождение: рождения
роль: роль
российский: российской
рутинный: рутинную
рыхлый: рыхлые
ряд: ряд
рядом: рядом
сам: сами самим само самой самом
самый: самая самое самые самый самым самых
сверхвысокий: сверхвысоких
сверхмассивный: сверхмассивная сверхмассивной сверхмассивные сверхмассивных
сверхтяжёлый: сверхтяжелые
сверху: сверху
свет: свет
светимость: светимости светимость светимостью
свободный: свободного
свой: свое своего своем своих свой
свойство: свойств
свыше: свыше
связанный: связанной связанных
связать: связана связано
связь: связи
сделать: сделали сделать
себя: собой
сей: сих
серый: серая
серьёзно: серьезно
сеть: сети сетью
сильно: сильно
сильный: сильное сильные сильным
систематический: систематическая
ситуация: ситуацию
скажем: скажем
сказать: сказал сказали сказано сказать
сквозь: сквозь
скепсис: скепсис
скопление: скопления
скорее: скорее
скучный: скучна
слабый: слабее слабое
след: следу
слово: словами
сложно: сложно
сложный: сложные сложным
случай: случае случай случая
сми: сми
смоделировать: смоделированных
смотреть: см смотреть смотрите
смочь: сможете
смысл: смысл смысле
снизу: снизу
собираться: собирается
собственно: собственно
событие: событие событий события событиями
совершенно: совершенно
совпадать: совпадает совпадают
совпадение: совпадение
современный: современные
согласный: согласен
содержать: содержащие содержит
содержаться: содержится
созвездие: созвездие созвездии
сообщество: сообществе
сообщить: сообщил
соответственно: соответственно
соответствие: соответствия
соответствовать: соответствует
состав: составе
состояние: состоянии
состоять: состоит состояла состоять
спектр: спектр
специалист: специалистов
специально: специально
список: списках
сплошной: сплошная
способ: способ способами способом
способный: способны
спутник: спутники
сравнивать: сравниваете
сравниваться: сравнивается
сравнить: сравнили
среди: среди
среднее: среднем
средний: среднее
ставить: ставил
статистика: статистики
статистический: статистической
стать: стал стали стало
статья: статье статью статья статьях
степень: степенью
сто: сто
столь: столь
сторона: сторона стороне сторону стороны
страна: стран
строиться: строится
строй: строй
струна: струн
струя: струй
существенно: существенно
существенный: существенный
существование: существование
существующий: существующих
схожий: схожи
сценарий: сценарии сценарий
сцинтиллятор: сцинтилляторами сцинтилляторы
сцинтилляционный: сцинтилляционными
считать: считать
считаться: считался считаются
счёт: счет
сыграть: сыграли
сюжет: сюжет сюжетом
также: также
таки: таки
такой: такая такие таким таких такого такое таком такую
твёрдо: твердо
твёрдый: твердый тверже
текущий: текущий текущую
телескоп: телескоп телескопов телескопом телескопу телескопы
тельце: тельца
тема: тема тему
теоретический: теоретических
теория: теории теория
термин: термин
технический: технической
тип: тип типа типы
толком: толком
тосихиро: тосихиро
тот: та те тех ту
точечный: точечно
точка: точки
точно: точно
точность: точностью
точный: точное
траектория: траектории траекториях
туда: туда
тяготение: тяготения
тяжёлый: тяжелее тяжелые
тёмный: темная темной темную
увеличение: увеличение увеличения
увеличиваться: увеличивается
уверенность: уверенностью
удаваться: удается
ударный: ударные
удаться: удалось
удивить: удивило
узнать: узнать
указать: указано указаны
указывать: указывает указывать
укладываться: укладываются
ультравысокий: ультравысоких ультравысокой
ультрафиолетовый: ультрафиолетовый
универсальный: универсальную универсальные
уникальный: уникальна уникальной
употребимый: употребим
упражнение: упражнение
уровень: уровне
усиливаться: усиливаться
ускоритель: ускорители ускорителях
ускорить: ускорить
условно: условно
условность: условности
усреднить: усредненное
устанавливать: устанавливать
установить: установлено
установка: установка установке установки установкой установку
установленный: установленной
утверждать: утверждаю
уточнить: уточните уточнить
утрачивать: утрачивают
участие: участия
участник: участники участников
учесть: учесть
учёный: ученые
учёт: учетом
факт: факт
факультативный: факультативные
феномен: феномена
ферми: ферми
фигурировать: фигурировала
физ: физ
физик: физикам
физика: физика
физический: физической
флуоресцентный: флуоресцентном флуоресцентные флуоресцентный флуоресцентным флуоресцентными флуоресцентных
флуоресцировать: флуоресцировать
формально: формально
фотон: фотон фотонов фотоны
фотонный: фотонный
фрагмент: фрагменты
фудзия: фудзии
функция: функцию
хороший: лучшего хорошая
хотеть: хочет хочу
хотя: хотя
целое: целом
цель: цель целью
центр: центр центра центре
центральный: центральная
частица: частиц частица частице частицей частицу частицы
частность: частности
частый: чаще
часть: части часть
четыре: четыре
число: числа числе число
читать: читают
чёрный: черная черной черные черных
чётко: четко
широкий: широкий широкой широком
штат: штата штате
шум: шума
эв: эв
экзотика: экзотика экзотику
экзотический: экзотические
эксаэлектронвольт: эксаэлектронвольтам
эксперимент: эксперимент эксперимента экспериментов экспериментом эксперименты
экспозиция: экспозицией экспозицию экспозиция
электрон: электронов электроны
энергия: энергией энергии энергий энергию энергия энергиям энергиями энергиях
эра: эры
это: этим
этот: эта этими этих этому
эффект: эффект
эффективный: эффективной
ээв: ээв
ют: юта
являться: является
явно: явно
ядерный: ядерных
ядро: ядер ядра ядро ядром
японский: японская японской
ясно: ясно
