азия: азии
академик: академик
активный: активная активной
аламосский: аламосской
альпы: альпах
америка: америки
американский: американской
англ: англ
аннигиляционный: аннигиляционных
антинейтрино: антинейтрино
античастица: античастицами античастицы
аромат: аромат аромата ароматов
артур: артур артуру
асимметрия: асимметрии
аспирант: аспиранты
атмосферный: атмосферными атмосферных
барионный: барионной барионным
беспрепятственно: беспрепятственно
благодаря: благодаря
ближний: ближнего ближних
бозон: бозон
борис: борисов
бруно: бруно
важный: важные важным
валерий: валерий
великий: великого величайший
вероятность: вероятности
вероятный: вероятным
вещество: вещества веществом
взаимодействие: взаимодействии взаимодействий
взаимодействовать: взаимодействуют
взаимопревращаться: взаимопревращаясь
взаимоуничтожаться: взаимоуничтожаются
видный: видны
вода: водой
возможность: возможности возможность
возможный: возможные возможных
возникать: возникают
возникнуть: возникли
войти: вошел
волокно: волокнами
восстановление: восстановлении
восток: востоке
впервые: впервые
временной: временной
время: времени
вручить: врученной
вселенная: вселенной
всё: всё
второй: второй
выдвинуть: выдвинута
выработка: выработке
высокий: высоких
высота: высотой
выступать: выступает
галактический: галактический
геометрия: геометрии
гигантский: гигантском
гипер: гипер
гипотеза: гипотеза
гипотетически: гипотетически
гипотетический: гипотетическая гипотетические
гл: гл
глава: глава
глубина: глубине
год: года году
горный: горном
город: города
гравитационный: гравитационных
далёкий: дальше
данные: данных
дать: дать
два: двух
двигаться: движущейся движущиеся
денежный: денежном
десять: десять
детектирование: детектирования
детектор: детектор детектора детекторе детекторов детектором детектору
дефицит: дефицитом
диаметр: диаметром
доверительный: доверительной
докт: докт
должный: должна должны
дорогой: дорогими
другой: другим другими других другого
европа: европы
европейский: европейском
естественный: естественных
зав: зав
загадка: загадка загадок
закон: законов
замена: заменой
замысел: замыслу
заниматься: занимающаяся
западный: западнее
заполнить: заполнен
запустить: запустили запущен
зарегистрировать: зарегистрированные
заряд: заряда
зарядить: заряженный
затаённый: затаенных
затем: затем
земля: земле землей земли земля
зеркальный: зеркального зеркальных
значение: значение значением
играть: играть
идея: идея
известный: известными
извод: изводом
изготовить: изготовлены
измерение: измерение измерения
изолировать: изолированные
изотропный: изотропным
изучать: изучаемых
изучаться: изучаются
изучение: изучение изучения
иметь: иметь имеющие
инвариантность: инвариантности
инвариантный: инвариантных
инженер: инженеров
иной: иной
институт: института
интерес: интерес
информация: информации
исключать: исключаемое
исключить: исключена
искусственный: искусственные искусственных
испания: испании
исследование: исследование исследований исследования исследованиях
исследовательский: исследовательских
источник: источника источников
исчезать: исчезают
итальянский: итальянским
ияи: ияи
кадзита: кадзита
камиока: камиока
камиоканд: камиоканде
канадский: канадскому
кардинально: кардинально
катализировать: катализировать
качество: качестве
квадрат: квадратов
квантовомеханический: квантовомеханического
кварк: кварков
класс: классу
ключевой: ключевую
км: км
коллаборация: коллаборация
комбинированный: комбинированной
компания: компанией
комплекс: комплекса комплексе
координата: координат
который: которая которого которой котором которые который которых
крупный: крупнейших
кубик: кубиков
куденко: куденко
лаборатория: лабораторией лаборатории
левый: левые левым
лежать: лежит
лептон: лептон лептонов лептоны
лептонный: лептонном
либо: либо
литр: литров
лишь: лишь
лос: лос
луна: луны
лёгкий: легкие
магнитный: магнитные
макдоналд: макдоналд
макдональд: макдональду
максим: максим
максимальный: максимальному
максимум: максимуму
малый: малых
масса: масс массой массы
массив: массиве
мат: мат
материя: материю
международный: международная
мезон: мезон
мелкий: мельчайших
менять: меняют
меняться: меняться
место: места
миллион: миллионов
миниатюрный: миниатюрные
минобрнауки: минобрнауки
мифь: мифи
мишень: мишень мишенью
модель: модели
модернизация: модернизации модернизация
модернизироваться: модернизировавшимся
монополь: монополи
мочь: могли могут
мфть: мфти
мюон: мюон мюоны
мюонный: мюонные
наблюдать: наблюдаемым
наблюдаться: наблюдавшееся
наблюдение: наблюдений
награда: наградами
надежда: надежд
называть: называемых
наиболее: наиболее
найти: найдут
накладывать: накладывать
направление: направлениях
нарушение: нарушение нарушению нарушения
наследовать: наследует
наука: наук
научий: науч
научный: научных
находиться: находящегося
нацелить: нацелена
национальный: национальной
начало: начало
начаться: начаться
наш: наш
неизвестный: неизвестной
неинвариантность: неинвариантности
нейтральный: нейтральная нейтральный
нейтринный: нейтринная нейтринного нейтринном нейтринный нейтринными нейтринных
нейтрино: нейтрино
нейтрон: нейтроны
некоторый: некоторые
неоднократно: неоднократно
неожиданный: неожиданный
несчастливый: несчастливой
нечётный: нечетной нечетному
никто: никем
ничтожный: ничтожны
нобелевский: нобелевской
новый: нового новые
ноябрь: ноябре
нужно: нужно
нулевой: нулевой
обладать: обладает обладают
обнадёживать: обнадеживающие
обнаружение: обнаружения
обнаружить: обнаруженные обнаружил обнаружить
образовываться: образовываться
обсерватория: обсерватория
общий: общими
объединение: объединения
объект: объектов
объяснение: объяснению
объём: объем объему
обычный: обычным
ограничение: ограничения
один: одна одного одной
однако: однако
одновременно: одновременно
одновременный: одновременной
однозначный: однозначному
означать: означает
оияй: оияи
оказываться: оказываются
около: около
околосветовой: околосветовыми
октябрь: октября
ооо: ооо
операция: операции
описать: описал
определённый: определенного
оптически: оптически
оптический: оптическими
основа: основе
основной: основной
остров: остров
осуществлять: осуществляли
осциллировать: осциллируют
осцилляция: осцилляции осцилляций осцилляциями осцилляциях
отдел: отделе
открытие: открытие
открыть: открыт
отличаться: отличаются отличающегося
отметить: отметить отмечены
относительно: относительно
относиться: относится
отношение: отношении
отражение: отражений отражения
отрицательный: отрицательные
очистить: очищенной
параметр: параметрами параметры
первоначальный: первоначального
первый: первое первому
перспектива: перспективами
пи: пи
площадка: площадке
поведение: поведении
повышение: повышение
поддержка: поддержку
подземный: подземной
подобный: подобных
подпись: подписи
подтверждение: подтверждению
позволять: позволяет
позитрон: позитрон
поиск: поисках
пока: пока
показать: показали
полезно: полезно
полистирольный: полистирольных
полный: полном
положительный: положительный
получать: получать
получить: получено получили
польза: пользу
понтекорво: понтекорво
пора: пор
поскольку: поскольку
построить: построенным
посёлок: поселке
поток: потока
почему: почему
правительство: правительства
правый: правые
превращаться: превращаются превращаясь
превысить: превысит
предположение: предположения
представлять: представляющий
предшественник: предшественником
преемник: преемник
премия: премией премию
преобладание: преобладание
престижный: престижными
прецизионный: прецизионное
привести: привели
примерно: примерно
примесь: примесей
принадлежать: принадлежит
принимать: принимали
приоритетный: приоритетных
природа: природы
проводиться: проводится
продолжение: продолжение
проект: проект проекте проектов проекту
производиться: производятся
производство: производства
пронзить: пронзить
пронизать: пронизанных
прорыв: прорыв
простираться: простирающуюся
просто: просто
пространственный: пространственных
противоположный: противоположные
протон: протона протонов протоны
протонно: протонно
протонный: протонного
прототип: прототипов
профессор: профессора профессору
проходить: проходившие
процесс: процессе процессов
путь: пути
пучок: пучка пучке
пять: пять
работа: работы
работать: работавшему работавшим
радиоактивный: радиоактивных
развиваться: развивается
разгадка: разгадке
разговорить: разговорить
различный: различных
размер: размерами
разместить: размещенный
разница: разницы
разность: разность
разработать: разработана
ран: ран
распад: распад распада распадов
располагаться: располагается
расположить: расположенных
расстояние: расстоянии
реактор: реакторах реакторов
реализовать: реализован
реальность: реальность
регистрация: регистрацией регистрации
регистрировать: регистрировать
резервуар: резервуар
результат: результат результате результаты
рнф: рнф
рождаться: рождающихся
роль: роль
российский: российские российскими российских российской
россия: россии
рубак: рубаков
руководство: руководством
рффи: рффи
самый: самыми самых
сбор: сбора
световой: световой
свидетельствовать: свидетельствуют
свой: своей своему свой
свойство: свойства
связанный: связанных
связь: связи
себя: собой
север: северу
северный: северной
северо: северо
сегментировать: сегментированный
сей: сих
сектор: секторе
сердце: сердце
середина: середине
сильный: сильном
симметрия: симметрии
синхротрон: синхротрона
система: системой
систематический: систематические
сколлапсировать: сколлапсирует
скорость: скоростью скоростями
слабовзаимодействующий: слабовзаимодействующие
следовать: следует
слишком: слишком
слово: словам словами
сложность: сложности
случай: случае
смена: смены
смешивание: смешивание смешивания
смотреть: см
собственно: собственно
событие: события
совместный: совместной
современный: современным современных
создавать: создает
создание: создании
солнечный: солнечными солнечных
солнце: солнца солнце
соответственно: соответственно
соответствовать: соответствует соответствующем соответствующий соответствующую
состав: состав
состоять: состоящая
сотр: сотр
сотрудник: сотрудники
сохранение: сохранения
специалист: специалистами
специально: специально
спин: спином
спиральность: спиральность
способность: способностью
спроектировать: спроектированы
сравнение: сравнению
сравнить: ср
ссср: ссср
сталкиваться: сталкиваются
стандартный: стандартной
стать: станет
стена: стену
стерильный: стерильного
сторона: стороны
страна: стран
страница: страниц
строгий: строгие
студент: студенты
субатомный: субатомные
судьба: судьбой
супер: супер
схожий: схожих
сцинтиллятор: сцинтилляторов сцинтилляторы
сцинтилляционный: сцинтилляционных
сша: сша
сыграть: сыграть
такааки: такааки
также: также
такой: таких
тау: тау
телесный: телесном
теория: теорий
территория: территории
тест: тесты
тип: тип типа
ток: ток
токай: токай
токийский: токийского
токио: токио
тот: тому
точно: точно
три: трех
тёмный: темного темную
угол: угле углов углы
удаваться: удавалось удается
удалённый: удаленном удаленных
указание: указание
университет: университета
унипласт: унипласт
уровень: уровне
ускоритель: ускорителей ускоритель ускорителя ускорителях
ускорительный: ускорительного ускорительном
установить: установлен
установка: установка установок
участвовать: участвуют участвующие участвующих
участие: участие
участник: участники участников
учреждение: учреждений
учёный: учеными ученых
фаза: фазы
фермион: фермионам
фиан: фиан
физ: физ
физик: физиком
физика: физике физики физику
физический: физических
финансовый: финансовую
флейвор: флейвор
фон: фоном
фонд: фонды
фото: фото
фотон: фотона
франция: франции
фундаментальный: фундаментальной
хиггс: хиггса
хида: хида
ход: ходе
хонсю: хонсю
целый: целой
цель: целью
центр: центр
центральный: центральной центральный центральных
цепочка: цепочке
церн: церне
цилиндр: цилиндр
частица: частиц частица частицами частицах частицы
частность: частности
число: число
чрезвычайно: чрезвычайно
чувствительность: чувствительности
чётность: четностей четности
шаг: шагом
швейцария: швейцарии
шкирка: шкирку
эксперимент: эксперимент эксперимента экспериментах эксперименте экспериментов
электрически: электрически
электрон: электрон электроны
электронный: электронные
электрослабый: электрослабых
элемент: элементов элементы
элементарный: элементарных
энергия: энергии энергий
этап: этапом
этот: эта
этюд: этюды
эффект: эффекту
юрий: юрий юрия
явление: явление явления
являться: является являются
ядерный: ядерных
ядерщик: ядерщики
япония: японии
японский: японский японских японского
