аварийный: аварийно аварийных
авиапарк: авиапарк
авиационный: авиационном
авиация: авиацией
авиашоу: авиашоу
автономность: автономности
автономный: автономного автономные автономный
азот: азот азота
айзекман: айзекман айзекманом
айзекмана: айзекмана айзекману
аквалангист: аквалангистов
акиям: акияма
аккумулятор: аккумуляторы
активно: активно
александр: александр александром
алексей: алексей
аллен: аллена
алюминиевый: алюминиевого
амбициозный: амбициозный
американец: американец американцев американцы
американка: американка
американский: американская
аналог: аналог
аналогия: аналогии
ангара: ангара
англичанка: англичанка
анна: анна
аномалия: аномалии
ансари: ансари
антенна: антеннами антенны
ануша: ануше
апогей: апогее
аполлон: аполлон аполлонах
аппарат: аппарат аппараты
аравия: аравии
арендовать: арендованном арендованный арендует
астронавт: астронавт астронавта астронавтами астронавтов астронавты
астронавтика: астронавтики
атмосфера: атмосфере атмосферой атмосферу атмосферы
афганистан: афганистане
байконур: байконур
бакалавриат: бакалавриат
баланс: баланс
баллон: баллоны
баржа: баржи
безопасность: безопасности
безусловно: безусловно
беленький: беленькие
белые: белые
бесконечно: бесконечно
бизнес: бизнес бизнеса бизнесом
бизнесмен: бизнесмен
билет: билет
бить: бьет
благородство: благородство
благотворительность: благотворительности
благотворительный: благотворительная
близкий: поближе
бо: бо
бой: бои
бок: бока
болезнь: болезни болезнь
больница: больницы
больший: большая большего большее большей большие большими большую
большой: большой
борт: борту
бразилия: бразилией бразилии
брать: брали
бросить: бросил
бывать: бывает
быстро: быстро
быть: будем будут
важно: важно
важность: важность
важный: важнее важные
вакуум: вакуум вакууме
ван: ван
вариант: вариант
ввс: ввс
вернуться: вернулись вернулся
верный: вернее
версия: версию версия
верхний: верхний
весь: весь всеми
видео: видео
видеть: видим
видимо: видимо
виктор: виктор
виток: витков
вкладываться: вкладывается
включать: включает
владеть: владела
вместе: вместе
вместо: вместо
вначале: вначале
внекорабельный: внекорабельной
внутри: внутри
вовсю: вовсю
вода: воде
военный: военную военный
возвращаться: возвращаясь
возвращение: возвращение возвращении
воздействие: воздействием воздействия
воздух: воздух
воздушный: воздушная воздушную воздушные
возможно: возможно
возможность: возможностей
возникнуть: возникло возникнет
война: войны
войти: войти
вокруг: вокруг
вообще: вообще
вопрос: вопрос
впервые: впервые
впереди: впереди
впечатление: впечатление
вплоть: вплоть
вполне: вполне
врач: врач врачи
время: временам времени время
вспомнить: вспомним вспомнить
встроить: встроенную
всякий: всяких
всё: всё
второй: вторая второй вторые
выбрать: выбрав выбрал
выводить: выводит
выиграть: выиграл выиграла
выискивать: выискивать
выйти: выйдет вышедшие вышел вышла вышли
выпасть: выпало
выполнять: выполняет
вырасти: вырос
высокий: высокие высшее
высоко: повыше
высота: высота высоту высоты
выступать: выступал
высунуться: высунулись высунуться
вытаскивать: вытаскивают
выход: выход выхода выходом
выходить: выходит выходят
выходной: выходные выходных
выше: выше
газ: газ
газета: газеты
гайка: гайка
гибель: гибели гибель
гибкий: гибкие
гибкость: гибкость
гибридный: гибридную
главкосмос: главкосмоса
главный: главным
глобальный: глобальный
говорить: говорили говоря говорят
год: год года году годы лет
город: городе
государственный: государственной
готовить: готовила готовит
готовый: готов
груз: грузами
грузовой: грузовой грузовых
гэрриот: гэрриот
давление: давления
дайсукэ: дайсукэ
далеко: далеко
дальнейший: дальнейшем дальнейшие дальнейших
далёкий: дальше
данные: данных
дата: дат дате
дать: данные
два: двух
двадцать: двадцати двадцать
двигать: двигать
двое: двое
девушка: девушек девушки
действительно: действительно
декабрь: декабре
декомпрессионный: декомпрессионной
декомпрессия: декомпрессией
делать: делать делающая
дело: деле дело
деннис: деннис
день: дней
деньга: денег деньги
держаться: держаться
десатурация: десатурацию
десятка: десятки
десять: десяти
деталь: деталях
детский: детской
детство: детства
дешёвый: дешевле
деятельность: деятельности
джаред: джаред
джареда: джареда
джаредом: джаредом
джентльменск: джентльменски
джиллис: джиллис
джон: джон
джуда: джуд
дизайн: дизайн
директор: директор директоров
дмитрий: дмитрий
добавить: добавил добавлены
добавлять: добавлять
добраться: добрался
довольно: довольно
доказать: доказать
долго: долго
должность: должностях
долл: долл
доллар: долларов
доля: долей долю
дом: доме
дополнительный: дополнительным
допускать: допускаю
допустить: допустили допустим
доработать: доработали
доработка: доработок
дорогой: дорогие
доставка: доставке
доставлять: доставляет доставляют
достигнуть: достичь
достижение: достижениях
доход: доход
друг: друг друга другу
другой: другие других
дружественный: дружественной
дублёрша: дублерша
думать: думаете думал думали думаю
дышать: дышали дышат дышит
единственный: единственный
естественно: естественно
желать: желающих
женщина: женщин
жертвователь: жертвователей
жертвовать: жертвует
жизненный: жизненные
жизнеобеспечение: жизнеобеспечения
жизнь: жизни жизнь
журналист: журналист
забирать: забирают
забираться: забираемся
забывать: забывать
забыть: забыть
завершиться: завершилась
зависимость: зависимости
задевать: задевали
задержаться: задержался
заканчиваться: заканчивается
закрывать: закрывать
закрыть: закрыть
замахнуться: замахнулся
занимать: занимали
заниматься: занимается занималась
занятый: заняты
занять: заняла
записываться: записывались
запланированный: запланированно
запланировать: запланирован запланированное
заплатить: заплатил заплатила заплатили заплатить
запомниться: запомнится
зарабатывать: зарабатывал
зарубежный: зарубежных
заря: заря
затем: затем
зато: зато
затопить: затопить
затрата: затратами затраты
захотеть: захочет
заявка: заявку
звёздный: звездные
земля: земле земли землю
земляк: земляк
земной: земного
знаменитый: знаменитая
знать: знаем знаете знают
значит: значит
золотой: золотое
игра: игры
играть: играет играли играть
идеальный: идеального
идти: идет
изменить: изменило
изучать: изучать
иллюминатор: иллюминаторах
илона: илон илона
именно: именно
имя: имена именем
иначе: иначе
инженер: инженер инженеров инженеры
инициатива: инициатива
институт: институте
инструктор: инструктор инструктором
интервью: интервью
интерес: интерес
интересно: интересно
интересный: интересная интересны интересный
информация: информации
ирак: ираке
исполнить: исполнила
исполнять: исполнял
использование: использования
использовать: использовать использует
использоваться: использовалась используется
исследовательский: исследовательские
исследоваться: исследовалась
история: истории историю история
истребитель: истребителей истребители истребителями
исходить: исходя
итак: итак
италия: италии
итог: итоге
кабель: кабели
кайло: кайл
какой: какое
калифорния: калифорнии
камера: камера камерой камеру камеры
камчатка: камчаткой
канаверал: канаверал
кассета: кассеты
катапульта: катапульту
катастрофа: катастрофы
категорически: категорически
качество: качестве
квартира: квартирой
кессонный: кессонная
километр: километров
кино: кино
кислород: кислорода кислородом
кислородный: кислородной
китаец: китайцы
китайский: китайскую
клапан: клапан
классический: классические классический
клон: клонов
ключевой: ключевой
км: км
количество: количество
коллаборация: коллаборация
коллега: коллег коллегой
колонизация: колонизация
комментарий: комментария
коммерческий: коммерческих коммерческой
компания: компании компаний компанию компания
композитор: композитор
композиция: композиции
компьютер: компьютеры
комфортный: комфортнее
конец: конца концу
конкуренция: конкуренции
конкурс: конкурс конкурсе
конкурсный: конкурсной
конструктор: конструкторы
контракт: контракта контракту контракты
корабль: корабле кораблей кораблем корабли корабль кораблю корабля кораблях
корея: кореи
королёв: королёве
корпус: корпус корпуса
космический: космическая космические космический космическим космических космической космическом
космонавт: космонавтов космонавты
космонавтика: космонавтика космонавтике космонавтики космонавтикой
космос: космос космоса космосе космосом
костюм: костюмах
который: которая которую которые который которых
край: крае
красивый: красивая красивый
краткий: краткая
крепкий: крепкий
криста: криста
кристофер: кристоферу
критика: критика
критиковать: критиковали критикуют
кровь: крови
кроме: кроме
крупный: крупные крупный крупными крупных
крутой: круче покруче
кстати: кстати
культурный: культурных
купить: купил
купол: купол
лазер: лазер
лазерный: лазерная лазерной лазерную
легкомоторный: легкомоторных
леонов: леонова
лестница: лестницу
летать: летаете летал летали летают
лететь: лететь летит
лето: лето
лечение: лечения
лишний: лишние
лишь: лишь
лотерея: лотерея
луна: луне луну
льшуя: льшую
любить: любят
любой: любой любую
люк: люк люка
ляция: ляция
лёгкий: легком
лётчик: летчик
маколифф: маколифф
малайзия: малайзии
маленький: маленькая маленькие маленький маленьких меньше
малый: меньшие
манёвр: маневром маневры
марс: марс марса
маск: маск
маска: маска
масса: массы
материал: материал
маэдзав: маэдзава
медицина: медицины
медицинский: медицинские медицинский медицинское медицинскому
межспутниковый: межспутниковую
менона: менон
менять: менять
место: места место
месяц: месяцы
метеорит: метеоритов
методика: методики
мечта: мечта мечты
мечтать: мечтал
микрометеорит: микрометеорита
миллиард: миллиарда
миллиардер: миллиардера миллиардером
миллион: миллиона миллионов
минус: минус
минута: минуты
мир: мир
мировой: мировой
миссия: миссии миссий миссию миссия миссиях
мкс: мкс
многие: многие
многоразовый: многоразовые
многослойный: многослойным
модель: модели модель
модернизировать: модернизировали
модифицированный: модифицированном
модифицировать: модифицированы
модуль: модулем
мой: моем
молния: молния
момент: момент момента моменту моменты
монтаж: монтажа
море: моря
мочь: могла могут можем можете
муж: муж
мужик: мужик
мужчина: мужчина
музыка: музыкой музыку
музыкант: музыкантами музыкантом
мы: нам
мыс: мыса
наблюдать: наблюдал
набор: набора
набрать: набрал
наверное: наверное
надёжность: надежность
назвать: назвал назвать
наземный: наземную наземные наземными
называть: называют
найти: найти
наказать: наказаны
намного: намного
напомнить: напомните напомню
напоследок: напоследок
например: например
наружу: наружу
нарушить: нарушена
насколько: насколько
настаивать: настаивал
настолько: настолько
настоящий: настоящий
наука: наука науки наукой
научный: научная научные научных
находиться: находится находиться
начаться: начались начался
наш: нашего наши нашим
неамериканский: неамериканских
небо: небе
невесомость: невесомость
негерметичный: негерметичный
некий: некую
некорректно: некорректно
некоторый: некоторое некоторый
немножечко: немножечко
необходимый: необходимым
непрофессиональный: непрофессиональные
несколько: нескольким несколько
нескоро: нескоро
нечто: нечто
нидерландский: нидерландской
нидерланды: нидерландах
ниже: ниже
нижний: нижний нижнюю
низкий: пониже
никак: никак
никакой: никакие
никто: никто
ниша: нишу
новость: новостями
новый: новая новую новые
номер: номере
носитель: носителе
нравиться: нравится
нужно: нужно
нужный: нужен
нюанс: нюансы
обеспечивать: обеспечивает
обеспечить: обеспечен
область: области
облететь: облетев облететь
обновить: обновить
обогнать: обогнала
оборудование: оборудование
образ: образом
образование: образование
обслуживание: обслуживании
обтекатель: обтекателем обтекатели обтекателя
общаться: общается
общий: общем
объект: объектами
объявить: объявил объявили
объём: объем
огнёв: огнёв
одержимость: одержимость
один: одна одни одного
однако: однако
одноразовый: одноразовый
океанский: океанские
около: около
околоземный: околоземных
окончание: окончание
окончить: окончил
онкологический: онкологической
онлайн: онлайн
опасность: опасности опасность опасностью
оператор: оператором
оплатить: оплатил оплатить
определить: определят
определяться: определяется
определённый: определенная определенные определенных
оптоволокно: оптоволокном
оптоволоконный: оптоволоконную
опускаться: опускается
орбита: орбите орбиту орбиты
орбитальный: орбитальную орбитальных
организационный: организационная
организм: организм
оргстекло: оргстекла
ориентация: ориентации
ориентировать: ориентировать
оркестр: оркестрами оркестры
орлан: орлан
осваивать: осваивать
освещаться: освещается
осень: осень
оскудеть: оскудеет
основа: основе основы
основное: основном
основный: основную
особенно: особенно
особенность: особенности
особый: особые
оставаться: оставалась оставались остается остаются
остаток: остатков
отбор: отбор
ответить: ответить
отдать: отдал
отдельный: отдельным
отель: отелем отель
отказ: отказа
отказаться: откажутся отказались
отказываться: отказывались
откидываться: откидывался
открывать: открывайте
открытый: открытом открытый
открыться: открылся
откуда: откуда
отлететь: отлетела
отличаться: отличаются
отличие: отличие отличия
отменить: отменил
отметить: отметить отмечу
отправить: отправила отправить
отправлять: отправлял отправлять отправляют
отправляться: отправлялись
отсек: отсек отсеков
отставка: отставке
отстегнуться: отстегнулся
отыгрывать: отыгрывать
охват: охват
охватывать: охватывает
охлаждение: охлаждения
очень: очень
палец: пальцами
парадигма: парадигме
параметр: параметры
парк: парк
пацай: пацаев
первый: первая первой первые первый первым первых
перевести: перевести
передаваемый: передаваемых
передавать: передает
передать: передали
передний: переднем
перейти: перейти перешла
перепад: перепадами перепадах
перерыв: перерыв
перестать: перестал
перечислимый: перечислим
периодически: периодически
персонал: персонал
перчатка: перчатки
печально: печально
пилот: пилот пилотов
пилотировать: пилотируемой пилотируемые пилотируемый пилотируемых
плавание: плавание
план: планы
планировать: планирует
платить: платит
платёж: платежами
плексиглас: плексиглас
плохо: плохо
плюс: плюс
победить: победила
побережье: побережья
побеседовать: побеседовал
побить: побив побила побит побить
побывать: побывал побывали
поверхность: поверхностью
повторяться: повторяются
повышенный: повышенной
погибать: погибает
погибнуть: погиб погибла погибли
поглотитель: поглотители
подать: подать
подвергать: подвергать
подготовка: подготовке подготовкой
поддержание: поддержания
поддерживать: поддерживать поддерживаю
поддержка: поддержке
подключить: подключены
поднимать: поднимаете поднимать
подниматься: поднимаетесь поднималось
поднять: поднять
подняться: поднялись
подождать: подождать
подполковник: подполковник
подросток: подростком
подрядчик: подрядчиков подрядчиком
подумывать: подумывал
подход: подход
подчеркнуть: подчеркнуть
подъём: подъем
подыгрывать: подыгрывают
пожалуйста: пожалуйста
пожар: пожара
пожарный: пожарной
пожертвовать: пожертвовал
позиция: позиция
познакомиться: познакомилась
пока: пока
показать: покажет показать
покрытие: покрытие покрытием
покупать: покупать
полагать: полагаю
полететь: полетел полетела полететь полетит
полностью: полностью
полноценно: полноценно
получать: получал
получаться: получается
получить: полученных получила получить
польза: польза пользе
пользоваться: пользуемся
полярный: полярную
полёт: полет полета полетах полетов полеты
помещаться: помещался
помимо: помимо
помнить: помнит помните помню помнят
помогать: помогает
помочь: помогли
помощник: помощником
поначалу: поначалу
понимать: понимаем понимает понимать понимаю
понравиться: понравилось
понятный: понятное
понять: понял поняли
попадание: попадание
попасть: попадет попадут
попробовать: попробую
популяризатор: популяризатором
пора: пор
порог: порог
поручень: поручень поручнями
порядок: порядка
посадка: посадку
поскольку: поскольку
последний: последние последний
посмотреть: посмотрел
поставить: поставили
постоянно: постоянно
постоянный: постоянные
потит: потит
поучаствовать: поучаствовать
похожий: похожего
почему: почему
починка: починка
почувствовать: почувствовал
поэтому: поэтому
появиться: появилось
пояс: пояс пояса
правда: правда
правильно: правильно
практически: практически
превратиться: превратится
предоставление: предоставление
предоставлять: предоставляет
представитель: представитель
представить: представьте
представлять: представлял
предусматривать: предусматривают
предыдущий: предыдущую
прибыть: прибыл
привезти: привезти
привести: привести
привлекать: привлекает
приводнение: приводнение
приводниться: приводнился
приводняться: приводняться
приезжать: приезжал
прийти: пришел
прийтись: пришлось
прикол: прикол
пример: примеру
примерно: примерно
приносить: приносит
принцип: принципе
принципиально: принципиально
принципиальный: принципиальная
принять: принято
причина: причин причинам
причём: причем
приём: прием
проблема: проблемы
проблематика: проблематика
пробуждение: пробуждение
провести: проведены
проводиться: проводилась проводились проводилось
программа: программа программе
прогресс: прогрессами
продать: продал
продолжить: продолжат продолжим
продолжиться: продолжится
проект: проекта проектов
прозрачный: прозрачный
произвести: произвело
произойти: произошла произошло
пройти: прошел
просто: просто
простой: простая
протестировать: протестированы
профессиональный: профессиональных
проходить: проходили проходят
прочный: прочного
прошлый: прошлый
прямо: прямо
прямой: прямой
пузырёк: пузырьки
путь: путь
пытаться: пытались пытался
пять: пять
пятьдесят: пятьдесят
работа: работе работы
работать: работал работала работали работало работать
равно: равно
ради: ради
радиационный: радиационного радиационной радиационный
радиация: радиацией радиации
радио: радио
радиоволна: радиоволна
радиосвязь: радиосвязи
раз: раза
разбирать: разбирать
разбиться: разбилась
развиваться: развиваться
развитие: развития
развлекуха: развлекухи
разгерметизация: разгерметизации
разгерметизировать: разгерметизировать
разгерметизироваться: разгерметизировался
разделение: разделении
разный: разная разных
разрабатывать: разрабатывает
разработать: разработали
разыграть: разыграли
рак: рака
ракета: ракета ракете ракеты
ракетчик: ракетчики
рамка: рамках
ранжироваться: ранжируются
ранний: раньше
раскрываться: раскрывается
распад: распада
рассказать: расскажите рассказать
рассказывать: рассказывать
рассматривать: рассматривать
расти: растет рос
реактивный: реактивном
ребёнок: детей дети
революция: революция
результат: результатам результате
рей: рей
рекорд: рекорд рекорда
рекордный: рекордные
ресурс: ресурсы
ретранслятор: ретранслятор ретрансляторы
ретрансляция: ретрансляции
решать: решала решать
решение: решение
решить: решено решил решили
риск: риска
ричард: ричард
ркк: ркк
рогозин: рогозин
род: рода
родитель: родители
родиться: родился
родный: родном
ролик: ролик ролика
роль: роль
роскосмос: роскосмос роскосмоса роскосмосом
российский: российской российском
россия: россией россии россия
россиянин: россиянин
россонавт: россонавты
рука: руками
руководитель: руководитель
руководить: руководил
сайт: сайт
салют: салют
сам: самом саму
самолёт: самолетах самолете
самый: самое самые самый
сара: сара сарой сары
саудовский: саудовской
свет: свет света свете
свой: свое своего своей своему свои своим своих свой своя
связанный: связанные
связать: связанная связаны
связь: связи связь
сгорать: сгорает
сделать: сделали сделан сделаны сделать
себя: собой
сегмент: сегменте
сей: сих
секунда: секунды
селфи: селфи
семброский: семброски
семья: семьей
сента: сент
сентябрь: сентября
серьёзный: серьезнее серьезные
сибирь: сибирью
сигнал: сигнал
сила: силы
сильно: сильно
симонить: симони
синий: синие синих
система: система системам системой системы
ситуация: ситуации ситуациях
скажем: скажем
сказать: сказать
сказка: сказка
скафандр: скафандр скафандра скафандрах скафандре скафандров скафандры
скидка: скидка
скол: сколы
сколько: сколько
скорость: скорость
скотт: скотт
скрипка: скрипке
скромно: скромно
слабый: слабое
слава: славу
следить: следить
следующий: следующее следующей следующем следующие следующих следующую
слепить: слепило
слетать: слетает слетал
слишком: слишком
сложный: сложнее сложной сложные сложный
случай: случай
случиться: случилось
слушать: слушали
сменный: сменные
смесь: смесь
сми: сми
смонтировать: смонтировали
смотреть: см
смочь: смогли
смысл: смысл
снабжать: снабжать
снаружи: снаружи
сначала: сначала
снимать: снимали
снова: снова
собрать: собрать
собственность: собственности
собственный: собственным
совершить: совершить
советовать: советую
советский: советский советского советском
совместить: совмещенные
совместный: совместной
совокупность: совокупность
содиректор: содиректора
сожаление: сожалению
создать: создал
сокол: сокола
сократить: сократила
солнце: солнце
соответственно: соответственно
сопровождать: сопровождает
сопровождение: сопровождению
составлять: составляющая
сосуд: сосудов
сотня: сотни
сотовидный: сотовидной
сотрудница: сотрудница
соцсеть: соцсеть
союз: союз союза союзах союзе
спасательный: спасательные спасательный спасательных
спасение: спасение
спасти: спасли спасти
спектр: спектр
специалист: специалисты
специальный: специальных
специфика: специфика
сплав: сплава
спокойно: спокойно
спонсор: спонсоры
спуск: спуске
спустя: спустя
спутник: спутник спутникам спутниками спутники спутников
сравнение: сравнение
сразу: сразу
среди: среди
срок: срок
ставить: ставит
сталкиваться: сталкиваются
становиться: становится
станция: станцией станции станций станцию станция станциях
стараться: старались стараются
старлинк: старлинка
старт: старте
стартовать: стартовав
стартовый: стартовые
старший: старше
статистика: статистики
статус: статусе
стать: стал стала стали станет стать
стол: столы
столкновение: столкновения
столкнуться: столкнулся
столько: столько
сторона: стороны
стравливание: стравливанием
страна: стран страны
страшный: страшной
строго: строго
строй: строя
ступень: ступени ступень
стыковка: стыковки
судить: судя
сумма: сумму
сутки: суток
суть: сути
существование: существования
сфера: сфере
считать: считанные считать
счёт: счет
сша: сша
сэкономить: сэкономим
тайминг: тайминг
также: также
таки: таки
такой: такая такие таким таких такого такую
тактический: тактических
текущий: текущие
телекомпания: телекомпания
телескоп: телескоп телескопа телескопу телескопы
тема: тему
терминал: терминалы
тестирование: тестирование
технико: технико
технически: технически
технический: технических
технолог: технолог
тито: тито
топливо: топлива топливо топливом
тормозиться: тормозятся
торопиться: торопится
тот: та те тех той тому
точка: точек точку
точный: точных
тоёхиро: тоёхиро
траектория: траектории
транс: транс
требование: требования
требовать: требует
требоваться: требуется
третий: третьего
трехслойный: трехслойного
триста: триста
трое: трое
троицкий: троицкий
трудиться: трудилось
турецкий: турецкий
туризм: туризм
турист: турист туристами туристов туристом туристы
туристический: туристические туристических
турция: турцию
тысяча: тысяча
тяньгунь: тяньгунь
уайт: уайта
убрать: убрали
увести: увести
увлекаться: увлекается увлекался
углепластиковый: углепластиковым
уговорить: уговорить
удалиться: удалился
удаться: удалось
удивиться: удивлюсь
удивляться: удивлялся
уильямс: уильямс
уйти: ушли
улетать: улетает
улететь: улетели
университет: университете университетов
упасть: упасть
управляться: управляется
уровень: уровнем
условно: условно
усложниться: усложнилась
услуга: услуги
успеть: успеет успеют
успех: успеха
успешно: успешно
успешный: успешный
установить: установил установлены
установленный: установленный
участвовать: участвовал
учебник: учебники
учитель: учителей
учиться: учился
учёт: учетом
фабрика: фабрики
фактор: факторов факторы
фиаско: фиаско
филантроп: филантроп
филантропия: филантропия
фильм: фильма
финтех: финтеха
флайта: флайт
флорида: флориде флориды
форма: форму
формально: формально
формироваться: формируется
фото: фото
фотографироваться: фотографировались
фотоснимок: фотоснимков
функция: функцию
хаббл: хаббл
хантяньюань: хантяньюани
хелен: хелен
химик: химик
хиппчен: хиппчен
хозяин: хозяин
хороший: хорошая хорошее
хотеть: хотел хотели хочу
хотя: хотя
хохлов: хохлов хохловым
хьюстон: хьюстоне
цвет: цвета цветов
целое: целом
целостность: целостность
цель: цель
ценный: ценно
центр: центре
цеплять: цепляете
цуп: цуп цупом
цупа: цупа
чарлзти: чарлз
час: часа часов
частичка: частичек частичка
частично: частично
частник: частником
частный: частная частной частном частную частных
часть: часть
чей: чьи
человек: людей люди человек человека
человечество: человечество
честной: честная
четверо: четверо
четыре: четыре
четыреста: четыреста
чик: чика
чинить: чинил
число: числе
чистый: чистым
читатель: читатели
член: члена членов
чудо: чудо
шаг: шаг шагов
шажок: шажки
шар: шара
шармен: шармен
шарнир: шарниры
шаттл: шаттл шаттла шаттлах шаттле шаттлов шаттлы
широко: широко
школа: школу
школьный: школьных
шланг: шлангами
шлем: шлема шлемах шлемы
шлюзовый: шлюзовая шлюзовой
шоколадный: шоколадной
штаб: штаб
штатный: штатно
штурмовик: штурмовики
экипаж: экипаж экипажа экипажем
экономить: экономить
экономический: экономические экономических
экономия: экономии
экспансия: экспансия
экспедиция: экспедиции
эксперимент: экспериментов эксперименты
электромобиль: электромобили
электроника: электроники
элемент: элементы
энергия: энергия
эномото: эномото
этап: этапа
этот: эта этих
эфир: эфир
эффективность: эффективность
югославия: югославии
южный: южной
юридически: юридически
юсак: юсаку
явно: явно
японец: японец
японский: японский
ясно: ясно
