ага: ага
агрессивно: агрессивно
азарт: азарт
аккуратный: аккуратней
активизироваться: активизировался
активность: активности активность
активный: активен активны
актуальный: актуальной
английски: английски
анималист: анималисты
антон: антон
беззащитный: беззащитными
беседа: беседу
бессмыслица: бессмыслицу
бесстрашный: бесстрашных
бесшумно: бесшумно
бесшумный: бесшумный
бленда: блендой
близкий: ближайшее ближе
бо: бо
больший: большем большие
большой: большой
бородатый: бородатой
бороздка: бороздки
ботанический: ботаническом
бояться: боятся
брак: брак
бывать: бывает
быстро: быстро
бёрдвотчер: бёрдвотчера бёрдвотчеров бёрдвотчеры
бёрдвотчерский: бёрдвотчерское
бёрдвотчинг: бёрдвотчинг
вернуться: вернуться
вертеть: вертеть
верхушка: верхушки
вес: вес
весь: всем
весьма: весьма
ветка: ветках ветки
взгляд: взгляд
взлетать: взлетал
взяться: взялся
вид: вид
видеть: видел видели видишь видят
видимо: видимо
видимый: видимых
видоискатель: видоискателя
вниз: вниз
внизу: внизу
внимательный: внимательным
возле: возле
возможно: возможно
возражать: возражал
вообще: вообще
воробьиный: воробьиного воробьиные воробьиный воробьиных
ворон: воронами
вплотную: вплотную
врач: врача
временами: временами
время: временем времени время
вс: вс
вспышка: вспышки
встретить: встретил
встретиться: встретившись
встреча: встречи
встречаться: встречается встречаются
всё: всё
второй: вторых
выбежать: выбежит
выискивать: выискивая
выкармливание: выкармливания
вылететь: вылетит
высматривать: высматривает
высоко: высоко повыше
выход: выходу
выясниться: выяснилось
гага: гага
гагара: гагарой
гбс: гбс
географический: географические
главный: главном
глаз: глаз
гласить: гласит
гнездо: гнезда
говорить: говорила
год: года
голова: головой голову
голос: голос
голый: голых
гоняться: гонялся
горлица: горлицы
городской: городских
гостить: гостили
гость: гостя
грызун: грызуны
дальний: дальних
дальномерный: дальномерная
два: двум
движение: движение
дежурство: дежурство
делать: делает делать
дело: деле дело
деловой: деловые
день: день днем
дерево: деревьев деревьями
длина: длина
длиннофокусный: длиннофокусными
длиннохвостый: длиннохвостой
длинный: длинный
дневный: дневная дневной дневную дневными
добытчик: добытчиком
добыча: добычу
должный: должны
достаточно: достаточно
дотянуть: дотянет
доходить: доходить
дремота: дремоту
дрозд: дроздами
друг: друг друга другом друзей друзьями
другой: других
думать: думает думаю
дупло: дупла дупле дупло
дятел: дятел
евсеев: евсеев
единственный: единственная
ждать: ждали
желтоголовый: желтоголовый
живой: живое
житель: жителей
жёлтый: желтых
заблуждение: заблуждением
заботливый: заботливым
завести: завести
завет: завет
загородить: загородили
задом: задом
задуматься: задумался
закуривать: закуривая
заладиться: заладилась
заметно: заметно
замечать: замечаешь
запас: запас
засада: засады
затем: затем
захотеть: захочет
зашибить: зашибите
защита: защита
звезда: звезда
зима: зиме
зимой: зимой
злой: злого злой
знакомство: знакомства
знакомый: знакомые
знаток: знатоков
знать: знает знаете знаешь знаю
значит: значит
зоомагазин: зоомагазин
игорь: игоря
играть: играют
идти: шла
измайловский: измайловский измайловском
измерять: измерять
изобилие: изобилии
именно: именно
инверсия: инверсия
иной: иной
интересный: интересное
информация: информацией
искать: ища ищите
искушение: искушению
исполнять: исполняя
истинный: истинная
итак: итак
к: ко
кадр: кадр
казаться: кажется
какой: каким
касаться: касается
квантовый: квантовый
кладовая: кладовую кладовыми
коллега: коллега
комментарий: комментариев
комментировать: комментировали
конец: конце концов
координата: координаты
корм: корма
кормить: кормит
кормление: кормление
кормушка: кормушек
королёк: королёк
коростель: коростелём
который: которому которые который которых
край: краях
крайний: крайней
красивый: красивый
крупный: крупные
крыло: крыльев
кто: кого кому
куст: куста
кушать: кушать
ладиться: ладилась
лен: лену
лента: ленту
летать: летать
лететь: летят
либо: либо
лицо: лица
лишь: лишь
ловить: ловить
ловля: ловле
луна: луны
льшуя: льшую
любительский: любительские
любовь: любви
любой: любое любой
люд: люду
магнетизм: магнетизмом
май: мае май
маленький: маленькая меньше
мало: мало
манёвренность: маневренность
март: март марте
мегаполис: мегаполисе мегаполисов
мелкий: мелкие
менять: менял
мера: мере
мерзкий: мерзкая
место: месте
металлик: металлику
метр: метрах
мимо: мимо
мировой: мировой
митинг: митинг
многие: многие
многий: многих
мой: моего
молодец: молодец
момент: момент
моргнуть: моргнул
москва: москве
мотив: мотив
муж: мужем
мы: нам
мыший: мышью
мышка: мышка
мышь: мышей мыши мышь
наблюдать: наблюдал
наблюдение: наблюдение наблюдения
наверное: наверное
наизусть: наизусть
найти: найти
намекать: намекая
напевать: напевая
написать: напишите
например: например
наслать: нашли
настроение: настроение
настроить: настроенными
находиться: находиться
начинать: начинает начинал
наш: нашей наших
небольшой: небольшие
невозможно: невозможно
недавний: недавней
недавно: недавно
недоброжелатель: недоброжелателями
незаметный: незаметным
некоторый: некоторые
немного: немного
неотразимый: неотразимым
неподалёку: неподалеку
несколько: несколько
несомненно: несомненно
неспешно: неспешно
неясыть: неясыти неясыть неясытью
ниже: ниже
никто: никого никто
никуда: никуда
новый: новые
нос: нос
ночной: ночную
ночь: ночь
ночью: ночью
нужно: нужно
нужный: нужен нужные
нынче: нынче
обделаться: обделается обделался
обитать: обитающие
обладать: обладает обладающие
обмениваться: обмениваться
образ: образом
объект: объект
объектив: объектив объектива объективами
оглядеться: оглядевшись
один: одна одно одного одной одном одному
однако: однако
окраска: окраска
олег: олега
ольга: ольгу
оно: оно
оперение: оперение оперенье
оптика: оптика
опытный: опытные
орнитология: орнитологии
основный: основная основным
особенно: особенно
особенный: особенным
оставаться: оставаться
остаться: останется остаться
отвлечься: отвлекся
отвращение: отвращения
отдавать: отдает
отец: отцом
откуда: откуда
отличие: отличие
отнести: отнес
относить: относит
отстраниться: отстранившись
охота: охота охоту охоты
охотиться: охотится охотиться
охотник: охотник
охотничий: охотничий
очень: очень
параллельно: параллельно
парк: парк
парка: парке
пасека: пасеке
пентакса: пентакса
первый: первому первых
перегруппировываться: перегруппировывались
передний: передние
период: период
перо: перо перьев
песня: песни песня
петь: поют
питаться: питаться
плотно: плотно
плотный: плотное плотный плотным
плохо: плохо
побежать: побежали
повернуться: повернись
повод: повод
поворачиваться: поворачиваясь
повторяться: повторялось
погадка: погадку
поглядывать: поглядывая
погодить: погодите
погружаться: погружался
подлететь: подлетит
поднимать: поднимает
поднять: подняв
подпускать: подпускает
подстерегать: подстерегал
подходить: подходил подходили
подшучивать: подшучивать
пожалуйста: пожалуйста
поза: поз позу
позволять: позволяют
поздний: позже
поймать: поймав пойманную
пойти: пошел
пока: пока
показать: покажу
показаться: показавшейся
половина: половина
положение: положении
получиться: получившиеся
полёт: полет полета
помнить: помню
помогать: помогает
помощь: помощь
понравиться: понравиться
попрощаться: попрощался
популярный: популярным
пора: пора
поскольку: поскольку
посмотреть: посмотри
поставить: поставил поставьте
потихоньку: потихоньку
почему: почему
поэтому: поэтому
правило: правило правилу
предположение: предположение
предпочитать: предпочитают
прекрасный: прекрасные
прервать: прерванную
приехать: приехал
прийти: придет
принять: приняв
природа: природы
прислать: пришлите
притягательность: притягательности притягательность
приходить: приходило
приходиться: приходится
причина: причинам
продолжать: продолжал
продолжаться: продолжалось
продолжить: продолжили
проиллюстрировать: проиллюстрирую
происходить: происходящего
пройти: прошло
пролететь: пролетела
проникновение: проникновение
просматривать: просматривая
противиться: противиться
прохожий: прохожие
прошлый: прошлый прошлых
проявлять: проявляла
прямо: прямо
психиатр: психиатр психиатром
птенец: птенцов
птица: птиц птица птицами птицы
птичка: птичка
пугачёв: пугачёву
пытаться: пытались
работать: работает
равно: равно
разбить: разбить
развить: развита
разглядывать: разглядывать
размах: размах
размер: размеры
размерность: размерности
разойтись: разойдутся
ракурс: ракурсы
рамштайна: рамштайн
ран: ран
ранний: раньше
распадаться: распадался
распространить: распространенным
рассказ: рассказом
расслабиться: расслабившись
расслабляться: расслабляться
расспрашивать: расспрашивать
расстояние: расстоянии расстояния
расходиться: расходиться
рацион: рациона
ребёночек: детки
результат: результате
решить: решили
роль: роль
россия: россии
русский: русской
рыхлый: рыхлое
рыцарь: рыцарей
сад: саду
сам: самой самом
самец: самец самца
самка: самка самке самки самкой
самый: самая самые самым самых
свежесочинённый: свежесочиненную
свет: свету
светлый: светлый
свой: свое своего свои своими своих
свойственный: свойственна
связь: связи
сделать: сделай сделали сделать
север: север
секрет: секрет
село: села
сесть: сел
сеть: сетях
сибирский: сибирского
сидеть: сидела сидит сидят
сильно: сильно
симбиоз: симбиоз
сирень: сирени
сказать: скажи
скворец: скворца
скорее: скорее
скрыться: скрылось
следовать: следуя
следующий: следующего
слетать: слетал слетать слетают
слететь: слетев слетит
сложно: сложно
слух: слухом
слушать: слушаю
слышать: слышал слышат
слёт: слета
смещаться: смещались
смотреть: см
снег: снег
снижать: снижает
снимать: снимать
снимка: снимок
снимок: снимки
снова: снова
снять: снять
собираться: собирался
собрать: собрать
собраться: собралась собрались
сова: сов сова совам совы
совершенно: совершенно
современный: современном современных
создавать: создавая
солнце: солнце
сорокопут: сорокопута
составлять: составляет составляющие
состоять: состоит
сотый: сотый
социальный: социальные социальных
спасибо: спасибо
способ: способ
спрашивать: спрашивали
сработать: сработало
сразу: сразу
среди: среди
срыгнуть: срыгнул
ставить: ставите
становиться: становятся
старинный: старинное
старое: старое
старый: старому
стать: стали
столько: столько
стоять: стояли
страна: страны
строй: строй
стряхнуть: стряхнул
суетиться: суетиться
сумасшедший: сумасшедшим сумасшедших
супруг: супруга
сутки: суток
сущность: сущности
сфотографировать: сфотографировать
сходить: сходить
сцепляться: сцепляются
съедать: съедает
съёмка: съемки
сыч: сыч сыча сычах сычи сычом сычу
сычик: сычик сычика
тайна: тайна тайны
также: также
такой: таким таком
тело: тела
темнота: темноты
тень: тени
толпа: толпа толпу
томный: томный
торопиться: торопился
тот: той
точно: точно
трехпалый: трехпалый
три: трех
трое: трое
туда: туда
ты: тебе
тянуть: тянул
тёмный: темное
увидеть: увидел
увидеться: увиделись увидеться
увы: увы
удалять: удаляя
удачливый: удачливый
удел: удел
удлиниться: удлинились
узнать: узнал
укрепить: укрепить
улетать: улетать
улететь: улететь
улыбочка: улыбочку
уметь: умеет умеют
упорный: упорные
урагус: урагус
услышать: услышал
успешно: успешно
успокаивать: успокаивает
устраивать: устраивает
устроить: устроить
утверждение: утверждением
фон: фоне
фонарь: фонарь
фото: фото
фотоаппарат: фотоаппараты
фотогалерея: фотогалерея
фотограф: фотографам фотографов фотографом фотографы
фотографировать: фотографировал фотографировать
фотография: фотографии фотографий
фотоохота: фотоохота фотоохоту
фотопрогулка: фотопрогулках
фотосессия: фотосессии
функция: функция
хвастаться: хвастаться
хищник: хищниками
хмелевой: хмелевое
хобби: хобби
хотеть: хотел хотели
хотеться: хочется
хотя: хотя
царский: царской
целый: целая
цель: целью
цицина: цицина
часто: часто
частый: частых чаще
часть: часть
чей: чей
человек: людей
черноголовка: черноголовке
четверо: четверо
чечётка: чечётки
чиститься: чистился
чуткий: чутким
чёрный: черный
чётко: четко
шапочно: шапочно
шум: шум
являться: является
язык: язык
январский: январский январской
январь: январе январь
ярко: ярко
ёлка: елках
